gameId,gameDate,gameType,Team Home,Score Home,Score Away,Team Away,Shot Home EV,Miss Home EV,Block Home EV,Goal Home EV,CF EV,Shot Away EV,Miss Away EV,Block Away EV,Goal Away EV,CA EV,Shot Home 5v5,Miss Home 5v5,Block Home 5v5,Goal Home 5V5,CF 5v5,Shot Away 5v5,Miss Away 5v5,Block Away 5v5,Goal Away 5v5,CA 5v5,First Goal Home,First Goal Away,SOG Home,SOG Away,Faceoff Home,Faceoff Away,Pim Home,Pim Away
2022020001,2022-10-07,2,NSH,4,1,SJS,19,8,19,4,50,22,11,10,1,44,19,8,19,4,50,21,10,9,1,41,1,0,32,31,0.454545,0.545455,13,13
2022020002,2022-10-08,2,SJS,2,3,NSH,21,8,15,1,45,11,11,14,3,39,21,8,15,1,45,11,11,14,3,39,1,0,33,18,0.507246,0.492754,6,8
2022020003,2022-10-11,2,NYR,3,1,TBL,20,6,16,1,43,18,7,8,0,33,20,6,16,1,43,18,7,8,0,33,1,0,39,26,0.638298,0.361702,12,8
2022020004,2022-10-11,2,LAK,3,4,VGK,25,13,9,3,50,41,8,20,3,72,21,13,8,3,45,40,8,19,3,70,1,0,30,51,0.491525,0.508475,10,6
2022020005,2022-10-12,2,WSH,2,5,BOS,25,10,15,2,52,18,7,13,4,42,25,10,15,2,52,18,7,13,4,42,0,1,35,30,0.372881,0.627119,6,8
2022020006,2022-10-12,2,CAR,4,1,CBJ,33,27,20,4,84,30,10,9,1,50,33,27,20,4,84,30,10,9,1,50,0,1,43,32,0.61039,0.38961,4,4
2022020007,2022-10-12,2,MTL,4,3,TOR,14,10,13,4,41,24,4,19,3,50,13,10,13,4,40,23,4,18,3,48,0,1,23,32,0.509804,0.490196,8,8
2022020008,2022-10-12,2,COL,5,2,CHI,24,8,14,1,47,14,5,11,0,30,24,8,14,1,47,14,5,11,0,30,1,0,35,17,0.387755,0.612245,11,17
2022020009,2022-10-12,2,ANA,5,4,SEA,18,4,11,3,36,36,10,9,1,56,18,4,11,2,35,35,10,9,1,55,1,0,27,48,0.571429,0.428571,15,11
2022020010,2022-10-12,2,EDM,5,3,VAN,18,6,16,1,41,23,9,10,2,44,18,6,16,1,41,23,8,10,2,43,0,1,25,36,0.478873,0.521127,16,8
2022020011,2022-10-13,2,PIT,6,2,ARI,33,9,7,4,53,20,3,14,0,37,33,9,7,4,53,20,3,14,0,37,1,0,53,28,0.584615,0.415385,12,14
2022020012,2022-10-13,2,PHI,5,2,NJD,14,6,7,4,31,31,15,23,1,70,14,6,5,4,29,30,14,23,1,68,0,1,25,37,0.391304,0.608696,8,8
2022020013,2022-10-13,2,BUF,4,1,OTT,24,7,7,4,42,30,3,9,1,43,24,7,7,4,42,30,3,9,1,43,0,1,36,36,0.44898,0.55102,8,8
2022020014,2022-10-13,2,NYI,1,3,FLA,27,13,13,0,53,17,7,16,3,43,23,12,13,0,48,17,7,16,3,43,0,1,33,29,0.585714,0.414286,12,8
2022020015,2022-10-13,2,TOR,3,2,WSH,27,6,7,2,42,17,13,12,2,44,27,6,7,2,42,17,13,12,2,44,1,0,39,26,0.535714,0.464286,10,6
2022020016,2022-10-13,2,NSH,1,4,DAL,19,7,12,1,39,17,7,7,2,33,19,7,12,1,39,17,7,7,2,33,0,1,32,29,0.5,0.5,13,15
2022020017,2022-10-13,2,MIN,3,7,NYR,17,9,10,2,38,18,4,10,6,38,16,8,10,2,36,17,4,10,5,36,0,1,36,35,0.5,0.5,19,17
2022020018,2022-10-13,2,CGY,5,3,COL,19,6,11,2,38,20,8,9,2,39,19,6,10,2,37,20,7,8,1,36,0,1,27,25,0.584615,0.415385,12,14
2022020019,2022-10-13,2,VGK,1,0,CHI,28,13,18,1,60,21,7,18,0,46,28,13,18,1,60,21,7,18,0,46,1,0,37,27,0.491228,0.508772,4,6
2022020020,2022-10-13,2,LAK,1,4,SEA,22,8,12,0,42,14,6,7,2,29,20,8,12,0,40,13,6,7,2,28,0,1,27,22,0.576923,0.423077,21,19
2022020021,2022-10-14,2,CBJ,2,5,TBL,14,7,3,2,26,33,14,13,4,64,14,7,3,2,26,33,14,13,4,64,1,0,28,39,0.714286,0.285714,4,8
2022020022,2022-10-14,2,DET,3,0,MTL,27,7,13,3,50,22,2,13,0,37,27,7,13,3,50,22,2,13,0,37,1,0,40,29,0.415385,0.584615,6,6
2022020023,2022-10-14,2,WPG,4,1,NYR,27,12,17,3,59,32,14,12,1,59,24,12,16,3,55,32,14,11,1,58,1,0,34,41,0.508772,0.491228,4,6
2022020024,2022-10-14,2,SJS,1,2,CAR,11,4,7,1,23,26,7,20,2,55,11,4,7,1,23,25,7,20,2,54,1,0,19,35,0.47541,0.52459,11,15
2022020025,2022-10-15,2,BUF,3,4,FLA,16,6,8,3,33,22,10,7,2,41,16,6,8,3,33,22,10,7,2,41,1,0,27,37,0.52381,0.47619,16,12
2022020026,2022-10-15,2,PHI,3,2,VAN,21,7,6,1,35,23,7,11,2,43,20,7,6,1,34,21,7,10,2,40,0,1,31,30,0.480769,0.519231,17,17
2022020027,2022-10-15,2,BOS,6,3,ARI,32,9,15,5,61,16,8,10,1,35,32,9,15,5,61,16,8,10,1,35,1,0,43,24,0.553846,0.446154,13,11
2022020028,2022-10-15,2,NJD,2,5,DET,31,12,18,2,63,12,7,10,5,34,29,10,17,2,58,11,7,10,4,32,1,0,39,22,0.545455,0.454545,12,10
2022020029,2022-10-15,2,WSH,3,1,MTL,17,12,19,2,50,16,15,11,1,43,17,12,19,2,50,16,15,11,1,43,0,1,29,22,0.403509,0.596491,13,13
2022020030,2022-10-15,2,TOR,3,2,OTT,27,15,17,2,61,24,8,11,1,44,27,15,17,2,61,24,8,11,1,44,0,1,32,28,0.491525,0.508475,4,4
2022020031,2022-10-15,2,PIT,6,2,TBL,31,12,9,4,56,25,7,12,1,45,31,12,9,4,56,25,7,12,1,45,0,1,45,36,0.616667,0.383333,8,8
2022020032,2022-10-15,2,NYI,7,1,ANA,23,13,9,7,52,20,12,17,1,50,21,11,9,7,48,17,12,16,1,46,1,0,38,23,0.569231,0.430769,10,10
2022020033,2022-10-15,2,STL,5,2,CBJ,17,10,13,4,44,22,6,12,2,42,17,10,13,4,44,22,6,12,2,42,1,0,25,25,0.425926,0.574074,4,6
2022020034,2022-10-15,2,MIN,6,7,LAK,23,10,17,3,53,18,4,4,5,31,22,10,17,3,52,17,4,4,5,30,0,1,35,34,0.463768,0.536232,14,14
2022020035,2022-10-15,2,DAL,5,1,NSH,12,12,15,4,43,25,25,11,0,61,12,12,15,3,42,25,24,11,0,60,1,0,22,30,0.534483,0.465517,10,16
2022020036,2022-10-15,2,EDM,3,4,CGY,20,6,12,2,40,30,13,9,3,55,20,6,12,2,40,29,13,8,3,53,0,1,29,42,0.545455,0.454545,10,10
2022020037,2022-10-15,2,SEA,2,5,VGK,29,10,17,1,57,24,11,8,3,46,29,10,17,1,57,23,11,8,3,45,0,1,33,30,0.347826,0.652174,8,4
2022020038,2022-10-15,2,SJS,2,5,CHI,18,9,14,2,43,18,7,3,3,31,17,9,14,2,42,17,6,3,3,29,1,0,26,25,0.528302,0.471698,6,18
2022020039,2022-10-17,2,NYR,6,4,ANA,30,13,11,3,57,15,3,12,4,34,30,13,11,3,57,15,3,12,4,34,1,0,43,22,0.517241,0.482759,2,8
2022020040,2022-10-17,2,TOR,2,4,ARI,22,10,12,1,45,14,2,5,2,23,22,10,12,1,45,14,2,5,2,23,0,1,28,19,0.591837,0.408163,12,12
2022020041,2022-10-17,2,BOS,5,3,FLA,23,9,16,5,53,27,11,13,3,54,23,9,16,5,53,27,11,13,3,54,1,0,34,41,0.644068,0.355932,12,10
2022020042,2022-10-17,2,MTL,3,2,PIT,30,10,16,2,58,22,9,12,2,45,27,10,15,2,54,21,9,12,2,44,0,1,39,28,0.481481,0.518519,6,6
2022020043,2022-10-17,2,WSH,6,4,VAN,23,8,15,4,50,25,14,13,3,55,22,7,14,4,47,24,14,12,3,53,1,0,30,30,0.517241,0.482759,4,8
2022020044,2022-10-17,2,DET,4,5,LAK,22,5,10,3,40,24,11,13,5,53,21,5,10,3,39,24,11,13,4,52,1,0,33,36,0.354839,0.645161,8,8
2022020045,2022-10-17,2,MIN,3,6,COL,28,9,13,1,51,32,9,11,4,56,27,9,13,1,50,31,9,10,3,53,0,1,39,38,0.551724,0.448276,10,14
2022020046,2022-10-17,2,DAL,4,1,WPG,15,10,9,3,37,17,14,15,1,47,15,10,9,3,37,17,14,15,1,47,0,1,29,25,0.54902,0.45098,10,8
2022020047,2022-10-17,2,SEA,1,5,CAR,18,4,8,0,30,23,12,14,3,52,18,4,8,0,30,23,12,14,3,52,0,1,23,34,0.483333,0.516667,10,10
2022020048,2022-10-18,2,NJD,4,2,ANA,34,12,13,4,63,12,6,6,2,26,34,12,13,4,63,12,6,6,2,26,0,1,41,20,0.537037,0.462963,15,23
2022020049,2022-10-18,2,OTT,7,5,BOS,24,12,11,7,54,20,13,10,4,47,23,9,10,6,48,19,12,9,3,43,1,0,31,34,0.5,0.5,15,13
2022020050,2022-10-18,2,CBJ,4,3,VAN,28,11,13,4,56,25,3,15,2,45,25,8,11,3,47,23,2,15,2,42,0,1,33,35,0.616667,0.383333,11,9
2022020051,2022-10-18,2,NYI,5,2,SJS,35,8,18,5,66,22,8,12,2,44,35,8,17,5,65,21,8,11,2,42,0,1,46,28,0.522388,0.477612,6,6
2022020052,2022-10-18,2,NSH,3,4,LAK,23,11,7,3,44,22,9,7,3,41,17,6,6,3,32,18,6,7,1,32,1,0,32,35,0.622642,0.377358,18,12
2022020053,2022-10-18,2,TBL,2,3,PHI,34,15,14,0,63,19,7,14,2,42,34,15,14,0,63,19,7,14,2,42,1,0,38,24,0.622642,0.377358,14,16
2022020054,2022-10-18,2,EDM,2,4,BUF,40,15,11,2,68,15,10,8,3,36,40,15,11,1,67,13,10,8,3,34,0,1,48,24,0.555556,0.444444,12,10
2022020055,2022-10-18,2,CGY,3,2,VGK,24,12,14,1,51,12,7,6,2,27,24,12,14,1,51,12,7,6,2,27,0,1,40,21,0.536232,0.463768,8,12
2022020056,2022-10-19,2,FLA,4,3,PHI,23,9,9,4,45,20,2,3,2,27,23,9,9,4,45,20,2,3,2,27,1,0,36,33,0.626866,0.373134,12,6
2022020057,2022-10-19,2,COL,3,4,WPG,30,8,25,2,65,21,11,10,3,45,29,7,24,2,62,18,10,10,1,39,0,1,33,28,0.538462,0.461538,8,6
2022020058,2022-10-19,2,SEA,3,4,STL,32,18,14,3,67,20,4,4,4,32,31,18,13,3,65,20,4,4,3,31,0,1,35,28,0.454545,0.545455,10,6
2022020059,2022-10-20,2,BOS,2,1,ANA,31,9,11,2,53,27,6,10,1,44,27,8,10,1,46,20,4,9,1,34,1,0,36,31,0.636364,0.363636,8,10
2022020060,2022-10-20,2,MTL,6,2,ARI,19,5,13,5,42,18,6,12,2,38,19,5,13,5,42,18,6,12,2,38,1,0,30,27,0.466667,0.533333,11,7
2022020061,2022-10-20,2,TOR,3,2,DAL,21,5,12,2,40,21,13,18,1,53,20,4,11,1,36,18,13,18,1,50,0,1,43,28,0.520548,0.479452,8,16
2022020062,2022-10-20,2,PIT,6,1,LAK,24,5,13,4,46,27,12,16,0,55,22,5,13,4,44,25,11,16,0,52,1,0,34,40,0.581818,0.418182,14,8
2022020063,2022-10-20,2,CBJ,5,3,NSH,30,13,16,5,64,21,8,16,3,48,29,13,16,5,63,20,8,16,3,47,0,1,42,26,0.455882,0.544118,10,6
2022020064,2022-10-20,2,NYR,2,3,SJS,18,14,8,2,42,22,10,16,2,50,18,14,8,2,42,18,10,15,1,44,0,1,23,27,0.421053,0.578947,6,10
2022020065,2022-10-20,2,OTT,5,2,WSH,34,7,16,3,60,20,11,8,0,39,33,7,16,3,59,19,11,8,0,38,0,1,44,24,0.641509,0.358491,15,15
2022020066,2022-10-20,2,NYI,1,4,NJD,13,8,20,1,42,31,14,15,4,64,11,7,20,0,38,29,14,15,4,62,0,1,17,43,0.392157,0.607843,8,6
2022020067,2022-10-20,2,MIN,4,3,VAN,28,8,11,3,50,17,12,14,3,46,23,8,9,2,42,17,11,14,3,45,1,0,37,26,0.509804,0.490196,11,13
2022020068,2022-10-20,2,CGY,3,6,BUF,33,10,12,3,58,24,17,10,4,55,33,10,12,3,58,24,17,10,4,55,1,0,43,32,0.438596,0.561404,10,2
2022020069,2022-10-20,2,EDM,6,4,CAR,23,6,11,3,43,28,10,16,2,56,22,6,11,3,42,28,10,16,2,56,1,0,33,40,0.512821,0.487179,10,10
2022020070,2022-10-20,2,VGK,5,2,WPG,23,11,9,5,48,25,11,10,2,48,23,11,9,4,47,25,11,10,2,48,1,0,32,28,0.5,0.5,2,6
2022020071,2022-10-21,2,FLA,2,3,TBL,26,4,12,2,44,21,7,5,1,34,25,4,12,2,43,19,7,5,1,32,0,1,38,32,0.470588,0.529412,18,14
2022020072,2022-10-21,2,CHI,4,3,DET,21,11,13,3,48,22,8,14,2,46,20,11,13,1,45,20,8,13,2,43,0,1,29,28,0.618182,0.381818,14,10
2022020073,2022-10-21,2,COL,2,3,SEA,16,11,11,1,39,29,7,7,2,45,16,11,11,1,39,29,7,7,2,45,0,1,20,38,0.631579,0.368421,15,9
2022020074,2022-10-22,2,BOS,4,3,MIN,25,7,15,3,50,18,6,7,1,32,24,7,14,3,48,17,6,7,1,31,0,1,43,27,0.610169,0.389831,10,10
2022020075,2022-10-22,2,NJD,2,1,SJS,28,7,11,1,47,19,16,15,1,51,28,7,11,1,47,19,16,15,1,51,1,0,36,22,0.47619,0.52381,4,6
2022020076,2022-10-22,2,OTT,6,2,ARI,24,3,14,5,46,14,5,8,1,28,19,3,14,5,41,14,5,8,1,28,1,0,32,22,0.625,0.375,19,17
2022020077,2022-10-22,2,EDM,0,2,STL,23,10,24,0,57,18,11,8,1,38,23,10,24,0,57,18,11,8,1,38,0,1,23,22,0.418605,0.581395,2,2
2022020078,2022-10-22,2,MTL,2,5,DAL,30,4,13,2,49,20,13,12,3,48,29,4,13,2,48,18,12,12,3,45,0,1,34,30,0.465517,0.534483,6,8
2022020079,2022-10-22,2,WSH,4,3,LAK,24,12,18,4,58,22,10,16,3,51,24,12,18,4,58,22,10,16,3,51,0,1,32,26,0.357143,0.642857,2,6
2022020080,2022-10-22,2,TBL,5,3,NYI,11,10,8,5,34,27,16,14,3,60,11,10,8,5,34,27,16,14,3,60,1,0,26,35,0.574074,0.425926,6,6
2022020081,2022-10-22,2,CBJ,3,6,PIT,24,5,17,2,48,29,9,11,6,55,24,5,17,2,48,29,9,11,6,55,1,0,32,39,0.466667,0.533333,6,2
2022020082,2022-10-22,2,WPG,1,4,TOR,26,7,10,1,44,23,15,16,2,56,26,7,9,1,43,23,15,16,2,56,1,0,31,28,0.478261,0.521739,15,15
2022020083,2022-10-22,2,NSH,1,3,PHI,27,18,18,0,63,21,7,11,3,42,27,17,18,0,62,21,7,11,3,42,0,1,32,25,0.714286,0.285714,14,16
2022020084,2022-10-22,2,VAN,1,5,BUF,25,10,14,0,49,20,14,13,4,51,25,10,14,0,49,20,14,13,4,51,0,1,30,27,0.553571,0.446429,2,8
2022020085,2022-10-22,2,CGY,3,2,CAR,18,5,6,2,31,21,10,14,2,47,15,3,6,1,25,20,10,14,2,46,0,1,32,27,0.48,0.52,8,8
2022020086,2022-10-22,2,VGK,2,3,COL,28,10,11,1,50,20,14,24,1,59,28,10,11,1,50,20,14,24,1,59,0,1,35,25,0.607143,0.392857,4,8
2022020087,2022-10-23,2,CHI,5,4,SEA,17,11,10,2,40,22,12,14,4,52,17,10,10,2,39,22,12,14,4,52,0,1,27,34,0.694915,0.305085,8,6
2022020088,2022-10-23,2,DET,5,1,ANA,24,4,6,2,36,27,12,13,1,53,24,4,6,2,36,27,12,13,1,53,1,0,41,33,0.491803,0.508197,12,14
2022020089,2022-10-23,2,NYR,1,5,CBJ,23,14,19,0,56,15,7,11,5,38,23,14,19,0,56,15,7,11,5,38,0,1,31,21,0.666667,0.333333,2,6
2022020090,2022-10-23,2,FLA,3,2,NYI,21,6,16,3,46,14,5,8,0,27,21,6,16,3,46,14,5,8,0,27,1,0,32,26,0.509804,0.490196,12,8
2022020091,2022-10-23,2,PHI,0,3,SJS,26,10,15,0,51,19,12,16,3,50,26,10,15,0,51,19,12,16,3,50,0,1,30,25,0.567164,0.432836,2,4
2022020092,2022-10-24,2,OTT,4,2,DAL,20,12,17,3,52,27,8,12,2,49,20,12,17,3,52,27,8,12,2,49,0,1,32,31,0.5,0.5,6,8
2022020093,2022-10-24,2,NJD,3,6,WSH,30,12,10,3,55,10,10,9,4,33,30,12,10,3,55,10,10,9,4,33,1,0,41,22,0.507463,0.492537,6,8
2022020094,2022-10-24,2,EDM,6,3,PIT,37,17,8,5,67,25,8,9,2,44,34,17,8,5,64,23,8,8,2,41,1,0,47,35,0.539683,0.460317,10,6
2022020095,2022-10-24,2,WPG,4,0,STL,32,8,12,4,56,22,14,13,0,49,32,8,12,4,56,22,14,13,0,49,1,0,43,25,0.395833,0.604167,6,12
2022020096,2022-10-24,2,VGK,3,1,TOR,25,10,16,2,53,18,7,26,1,52,25,10,16,2,53,18,7,26,1,52,1,0,33,23,0.490909,0.509091,4,6
2022020097,2022-10-24,2,VAN,2,3,CAR,11,8,14,1,34,33,15,12,2,62,11,8,14,1,34,33,15,12,2,62,0,1,16,39,0.4,0.6,6,4
2022020098,2022-10-25,2,CBJ,3,6,ARI,23,14,12,3,52,9,8,5,4,26,23,14,12,3,52,9,8,5,4,26,0,1,33,19,0.537313,0.462687,16,14
2022020099,2022-10-25,2,NYR,2,3,COL,32,12,10,2,56,36,4,14,0,54,29,10,10,2,51,34,4,13,0,51,0,1,46,44,0.564516,0.435484,6,8
2022020100,2022-10-25,2,BOS,3,1,DAL,21,6,4,2,33,26,6,11,1,44,20,6,4,2,32,25,6,11,1,43,1,0,29,31,0.528302,0.471698,11,13
2022020101,2022-10-25,2,MTL,1,3,MIN,24,8,18,1,51,22,3,15,3,43,23,8,16,1,48,17,3,15,3,38,0,1,27,31,0.520833,0.479167,10,10
2022020102,2022-10-25,2,DET,2,6,NJD,15,9,12,2,38,35,10,12,4,61,15,9,12,2,38,35,10,12,4,61,1,0,22,41,0.413793,0.586207,2,6
2022020103,2022-10-25,2,CHI,4,2,FLA,13,6,5,3,27,24,15,15,2,56,13,6,5,3,27,23,14,12,2,51,1,0,22,31,0.583333,0.416667,14,6
2022020104,2022-10-25,2,CGY,4,1,PIT,21,11,18,3,53,25,14,13,0,52,21,11,18,3,53,25,14,13,0,52,1,0,36,33,0.640625,0.359375,10,6
2022020105,2022-10-25,2,SEA,5,1,BUF,15,9,7,3,34,10,7,12,1,30,15,9,7,3,34,10,7,12,1,30,1,0,24,16,0.326531,0.673469,8,6
2022020106,2022-10-25,2,LAK,4,2,TBL,26,9,16,3,54,16,7,17,2,42,26,8,15,3,52,15,7,17,2,41,1,0,33,25,0.54902,0.45098,10,10
2022020107,2022-10-25,2,SJS,2,4,VGK,27,13,25,2,67,25,11,18,4,58,27,13,25,2,67,25,11,18,4,58,0,1,31,31,0.508475,0.491525,2,4
2022020108,2022-10-26,2,NYI,3,0,NYR,20,9,12,3,44,32,13,11,0,56,20,9,12,3,44,32,13,11,0,56,1,0,29,41,0.510204,0.489796,6,6
2022020109,2022-10-26,2,STL,1,3,EDM,29,11,6,0,46,20,10,18,3,51,29,11,6,0,46,20,10,18,3,51,0,1,38,28,0.433333,0.566667,4,6
2022020110,2022-10-26,2,ANA,2,4,TBL,16,5,15,2,38,23,10,18,3,54,15,5,15,2,37,23,10,18,3,54,1,0,21,30,0.546875,0.453125,6,4
2022020111,2022-10-27,2,BOS,5,1,DET,22,8,5,2,37,24,6,9,1,40,21,8,5,2,36,23,6,9,1,39,1,0,33,29,0.483333,0.516667,10,14
2022020112,2022-10-27,2,PHI,4,3,FLA,17,8,5,3,33,39,21,26,2,88,17,7,4,3,31,37,20,26,2,85,0,1,22,51,0.5,0.5,12,8
2022020113,2022-10-27,2,OTT,2,4,MIN,20,11,18,1,50,29,10,7,2,48,20,10,18,1,49,26,10,7,2,45,1,0,29,40,0.483871,0.516129,20,22
2022020114,2022-10-27,2,BUF,2,3,MTL,30,10,10,1,51,26,8,12,3,49,30,10,10,1,51,26,8,12,3,49,0,1,45,34,0.431373,0.568627,6,8
2022020115,2022-10-27,2,NSH,6,2,STL,29,10,18,5,62,27,9,7,1,44,29,10,18,5,62,27,9,7,1,44,0,1,42,35,0.520833,0.479167,6,4
2022020116,2022-10-27,2,CHI,5,6,EDM,19,3,4,3,29,18,10,5,3,36,17,2,4,3,26,18,10,5,3,36,0,1,36,38,0.546875,0.453125,18,22
2022020117,2022-10-27,2,DAL,2,0,WSH,24,11,14,1,50,23,12,14,0,49,24,10,14,1,49,20,12,13,0,45,1,0,27,27,0.684211,0.315789,8,8
2022020118,2022-10-27,2,SEA,4,5,VAN,27,13,15,3,58,14,4,8,3,29,27,13,15,3,58,14,4,8,3,29,0,1,36,19,0.418182,0.581818,19,23
2022020119,2022-10-27,2,SJS,4,3,TOR,26,6,9,2,43,20,11,9,2,42,25,5,9,1,40,19,9,9,2,39,1,0,31,25,0.5,0.5,10,8
2022020120,2022-10-27,2,LAK,4,6,WPG,35,8,18,3,64,8,9,5,3,25,35,8,18,3,64,8,9,5,3,25,0,1,44,19,0.666667,0.333333,10,8
2022020121,2022-10-28,2,VGK,4,0,ANA,18,14,10,2,44,23,8,15,0,46,18,14,10,2,44,23,8,15,0,46,1,0,22,29,0.52459,0.47541,9,9
2022020122,2022-10-28,2,CBJ,0,4,BOS,21,5,19,0,45,24,10,12,3,49,21,5,19,0,45,24,10,12,3,49,0,1,30,35,0.418182,0.581818,4,6
2022020123,2022-10-28,2,NJD,1,0,COL,20,10,14,0,44,16,7,9,0,32,20,10,14,0,44,16,7,9,0,32,1,0,23,24,0.708333,0.291667,12,6
2022020124,2022-10-28,2,CAR,2,6,NYI,26,21,24,2,73,26,5,9,5,45,26,21,24,2,73,26,5,9,5,45,0,1,35,32,0.539683,0.460317,2,6
2022020125,2022-10-28,2,VAN,5,1,PIT,20,6,4,3,33,28,6,16,0,50,20,6,4,2,32,27,6,15,0,48,1,0,29,35,0.509091,0.490909,10,10
2022020126,2022-10-28,2,ARI,2,3,WPG,14,9,8,2,33,25,13,11,3,52,13,9,8,2,32,25,13,11,2,51,1,0,21,35,0.592593,0.407407,12,6
2022020127,2022-10-29,2,DAL,3,6,NYR,25,7,11,3,46,19,15,13,4,51,22,6,10,3,41,17,15,13,4,49,1,0,33,27,0.461538,0.538462,14,12
2022020128,2022-10-29,2,FLA,5,3,OTT,44,10,14,4,72,17,5,11,2,35,40,10,12,4,66,16,4,11,2,33,1,0,58,26,0.555556,0.444444,12,16
2022020129,2022-10-29,2,SJS,3,4,TBL,23,9,11,2,45,19,17,8,4,48,23,9,11,2,45,19,17,8,4,48,0,1,27,26,0.454545,0.545455,4,6
2022020130,2022-10-29,2,PHI,3,4,CAR,17,3,6,2,28,24,12,12,4,52,15,3,6,2,26,19,11,12,3,45,0,1,29,38,0.515152,0.484848,10,14
2022020131,2022-10-29,2,BUF,4,3,CHI,35,7,20,2,64,20,6,10,2,38,35,7,20,2,64,20,6,10,2,38,1,0,45,26,0.27451,0.72549,8,6
2022020132,2022-10-29,2,DET,2,1,MIN,22,9,13,1,45,27,12,17,1,57,21,9,13,1,44,27,12,17,1,57,0,1,25,31,0.45,0.55,4,6
2022020133,2022-10-29,2,STL,4,7,MTL,24,13,10,3,50,14,12,5,5,36,22,13,10,2,47,14,11,5,5,35,1,0,30,25,0.491228,0.508772,8,6
2022020134,2022-10-29,2,LAK,4,2,TOR,17,10,11,2,40,19,13,6,1,39,16,9,11,2,38,18,13,6,1,38,0,1,29,28,0.563636,0.436364,8,12
2022020135,2022-10-29,2,NYI,5,4,COL,36,10,10,5,61,29,8,14,3,54,36,10,10,5,61,29,8,14,3,54,0,1,44,37,0.428571,0.571429,4,6
2022020136,2022-10-29,2,NSH,0,3,WSH,25,10,8,0,43,25,14,13,3,55,25,10,8,0,43,25,14,13,3,55,0,1,34,35,0.612903,0.387097,6,10
2022020137,2022-10-29,2,CGY,2,3,EDM,36,15,14,1,66,18,11,11,2,42,36,15,14,1,66,17,10,10,2,39,1,0,42,26,0.485294,0.514706,8,6
2022020138,2022-10-29,2,SEA,3,1,PIT,22,15,14,3,54,30,13,12,1,56,22,15,14,3,54,30,13,12,1,56,0,1,30,33,0.521739,0.478261,4,4
2022020139,2022-10-30,2,NJD,7,1,CBJ,31,15,16,6,68,18,5,12,1,36,31,15,16,5,67,18,5,11,1,35,1,0,53,21,0.553846,0.446154,6,8
2022020140,2022-10-30,2,CHI,3,4,MIN,24,8,11,3,46,31,14,14,5,64,22,8,10,3,43,28,12,11,3,54,1,0,26,35,0.625,0.375,25,11
2022020141,2022-10-30,2,ARI,2,3,NYR,18,11,11,1,41,30,9,5,2,46,18,11,11,1,41,30,9,5,2,46,0,1,20,39,0.45614,0.54386,6,2
2022020142,2022-10-30,2,ANA,4,3,TOR,32,12,10,4,58,30,11,9,1,51,28,12,10,3,53,26,9,9,1,45,0,1,39,36,0.508772,0.491228,6,6
2022020143,2022-10-30,2,VGK,2,1,WPG,41,11,13,2,67,20,12,20,1,53,41,10,12,1,64,16,11,18,1,46,0,1,48,24,0.589286,0.410714,2,6
2022020144,2022-10-31,2,BUF,8,3,DET,34,11,11,6,62,14,9,4,2,29,34,11,10,6,61,12,9,4,2,27,1,0,46,18,0.492308,0.507692,4,12
2022020145,2022-10-31,2,CAR,3,2,WSH,20,10,13,3,46,17,6,5,2,30,16,8,13,1,38,12,6,5,1,24,1,0,35,20,0.55,0.45,12,16
2022020146,2022-10-31,2,STL,1,5,LAK,19,7,9,1,36,22,15,7,4,48,19,7,9,1,36,22,15,7,4,48,0,1,28,30,0.509434,0.490566,6,8
2022020147,2022-11-01,2,PIT,5,6,BOS,28,13,18,5,64,28,8,11,5,52,26,13,18,5,62,27,7,10,4,48,1,0,38,40,0.449275,0.550725,6,8
2022020148,2022-11-01,2,TBL,4,3,OTT,16,3,14,3,36,8,11,18,2,39,16,3,14,3,36,7,10,17,2,36,0,1,34,15,0.45098,0.54902,13,26
2022020149,2022-11-01,2,NYR,1,0,PHI,27,19,11,1,58,16,7,12,0,35,22,19,11,0,52,16,5,11,0,32,0,0,36,19,0.42,0.58,10,10
2022020150,2022-11-01,2,WSH,2,3,VGK,18,10,20,1,49,26,6,26,2,60,17,10,20,1,48,24,5,22,1,52,1,0,21,31,0.586207,0.413793,6,6
2022020151,2022-11-01,2,MIN,4,1,MTL,17,14,12,3,46,30,10,7,0,47,17,14,12,3,46,30,10,7,0,47,1,0,31,35,0.38,0.62,21,45
2022020152,2022-11-01,2,CHI,1,3,NYI,16,9,10,0,35,23,2,12,2,39,16,9,10,0,35,23,2,12,2,39,0,1,22,33,0.530612,0.469388,8,21
2022020153,2022-11-01,2,DAL,5,2,LAK,32,11,19,2,64,28,9,14,1,52,30,10,19,2,61,28,9,14,1,52,1,0,40,32,0.523077,0.476923,6,8
2022020154,2022-11-01,2,EDM,7,4,NSH,19,10,18,5,52,16,9,10,2,37,19,10,18,5,52,16,9,10,2,37,0,1,37,23,0.537313,0.462687,9,17
2022020155,2022-11-01,2,CGY,4,5,SEA,29,9,14,4,56,15,5,14,3,37,29,9,14,4,56,15,5,14,3,37,0,1,40,26,0.615385,0.384615,13,13
2022020156,2022-11-01,2,ARI,3,1,FLA,13,13,5,1,32,33,13,18,1,65,13,13,4,1,31,32,13,17,1,63,0,1,21,42,0.430769,0.569231,10,12
2022020157,2022-11-01,2,VAN,2,5,NJD,20,12,14,0,46,30,11,11,3,55,20,12,14,0,46,30,11,11,3,55,0,1,23,37,0.423077,0.576923,27,25
2022020158,2022-11-01,2,SJS,5,6,ANA,32,10,7,5,54,29,8,12,7,56,30,9,7,4,50,27,7,9,4,47,0,1,44,44,0.446154,0.553846,15,23
2022020159,2022-11-02,2,TOR,5,2,PHI,29,13,18,3,63,17,6,5,1,29,29,13,18,3,63,17,6,5,1,29,0,1,44,25,0.467742,0.532258,31,39
2022020160,2022-11-02,2,BUF,6,3,PIT,23,7,9,5,44,17,7,11,2,37,23,7,9,5,44,17,7,11,2,37,0,1,33,21,0.457627,0.542373,8,10
2022020161,2022-11-03,2,NYR,2,5,BOS,17,10,10,2,39,24,10,15,5,54,17,10,10,2,39,24,10,15,5,54,0,1,20,37,0.390244,0.609756,16,24
2022020162,2022-11-03,2,TBL,3,4,CAR,21,10,10,2,43,37,11,16,3,67,16,7,9,1,33,34,8,14,1,57,0,1,26,55,0.382353,0.617647,12,12
2022020163,2022-11-03,2,OTT,4,5,VGK,36,13,16,4,69,22,8,5,3,38,36,13,16,4,69,22,8,5,3,38,0,1,46,32,0.5,0.5,8,6
2022020164,2022-11-03,2,DET,3,1,WSH,20,7,6,2,35,28,5,12,1,46,20,7,6,2,35,28,5,12,1,46,0,1,26,34,0.363636,0.636364,10,8
2022020165,2022-11-03,2,WPG,3,2,MTL,30,10,10,2,52,16,10,6,2,34,27,10,10,1,48,14,10,6,2,32,0,1,36,22,0.534884,0.465116,4,10
2022020166,2022-11-03,2,STL,2,5,NYI,32,17,5,1,55,21,11,8,4,44,32,17,5,1,55,21,11,8,4,44,1,0,34,30,0.568627,0.431373,9,11
2022020167,2022-11-03,2,MIN,0,4,SEA,19,5,12,0,36,18,11,7,3,39,19,5,12,0,36,18,11,7,3,39,0,1,22,23,0.488889,0.511111,4,4
2022020168,2022-11-03,2,CHI,2,1,LAK,15,11,9,2,37,32,14,20,1,67,15,11,9,1,36,31,14,20,1,66,1,0,19,33,0.396226,0.603774,9,7
2022020169,2022-11-03,2,CGY,1,4,NSH,24,8,21,1,54,22,12,11,3,48,24,8,21,1,54,22,12,11,3,48,0,1,30,32,0.411765,0.588235,8,6
2022020170,2022-11-03,2,EDM,3,4,NJD,31,12,10,2,55,36,14,16,4,70,31,12,10,2,55,36,14,16,4,70,1,0,37,43,0.5625,0.4375,6,4
2022020171,2022-11-03,2,VAN,8,5,ANA,36,7,6,5,54,22,2,11,3,38,36,7,6,5,54,22,2,11,3,38,0,1,47,31,0.603448,0.396552,11,11
2022020172,2022-11-03,2,ARI,2,7,DAL,26,14,12,2,54,20,6,12,6,44,26,14,12,2,54,20,6,12,6,44,0,1,30,36,0.508475,0.491525,8,2
2022020173,2022-11-03,2,SJS,3,4,FLA,37,10,16,2,65,38,14,18,3,73,31,9,16,2,58,30,13,18,2,63,0,1,39,44,0.424242,0.575758,7,6
2022020174,2022-11-04,2,CAR,5,3,BUF,17,11,6,4,38,17,10,8,2,37,17,11,6,4,38,17,10,8,2,37,0,1,33,25,0.61194,0.38806,12,10
2022020175,2022-11-04,2,COL,6,3,CBJ,21,8,11,4,44,24,4,12,2,42,21,8,11,4,44,24,4,11,2,41,1,0,36,39,0.358025,0.641975,14,10
2022020176,2022-11-05,2,WPG,4,0,CHI,33,16,12,0,61,28,8,6,0,42,33,15,11,0,59,28,8,6,0,42,1,0,37,30,0.481481,0.518519,6,8
2022020177,2022-11-05,2,EDM,2,6,DAL,22,8,9,1,40,21,14,9,4,48,22,8,9,1,40,21,14,9,4,48,0,1,30,36,0.5,0.5,6,12
2022020178,2022-11-05,2,WSH,2,3,ARI,30,12,15,1,58,18,9,5,3,35,30,12,15,1,58,18,9,5,3,35,1,0,36,26,0.561404,0.438596,6,6
2022020179,2022-11-05,2,TOR,2,1,BOS,23,8,9,1,41,18,11,13,0,42,23,8,9,1,41,18,11,13,0,42,1,0,28,21,0.545455,0.454545,6,6
2022020180,2022-11-05,2,TBL,5,3,BUF,22,9,10,4,45,17,11,14,2,44,22,9,10,4,45,17,11,14,2,44,1,0,30,24,0.492308,0.507692,6,4
2022020181,2022-11-05,2,DET,3,0,NYI,18,8,8,1,35,19,13,22,0,54,18,8,8,1,35,19,13,22,0,54,1,0,26,24,0.396226,0.603774,6,10
2022020182,2022-11-05,2,OTT,1,2,PHI,27,14,24,1,66,21,9,19,1,50,27,14,24,1,66,21,8,19,1,49,1,0,34,28,0.586207,0.413793,6,10
2022020183,2022-11-05,2,PIT,2,3,SEA,29,20,17,2,68,21,9,7,3,40,29,20,17,2,68,21,9,7,3,40,1,0,37,28,0.571429,0.428571,6,6
2022020184,2022-11-05,2,MTL,4,6,VGK,26,8,17,3,54,26,5,24,4,59,25,8,16,3,52,25,5,21,4,55,0,1,31,42,0.431034,0.568966,21,6
2022020185,2022-11-05,2,CBJ,1,5,COL,31,6,13,0,50,39,10,20,5,74,31,6,13,0,50,39,10,20,5,74,0,1,32,45,0.430769,0.569231,7,7
2022020186,2022-11-05,2,VAN,3,4,NSH,33,7,11,2,53,24,14,11,3,52,30,5,11,2,48,20,12,10,2,44,1,0,45,30,0.506849,0.493151,30,18
2022020187,2022-11-05,2,CGY,3,4,NJD,18,11,15,3,47,24,10,9,3,46,18,11,14,3,46,22,10,9,3,44,1,0,30,35,0.478261,0.521739,14,8
2022020188,2022-11-05,2,SJS,4,5,ANA,42,10,19,5,76,21,14,9,7,51,35,7,13,3,58,15,11,8,4,38,1,0,52,25,0.557377,0.442623,9,19
2022020189,2022-11-05,2,LAK,5,4,FLA,21,8,13,4,46,30,19,16,4,69,20,8,13,4,45,28,19,16,4,67,0,1,39,38,0.521739,0.478261,4,22
2022020190,2022-11-06,2,NYR,2,3,DET,26,10,20,1,57,24,5,12,2,43,26,10,20,1,57,22,5,11,2,40,1,0,29,36,0.47541,0.52459,8,4
2022020191,2022-11-06,2,CAR,1,3,TOR,28,21,13,0,62,17,13,9,3,42,28,21,13,0,62,17,13,9,3,42,1,0,30,21,0.5,0.5,2,4
2022020192,2022-11-06,2,ANA,3,5,FLA,29,10,11,2,52,40,8,29,3,80,28,9,11,2,50,38,7,27,2,74,0,1,35,48,0.4,0.6,12,6
2022020193,2022-11-07,2,NYI,4,3,CGY,25,9,19,3,56,43,9,18,3,73,25,9,18,3,55,38,9,17,3,67,0,1,32,46,0.542373,0.457627,0,4
2022020194,2022-11-07,2,BOS,3,1,STL,27,9,17,1,54,23,9,11,1,44,25,9,17,1,52,23,8,10,1,42,1,0,37,27,0.566038,0.433962,8,6
2022020195,2022-11-07,2,WSH,5,4,EDM,24,14,16,1,55,24,13,12,4,53,22,13,16,1,52,22,13,12,3,50,1,0,31,29,0.521739,0.478261,4,12
2022020196,2022-11-08,2,BUF,1,4,ARI,23,16,9,0,48,16,3,6,3,28,23,15,9,0,47,14,2,4,3,23,0,1,33,24,0.603448,0.396552,10,12
2022020197,2022-11-08,2,NJD,3,2,CGY,12,9,15,2,38,28,15,7,0,50,12,9,15,2,38,28,15,7,0,50,0,1,20,35,0.507937,0.492063,13,15
2022020198,2022-11-08,2,NYR,3,4,NYI,29,8,13,1,51,17,6,15,2,40,29,8,13,1,51,17,6,15,2,40,0,1,40,26,0.571429,0.428571,6,8
2022020199,2022-11-08,2,PHI,5,1,STL,29,13,9,5,56,21,15,17,1,54,29,13,8,4,54,20,14,17,1,52,1,0,35,28,0.4,0.6,14,12
2022020200,2022-11-08,2,OTT,4,6,VAN,31,16,11,2,60,17,5,7,6,35,31,16,11,2,60,17,5,7,6,35,1,0,41,28,0.565217,0.434783,13,17
2022020201,2022-11-08,2,TOR,3,4,VGK,22,10,11,3,46,14,11,9,3,37,22,10,11,3,46,14,11,8,2,35,0,1,31,20,0.612245,0.387755,4,4
2022020202,2022-11-08,2,TBL,2,3,EDM,29,6,15,2,52,20,7,10,0,37,29,6,15,2,52,20,6,9,0,35,0,1,37,29,0.533333,0.466667,8,10
2022020203,2022-11-08,2,DET,2,3,MTL,26,11,10,2,49,29,3,11,2,45,22,10,9,2,43,24,2,11,2,39,0,1,43,33,0.472727,0.527273,4,35
2022020204,2022-11-08,2,WPG,5,1,DAL,27,7,9,5,48,21,9,15,1,46,25,7,9,5,46,21,8,14,1,44,0,1,33,22,0.489796,0.510204,9,9
2022020205,2022-11-08,2,SEA,5,1,NSH,13,8,14,5,40,21,17,21,1,60,13,8,14,5,40,21,17,21,1,60,1,0,20,25,0.413043,0.586957,4,2
2022020206,2022-11-08,2,LAK,1,0,MIN,23,14,14,1,52,16,11,11,0,38,23,14,14,1,52,16,11,11,0,38,1,0,30,21,0.571429,0.428571,2,11
2022020207,2022-11-09,2,FLA,3,0,CAR,19,10,7,2,38,29,7,14,0,50,19,10,7,2,38,29,7,14,0,50,1,0,37,40,0.453125,0.546875,6,8
2022020208,2022-11-09,2,WSH,1,4,PIT,20,12,17,1,50,19,10,13,3,45,20,12,17,1,50,19,10,13,3,45,0,1,25,28,0.490566,0.509434,11,13
2022020209,2022-11-09,2,MTL,5,2,VAN,22,5,6,4,37,26,7,14,2,49,22,5,6,4,37,26,7,14,2,49,1,0,29,33,0.471698,0.528302,6,10
2022020210,2022-11-09,2,ANA,1,4,MIN,19,9,4,1,33,30,7,13,2,52,19,9,4,1,33,29,7,13,2,51,1,0,32,39,0.5,0.5,57,53
2022020211,2022-11-10,2,BOS,3,1,CGY,10,8,3,3,24,24,10,10,1,45,10,8,3,3,24,24,9,10,1,44,0,1,28,32,0.678571,0.321429,17,15
2022020212,2022-11-10,2,CAR,7,2,EDM,23,18,15,6,62,16,17,5,1,39,23,18,15,6,62,16,16,5,1,38,1,0,32,22,0.555556,0.444444,4,8
2022020213,2022-11-10,2,NJD,4,3,OTT,33,20,18,3,74,21,16,8,2,47,32,18,17,3,70,19,15,8,2,44,1,0,41,28,0.5,0.5,8,6
2022020214,2022-11-10,2,CBJ,5,2,PHI,20,9,9,5,43,31,13,18,2,64,20,9,9,5,43,29,12,18,2,61,1,0,29,34,0.52381,0.47619,7,11
2022020215,2022-11-10,2,BUF,4,7,VGK,24,12,21,1,58,27,5,12,6,50,23,12,21,1,57,27,5,12,6,50,0,1,35,36,0.414286,0.585714,4,6
2022020216,2022-11-10,2,NYI,0,2,ARI,20,17,12,0,49,24,7,16,1,48,20,17,12,0,49,24,7,16,1,48,0,1,24,28,0.701754,0.298246,11,11
2022020217,2022-11-10,2,DET,2,8,NYR,18,5,9,2,34,20,9,12,6,47,18,5,9,2,34,20,9,12,6,47,0,1,20,33,0.511111,0.488889,6,4
2022020218,2022-11-10,2,STL,5,3,SJS,25,14,9,4,52,27,15,13,3,58,25,14,9,4,52,27,15,13,3,58,1,0,33,30,0.484848,0.515152,0,4
2022020219,2022-11-10,2,COL,5,3,NSH,21,14,11,3,49,30,7,20,2,59,21,14,11,3,49,30,7,20,2,59,0,1,35,35,0.449275,0.550725,4,6
2022020220,2022-11-10,2,LAK,2,1,CHI,27,13,18,2,60,21,6,10,0,37,23,11,15,1,50,14,5,10,0,29,0,1,35,32,0.315789,0.684211,8,8
2022020221,2022-11-11,2,TOR,2,4,PIT,19,13,15,1,48,16,13,12,4,45,19,13,15,1,48,16,13,12,4,45,1,0,30,23,0.5,0.5,2,6
2022020222,2022-11-11,2,WSH,5,1,TBL,15,12,12,5,44,18,8,14,1,41,15,11,12,5,43,18,8,14,1,41,1,0,24,29,0.377778,0.622222,38,41
2022020223,2022-11-11,2,DAL,4,5,SJS,24,18,24,4,70,9,6,6,4,25,24,18,24,4,70,9,6,6,4,25,1,0,29,18,0.52459,0.47541,11,9
2022020224,2022-11-11,2,SEA,0,1,MIN,28,11,15,0,54,15,8,5,1,29,28,11,15,0,54,15,8,5,1,29,0,1,28,21,0.58,0.42,6,8
2022020225,2022-11-12,2,PHI,1,4,OTT,31,7,10,1,49,17,7,13,2,39,31,7,10,1,49,17,7,13,2,39,1,0,38,27,0.551724,0.448276,16,16
2022020226,2022-11-12,2,FLA,2,4,EDM,32,10,13,1,56,21,2,7,3,33,31,10,12,1,54,20,2,6,3,31,0,1,42,32,0.465517,0.534483,10,6
2022020227,2022-11-12,2,NJD,4,2,ARI,16,11,6,3,36,14,9,5,0,28,15,9,5,3,32,12,9,4,0,25,1,0,26,18,0.58209,0.41791,12,18
2022020228,2022-11-12,2,BUF,1,3,BOS,26,10,10,0,46,23,8,9,2,42,26,10,10,0,46,22,7,9,2,40,1,0,31,30,0.525424,0.474576,8,8
2022020229,2022-11-12,2,MTL,5,4,PIT,30,2,18,4,54,16,12,7,3,38,28,2,18,3,51,15,12,7,2,36,1,0,42,24,0.460317,0.539683,8,12
2022020230,2022-11-12,2,TOR,3,2,VAN,28,16,11,2,57,21,9,11,1,42,28,16,11,2,57,21,9,11,1,42,0,1,34,29,0.5625,0.4375,8,4
2022020231,2022-11-12,2,NYI,4,3,CBJ,31,11,16,4,62,24,12,13,2,51,31,11,16,3,61,24,12,13,2,51,0,1,46,29,0.557377,0.442623,4,4
2022020232,2022-11-12,2,NSH,2,1,NYR,11,8,10,2,31,25,9,15,1,50,11,8,8,2,29,23,8,15,1,47,1,0,18,35,0.490196,0.509804,22,20
2022020233,2022-11-12,2,COL,4,1,CAR,12,1,4,3,20,23,12,14,1,50,12,1,4,3,20,23,11,14,1,49,1,0,28,25,0.38,0.62,10,8
2022020234,2022-11-12,2,ANA,2,3,CHI,35,12,12,2,61,17,12,6,3,38,35,12,12,2,61,17,12,6,3,38,1,0,41,22,0.370968,0.629032,6,8
2022020235,2022-11-12,2,VGK,2,3,STL,34,8,23,1,66,16,5,17,3,41,34,8,23,1,66,16,5,17,3,41,0,1,36,28,0.603175,0.396825,8,0
2022020236,2022-11-12,2,CGY,3,2,WPG,28,6,10,2,46,21,8,16,2,47,23,6,10,2,41,20,8,16,1,45,1,0,35,23,0.465517,0.534483,10,10
2022020237,2022-11-12,2,LAK,4,3,DET,16,12,17,2,47,15,9,19,1,44,16,12,17,2,47,15,9,19,1,44,1,0,21,21,0.576923,0.423077,8,6
2022020238,2022-11-13,2,PHI,1,5,DAL,27,8,14,1,50,20,11,9,2,42,27,8,14,1,50,20,11,9,2,42,0,1,38,31,0.258621,0.741379,6,12
2022020239,2022-11-13,2,NYR,4,1,ARI,14,1,12,3,30,22,7,13,0,42,12,1,11,3,27,21,7,13,0,41,1,0,27,32,0.384615,0.615385,14,10
2022020240,2022-11-13,2,MIN,2,3,SJS,27,21,12,2,62,32,16,11,4,63,22,19,12,1,54,27,13,11,2,53,1,0,30,37,0.482143,0.517857,6,4
2022020241,2022-11-13,2,BOS,5,2,VAN,20,7,9,2,38,20,9,9,0,38,20,6,9,1,36,20,9,8,0,37,1,0,33,31,0.637931,0.362069,32,22
2022020242,2022-11-13,2,TBL,6,3,WSH,24,14,12,4,54,16,10,7,3,36,23,14,12,4,53,14,10,7,3,34,1,0,35,22,0.453125,0.546875,22,20
2022020243,2022-11-13,2,SEA,2,3,WPG,15,10,8,1,34,13,17,17,1,48,15,10,8,1,34,13,17,17,0,47,1,0,21,30,0.565217,0.434783,16,10
2022020244,2022-11-14,2,OTT,2,4,NYI,25,19,17,1,62,27,5,5,2,39,25,19,17,1,62,27,5,5,2,39,0,1,38,35,0.491525,0.508475,11,17
2022020245,2022-11-14,2,CHI,0,3,CAR,18,3,6,0,27,18,11,11,3,43,18,3,6,0,27,18,11,11,3,43,0,1,27,32,0.612903,0.387097,6,8
2022020246,2022-11-14,2,CGY,6,5,LAK,20,8,14,5,47,19,9,12,4,44,19,8,14,5,46,14,8,10,2,34,1,0,30,29,0.492537,0.507463,8,8
2022020247,2022-11-14,2,COL,2,3,STL,38,14,15,1,68,33,10,7,2,52,38,14,15,1,68,33,10,7,2,52,1,0,47,39,0.483871,0.516129,4,10
2022020248,2022-11-15,2,TBL,5,4,DAL,26,11,9,4,50,24,10,10,1,45,22,11,8,3,44,22,10,9,1,42,1,0,38,32,0.513158,0.486842,6,12
2022020249,2022-11-15,2,MTL,1,5,NJD,22,9,19,1,51,27,9,21,4,61,22,9,19,1,51,27,9,21,4,61,0,1,26,39,0.548387,0.451613,4,4
2022020250,2022-11-15,2,CBJ,5,4,PHI,28,6,17,4,55,29,15,22,3,69,25,6,16,3,50,27,14,21,3,65,1,0,33,37,0.52459,0.47541,6,4
2022020251,2022-11-15,2,PIT,2,5,TOR,27,12,22,2,63,24,11,15,5,55,26,12,20,2,60,23,11,15,5,54,0,1,37,33,0.54902,0.45098,4,8
2022020252,2022-11-15,2,BUF,4,5,VAN,23,10,18,4,55,23,10,9,3,45,23,10,18,4,55,23,10,9,3,45,0,1,32,32,0.4375,0.5625,6,6
2022020253,2022-11-15,2,FLA,5,2,WSH,30,5,16,4,55,27,15,17,2,61,30,5,16,4,55,27,15,16,1,59,1,0,43,43,0.45,0.55,12,4
2022020254,2022-11-15,2,NSH,2,1,MIN,15,7,7,1,30,24,15,13,1,53,14,7,7,1,29,23,15,13,1,52,1,0,25,33,0.54717,0.45283,24,22
2022020255,2022-11-15,2,ANA,3,2,DET,23,14,19,2,58,28,10,10,1,49,22,14,18,1,55,23,10,8,1,42,0,1,30,33,0.448276,0.551724,8,10
2022020256,2022-11-15,2,VGK,2,5,SJS,22,8,13,2,45,22,6,20,4,52,22,8,13,2,45,22,6,20,4,52,1,0,26,29,0.559322,0.440678,4,6
2022020257,2022-11-16,2,OTT,4,1,BUF,26,6,7,3,42,20,7,17,0,44,24,5,6,3,38,19,7,17,0,43,1,0,40,30,0.571429,0.428571,18,14
2022020258,2022-11-16,2,CHI,2,5,STL,18,9,12,1,40,27,7,7,4,45,18,9,12,1,40,27,7,7,4,45,0,1,27,35,0.58,0.42,4,6
2022020259,2022-11-16,2,EDM,1,3,LAK,22,9,28,1,60,26,4,7,3,40,22,9,28,1,60,26,4,7,3,40,0,1,23,32,0.444444,0.555556,10,6
2022020260,2022-11-17,2,TBL,4,1,CGY,17,9,10,3,39,35,10,17,0,62,16,9,10,3,38,34,10,17,0,61,1,0,24,40,0.514286,0.485714,8,6
2022020261,2022-11-17,2,CAR,2,3,COL,36,11,13,2,62,10,7,6,2,25,32,10,12,2,56,9,7,5,1,22,0,1,48,15,0.68254,0.31746,8,10
2022020262,2022-11-17,2,FLA,4,6,DAL,34,7,12,2,55,15,9,12,6,42,34,7,12,2,55,15,9,12,6,42,0,1,44,29,0.454545,0.545455,13,15
2022020263,2022-11-17,2,CBJ,6,4,MTL,21,13,10,6,50,38,10,16,3,67,21,13,10,6,50,36,10,15,3,64,1,0,29,42,0.514706,0.485294,11,9
2022020264,2022-11-17,2,TOR,2,3,NJD,22,8,14,1,45,28,10,9,3,50,21,8,14,1,44,26,10,9,2,47,1,0,27,33,0.6,0.4,4,10
2022020265,2022-11-17,2,BOS,4,1,PHI,20,11,15,2,48,21,11,8,0,40,20,11,15,2,48,21,11,8,0,40,1,0,32,23,0.5,0.5,8,8
2022020266,2022-11-17,2,WPG,3,2,ANA,26,8,12,2,48,24,9,9,2,44,26,8,12,2,48,24,9,9,2,44,0,1,32,31,0.584906,0.415094,19,11
2022020267,2022-11-17,2,NSH,5,4,NYI,23,13,8,4,48,23,16,16,3,58,23,12,8,4,47,21,15,14,3,53,1,0,31,33,0.518519,0.481481,8,8
2022020268,2022-11-17,2,MIN,4,6,PIT,15,11,10,3,39,17,9,14,4,44,15,11,10,3,39,16,9,14,4,43,0,1,23,32,0.423729,0.576271,10,6
2022020269,2022-11-17,2,STL,5,4,WSH,21,9,8,5,43,45,14,15,3,77,13,4,7,3,27,36,13,15,2,66,1,0,24,51,0.647059,0.352941,8,8
2022020270,2022-11-17,2,VGK,4,1,ARI,22,6,8,3,39,19,9,14,1,43,22,6,8,3,39,19,9,14,1,43,1,0,39,26,0.471698,0.528302,13,15
2022020271,2022-11-17,2,SEA,3,2,NYR,26,17,9,3,55,22,11,11,0,44,25,17,8,2,52,20,11,11,0,42,1,0,32,30,0.55102,0.44898,8,8
2022020272,2022-11-17,2,SJS,4,7,DET,19,15,19,4,57,10,11,11,7,39,19,15,19,4,57,10,11,11,7,39,1,0,25,21,0.509091,0.490909,6,2
2022020273,2022-11-18,2,VAN,4,1,LAK,20,6,14,3,43,31,13,9,1,54,20,6,14,3,43,30,13,9,1,53,1,0,25,38,0.5,0.5,4,6
2022020274,2022-11-19,2,OTT,1,5,NJD,19,12,10,1,42,21,8,10,3,42,19,12,10,1,42,21,8,10,3,42,0,1,26,36,0.591549,0.408451,8,4
2022020275,2022-11-19,2,FLA,4,5,CGY,29,11,11,4,55,28,11,12,5,56,22,11,11,3,47,24,10,11,3,48,0,1,35,35,0.459459,0.540541,13,13
2022020276,2022-11-19,2,TOR,5,2,BUF,17,5,10,2,34,18,7,16,0,41,17,5,10,2,34,18,7,16,0,41,1,0,23,34,0.62,0.38,12,6
2022020277,2022-11-19,2,BOS,6,1,CHI,31,17,9,4,61,15,5,8,0,28,31,17,9,4,61,15,5,8,0,28,1,0,43,18,0.444444,0.555556,6,6
2022020278,2022-11-19,2,WSH,0,4,COL,31,9,15,0,55,20,16,10,3,49,31,9,15,0,55,20,16,10,3,49,0,1,32,29,0.592593,0.407407,6,4
2022020279,2022-11-19,2,CBJ,1,6,DET,23,12,13,1,49,24,7,13,4,48,21,12,13,1,47,23,7,13,4,47,0,1,28,37,0.580645,0.419355,8,6
2022020280,2022-11-19,2,MTL,5,4,PHI,24,15,17,4,60,23,15,15,4,57,22,13,17,3,55,21,13,14,4,52,0,1,32,29,0.653846,0.346154,13,11
2022020281,2022-11-19,2,WPG,0,3,PIT,27,13,5,0,45,27,12,7,3,49,27,13,5,0,45,27,12,7,3,49,0,1,32,32,0.52381,0.47619,4,4
2022020282,2022-11-19,2,STL,6,2,ANA,25,3,9,5,42,22,9,20,0,51,24,3,8,5,40,22,9,20,0,51,1,0,34,32,0.482759,0.517241,15,11
2022020283,2022-11-19,2,MIN,2,1,CAR,18,13,13,2,46,19,17,16,1,53,17,12,13,1,43,18,16,15,1,50,0,1,21,21,0.615385,0.384615,6,4
2022020284,2022-11-19,2,DAL,5,2,NYI,21,10,11,5,47,20,9,12,1,42,21,10,11,5,47,20,9,12,1,42,0,1,35,29,0.637931,0.362069,10,14
2022020285,2022-11-19,2,NSH,2,3,TBL,24,5,7,1,37,30,8,19,1,58,20,5,7,1,33,28,8,18,1,55,1,0,32,39,0.5,0.5,12,12
2022020286,2022-11-19,2,SEA,3,2,LAK,24,8,7,2,41,26,12,22,1,61,24,8,6,1,39,24,12,22,1,59,1,0,29,29,0.583333,0.416667,2,6
2022020287,2022-11-19,2,EDM,4,3,VGK,15,12,10,3,40,22,7,15,3,47,15,12,10,2,39,22,7,15,2,46,1,0,23,34,0.444444,0.555556,6,6
2022020288,2022-11-19,2,SJS,1,2,NYR,18,13,8,1,40,36,9,14,2,61,18,13,8,1,40,36,9,14,2,61,0,1,23,43,0.6,0.4,6,2
2022020289,2022-11-20,2,CBJ,5,3,FLA,17,11,3,2,33,42,12,23,3,80,17,11,3,2,33,42,12,23,3,80,0,1,23,50,0.533333,0.466667,6,4
2022020290,2022-11-20,2,CHI,3,5,PIT,25,8,12,3,48,17,9,15,5,46,25,7,11,2,45,17,9,14,5,45,0,1,32,25,0.451613,0.548387,14,18
2022020291,2022-11-21,2,TBL,3,5,BOS,31,9,6,2,48,19,4,9,3,35,31,9,6,2,48,19,4,9,3,35,1,0,35,29,0.48,0.52,8,6
2022020292,2022-11-21,2,PHI,2,5,CGY,18,3,15,2,38,21,10,13,5,49,18,3,15,2,38,21,10,13,5,49,0,1,25,30,0.5,0.5,11,13
2022020293,2022-11-21,2,NJD,5,2,EDM,21,18,12,4,55,21,8,10,1,40,21,18,12,4,55,21,8,10,1,40,1,0,28,30,0.462963,0.537037,8,6
2022020294,2022-11-21,2,WPG,4,3,CAR,15,8,8,4,35,20,28,18,3,69,13,8,8,3,32,19,26,18,3,66,1,0,23,27,0.487805,0.512195,4,6
2022020295,2022-11-21,2,TOR,2,3,NYI,28,16,12,1,57,20,14,8,3,45,28,15,12,1,56,19,14,8,2,43,0,1,32,24,0.525424,0.474576,11,13
2022020296,2022-11-21,2,STL,3,1,ANA,22,8,10,2,42,24,7,12,1,44,22,8,10,2,42,24,7,12,1,44,1,0,27,28,0.62,0.38,4,6
2022020297,2022-11-21,2,NSH,4,3,ARI,33,13,9,5,60,27,8,8,5,48,25,12,9,1,47,21,7,8,2,38,1,0,45,27,0.546875,0.453125,11,21
2022020298,2022-11-21,2,DAL,2,3,COL,16,7,20,2,45,23,7,15,2,47,14,6,18,2,40,20,6,14,1,41,0,1,24,35,0.648148,0.351852,27,7
2022020299,2022-11-21,2,SJS,5,1,OTT,18,10,13,4,45,32,8,14,1,55,18,10,13,4,45,32,8,14,1,55,1,0,31,38,0.433333,0.566667,9,11
2022020300,2022-11-21,2,VAN,4,5,VGK,24,7,14,4,49,32,8,10,5,55,24,7,14,4,49,32,8,10,5,55,1,0,29,38,0.538462,0.461538,2,2
2022020301,2022-11-22,2,MTL,2,7,BUF,18,3,8,2,31,25,5,17,5,52,18,3,8,2,31,24,5,17,5,51,0,1,31,38,0.54717,0.45283,17,21
2022020302,2022-11-22,2,LAK,3,5,NYR,35,5,14,2,56,20,7,19,5,51,34,4,14,2,54,20,7,19,5,51,1,0,38,25,0.525424,0.474576,2,4
2022020303,2022-11-23,2,CAR,0,4,ARI,29,11,25,0,65,14,5,9,4,32,29,11,25,0,65,14,5,9,4,32,0,1,36,27,0.571429,0.428571,11,13
2022020304,2022-11-23,2,FLA,5,2,BOS,20,9,8,2,39,32,6,14,0,52,20,9,7,2,38,32,6,11,0,49,1,0,31,39,0.412698,0.587302,12,14
2022020305,2022-11-23,2,PIT,2,1,CGY,32,9,16,4,61,30,13,11,3,57,31,7,15,1,54,28,9,11,1,49,1,0,39,34,0.542373,0.457627,6,6
2022020306,2022-11-23,2,CBJ,1,3,MTL,24,9,17,1,51,24,5,13,3,45,22,9,17,1,49,23,4,13,3,43,1,0,31,29,0.545455,0.454545,11,11
2022020307,2022-11-23,2,BUF,6,2,STL,21,11,11,4,47,31,11,10,1,53,20,10,10,4,44,31,11,10,1,53,1,0,32,36,0.538462,0.461538,8,8
2022020308,2022-11-23,2,NJD,1,2,TOR,23,12,18,1,54,12,9,8,2,31,23,12,18,1,54,12,9,8,2,31,0,1,35,20,0.590164,0.409836,8,6
2022020309,2022-11-23,2,MIN,6,1,WPG,27,4,9,4,44,26,9,16,1,52,25,4,8,4,41,24,9,15,1,49,1,0,39,29,0.578947,0.421053,13,19
2022020310,2022-11-23,2,NYI,3,0,EDM,24,5,9,1,39,35,7,9,0,51,23,5,9,1,38,35,7,9,0,51,1,0,31,49,0.521127,0.478873,10,4
2022020311,2022-11-23,2,DET,3,0,NSH,19,7,7,2,35,21,12,22,0,55,19,7,7,2,35,21,12,22,0,55,1,0,29,26,0.604651,0.395349,6,4
2022020312,2022-11-23,2,WSH,3,2,PHI,19,14,17,2,52,17,10,13,2,42,18,12,16,1,47,17,10,13,2,42,0,1,32,23,0.576923,0.423077,8,6
2022020313,2022-11-23,2,DAL,6,4,CHI,32,12,27,5,76,22,9,9,4,44,32,12,27,5,76,22,9,9,4,44,1,0,39,31,0.538462,0.461538,9,9
2022020314,2022-11-23,2,ANA,3,2,NYR,17,11,8,3,39,36,13,16,2,67,17,11,8,3,39,36,13,16,2,67,0,1,22,43,0.521739,0.478261,8,6
2022020315,2022-11-23,2,VGK,4,1,OTT,21,7,11,3,42,35,17,24,0,76,21,7,11,3,42,35,17,24,0,76,1,0,36,40,0.553846,0.446154,4,8
2022020316,2022-11-23,2,SEA,8,5,SJS,17,8,15,7,47,17,10,14,4,45,17,8,15,7,47,17,10,14,4,45,0,1,27,26,0.45614,0.54386,6,8
2022020317,2022-11-23,2,COL,3,4,VAN,20,8,16,1,45,14,3,6,4,27,20,8,16,1,45,14,3,6,3,26,0,1,36,25,0.472222,0.527778,10,12
2022020318,2022-11-25,2,BOS,3,2,CAR,27,7,12,2,48,23,4,2,0,29,26,7,12,2,47,20,4,2,0,26,0,1,41,36,0.571429,0.428571,12,12
2022020319,2022-11-25,2,WSH,3,0,CGY,19,9,17,2,47,28,9,14,0,51,19,9,17,2,47,28,9,14,0,51,1,0,25,32,0.5,0.5,4,4
2022020320,2023-04-14,2,NSH,3,4,COL,18,6,11,2,37,26,9,16,4,55,18,6,11,2,37,26,9,16,4,55,0,1,21,34,0.612245,0.387755,8,4
2022020321,2022-11-25,2,CHI,2,3,MTL,19,10,11,3,43,19,12,10,4,45,17,9,10,1,37,19,10,9,1,39,0,1,32,23,0.568627,0.431373,4,8
2022020322,2022-11-25,2,MIN,3,4,TOR,19,13,22,2,56,19,10,10,4,43,19,13,22,2,56,19,10,10,4,43,0,1,28,28,0.444444,0.555556,6,4
2022020323,2022-11-25,2,ANA,1,5,OTT,18,5,11,1,35,19,10,14,2,45,16,4,11,1,32,19,10,14,2,45,0,1,32,33,0.43662,0.56338,21,17
2022020324,2022-11-25,2,PHI,1,4,PIT,29,7,8,1,45,21,6,19,4,50,26,6,7,1,40,21,6,19,4,50,0,1,30,29,0.369565,0.630435,15,11
2022020325,2022-11-25,2,DET,4,3,ARI,26,19,8,2,55,14,10,6,3,33,20,18,6,1,45,10,8,6,3,27,1,0,36,24,0.566038,0.433962,15,15
2022020326,2022-11-25,2,CBJ,2,3,NYI,21,11,12,0,44,14,10,19,2,45,21,9,12,0,42,11,9,19,1,40,0,1,26,24,0.517241,0.482759,15,15
2022020327,2022-11-25,2,BUF,1,3,NJD,30,9,14,1,54,37,11,18,3,69,30,9,14,1,54,37,11,18,3,69,0,1,34,44,0.428571,0.571429,2,2
2022020328,2022-11-25,2,TBL,5,2,STL,20,16,9,4,49,22,6,15,1,44,20,16,9,4,49,22,6,15,1,44,1,0,27,27,0.458333,0.541667,13,11
2022020329,2022-11-25,2,VGK,2,4,SEA,19,8,14,1,42,22,8,19,4,53,19,8,14,1,42,22,8,19,4,53,0,1,22,28,0.574074,0.425926,4,2
2022020330,2022-11-25,2,DAL,4,5,WPG,27,12,13,3,55,18,8,11,5,42,27,12,12,3,54,18,8,11,4,41,0,1,41,28,0.692308,0.307692,6,20
2022020331,2022-11-25,2,SJS,2,5,LAK,25,13,19,2,59,21,10,13,4,48,25,13,19,2,59,21,10,13,4,48,0,1,31,29,0.477612,0.522388,4,6
2022020332,2022-11-26,2,NYR,3,4,EDM,16,3,9,3,31,24,21,11,3,59,16,3,8,3,30,22,20,10,3,55,1,0,23,32,0.490909,0.509091,6,6
2022020333,2022-11-26,2,CAR,3,2,CGY,28,15,12,1,56,15,13,10,1,39,28,14,12,1,55,15,13,10,1,39,1,0,33,20,0.428571,0.571429,8,8
2022020334,2022-11-26,2,FLA,4,5,STL,29,7,6,3,45,27,4,10,5,46,29,7,6,3,45,26,4,10,4,44,1,0,37,37,0.46,0.54,15,11
2022020335,2022-11-26,2,PIT,1,4,TOR,22,11,10,1,44,28,5,10,4,47,22,11,10,1,44,28,5,10,4,47,0,1,26,41,0.491228,0.508772,6,4
2022020336,2022-11-26,2,NJD,5,1,WSH,22,4,4,4,34,28,12,22,0,62,22,4,4,4,34,28,12,22,0,62,1,0,29,38,0.519231,0.480769,10,8
2022020337,2022-11-26,2,NYI,5,2,PHI,13,9,9,3,34,23,14,8,2,47,13,9,9,3,34,23,14,8,2,47,1,0,23,28,0.52381,0.47619,23,27
2022020338,2023-01-17,2,NSH,2,1,CBJ,23,16,11,2,52,26,10,9,1,46,23,16,11,2,52,26,10,9,1,46,1,0,28,40,0.490196,0.509804,6,6
2022020339,2022-11-26,2,COL,4,1,DAL,24,3,7,3,37,25,5,8,0,38,24,3,7,3,37,25,5,8,0,38,1,0,36,42,0.368421,0.631579,15,33
2022020340,2022-11-26,2,VGK,1,5,VAN,19,15,14,1,49,25,8,15,2,50,19,15,14,1,49,25,8,15,2,50,0,1,27,36,0.603448,0.396552,20,26
2022020341,2022-11-27,2,MIN,4,3,ARI,22,7,14,3,46,19,9,7,3,38,21,7,14,2,44,19,9,7,3,38,1,0,29,23,0.551724,0.448276,19,13
2022020342,2022-11-27,2,CHI,2,7,WPG,19,13,7,1,40,28,3,14,5,50,19,13,7,1,40,28,3,14,5,50,0,1,25,44,0.44898,0.55102,12,8
2022020343,2022-11-27,2,ANA,4,5,SEA,22,10,8,1,41,17,8,8,4,37,22,10,8,1,41,17,8,8,4,37,0,1,29,25,0.586207,0.413793,4,8
2022020344,2022-11-27,2,SJS,3,4,VAN,31,12,15,2,60,15,12,24,4,55,31,12,15,2,60,15,12,24,3,54,0,1,35,20,0.563636,0.436364,4,2
2022020345,2022-11-27,2,LAK,2,3,OTT,24,13,17,0,54,33,10,20,2,65,24,13,17,0,54,33,10,20,1,64,0,1,27,39,0.515152,0.484848,4,4
2022020346,2022-11-28,2,NYR,3,5,NJD,27,8,11,2,48,24,12,8,5,49,27,8,11,2,48,24,11,8,5,48,1,0,38,38,0.404255,0.595745,6,10
2022020347,2022-11-28,2,BUF,5,6,TBL,29,12,10,5,56,17,18,8,3,46,22,10,9,5,46,17,17,8,2,44,0,1,37,25,0.4,0.6,10,4
2022020348,2022-11-28,2,DET,2,4,TOR,39,6,22,2,69,18,3,5,3,29,39,6,22,2,69,17,3,5,3,28,1,0,44,25,0.44,0.56,4,6
2022020349,2022-11-28,2,CBJ,2,3,VGK,29,14,14,3,60,28,18,12,4,62,23,12,14,2,51,26,11,11,2,50,0,1,28,36,0.444444,0.555556,8,4
2022020350,2022-11-28,2,STL,1,4,DAL,22,11,8,1,42,19,10,21,4,54,22,11,8,1,42,19,10,21,4,54,0,1,24,24,0.361702,0.638298,7,7
2022020351,2022-11-28,2,EDM,4,3,FLA,30,8,14,3,55,23,9,7,2,41,30,8,14,2,54,21,8,7,2,38,0,1,40,28,0.578125,0.421875,8,10
2022020352,2022-11-29,2,PIT,2,3,CAR,29,5,14,2,50,32,11,11,3,57,29,5,14,2,50,32,11,10,2,55,1,0,32,39,0.473684,0.526316,4,4
2022020353,2022-11-29,2,PHI,3,1,NYI,26,6,13,2,47,17,6,15,0,38,25,6,13,2,46,17,6,15,0,38,0,1,33,24,0.490909,0.509091,20,16
2022020354,2022-11-29,2,MTL,0,4,SJS,24,10,19,0,53,6,6,4,4,20,24,10,19,0,53,6,6,4,4,20,0,1,28,24,0.531915,0.468085,10,12
2022020355,2022-11-29,2,BOS,3,1,TBL,22,8,10,2,42,23,6,17,0,46,22,8,10,2,42,23,6,17,0,46,1,0,26,28,0.46,0.54,4,2
2022020356,2022-11-29,2,NSH,2,1,ANA,38,12,17,2,69,33,5,17,1,56,36,10,17,1,64,32,5,16,1,54,1,0,41,35,0.581818,0.418182,0,4
2022020357,2022-11-29,2,WPG,5,0,COL,14,9,9,4,36,35,5,11,0,51,14,7,9,4,34,32,5,11,0,48,1,0,23,40,0.630435,0.369565,8,6
2022020358,2022-11-29,2,CGY,6,2,FLA,13,14,9,4,40,25,7,8,2,42,10,13,6,4,33,24,7,8,2,41,1,0,23,33,0.627119,0.372881,12,12
2022020359,2022-11-29,2,VAN,1,5,WSH,25,10,10,1,46,22,9,10,5,46,25,10,10,1,46,22,9,9,5,45,0,1,32,28,0.530612,0.469388,2,6
2022020360,2022-11-29,2,LAK,8,9,SEA,22,12,8,6,48,20,13,8,6,47,22,12,8,6,48,20,13,8,6,47,1,0,35,30,0.629032,0.370968,8,8
2022020361,2022-11-30,2,DET,4,5,BUF,27,13,5,4,49,23,12,10,3,48,25,11,5,4,45,19,10,7,2,38,1,0,45,34,0.681159,0.318841,6,16
2022020362,2022-11-30,2,OTT,1,3,NYR,29,11,14,1,55,27,12,14,3,56,28,11,14,1,54,27,11,14,3,55,0,1,35,36,0.705882,0.294118,6,8
2022020363,2022-11-30,2,TOR,3,1,SJS,23,5,19,3,50,21,12,17,1,51,23,5,19,3,50,21,12,17,1,51,1,0,32,24,0.607843,0.392157,0,6
2022020364,2022-11-30,2,CHI,4,5,EDM,15,4,13,2,34,22,7,8,5,42,15,3,13,2,33,21,7,8,5,41,0,1,25,41,0.609375,0.390625,8,12
2022020365,2022-12-01,2,BUF,4,6,COL,17,10,12,2,41,14,5,3,3,25,17,10,12,2,41,14,5,3,3,25,0,1,28,34,0.441176,0.558824,14,16
2022020366,2022-12-01,2,NJD,3,4,NSH,22,9,10,1,42,19,10,17,4,50,22,9,10,1,42,19,10,17,3,49,0,1,28,24,0.525424,0.474576,2,10
2022020367,2022-12-01,2,PHI,1,4,TBL,17,8,9,1,35,20,14,14,3,51,17,8,9,1,35,20,14,14,3,51,0,1,22,27,0.347826,0.652174,6,6
2022020368,2022-12-01,2,PIT,4,3,VGK,36,8,25,3,72,25,16,9,1,51,33,7,21,3,64,25,15,9,1,50,0,1,47,37,0.480769,0.519231,10,12
2022020369,2022-12-01,2,STL,4,6,CAR,20,6,4,2,32,28,11,8,5,52,20,6,4,2,32,28,11,8,5,52,1,0,26,36,0.403846,0.596154,2,6
2022020370,2022-12-01,2,MIN,5,3,EDM,22,10,13,3,48,15,7,13,2,37,22,10,13,3,48,15,7,13,2,37,0,1,30,21,0.473684,0.526316,6,6
2022020371,2022-12-01,2,DAL,5,0,ANA,31,10,20,3,64,20,6,10,0,36,30,10,20,3,63,20,6,10,0,36,1,0,41,31,0.641509,0.358491,21,13
2022020372,2022-12-01,2,CGY,1,2,MTL,32,9,21,1,63,16,10,5,1,32,32,9,21,1,63,16,10,5,1,32,0,1,46,19,0.463768,0.536232,6,8
2022020373,2022-12-01,2,VAN,1,5,FLA,29,11,7,1,48,23,10,11,5,49,29,11,7,1,48,23,10,11,5,49,0,1,33,32,0.544118,0.455882,9,11
2022020374,2022-12-01,2,SEA,3,2,WSH,22,16,24,2,64,14,8,6,1,29,22,16,24,1,63,14,8,6,1,29,0,1,25,23,0.425926,0.574074,13,9
2022020375,2022-12-01,2,LAK,5,3,ARI,18,7,12,3,40,9,11,8,2,30,17,7,12,2,38,9,11,7,2,29,0,1,32,21,0.473684,0.526316,8,10
2022020376,2022-12-02,2,NYR,2,3,OTT,20,12,18,2,52,26,9,8,2,45,18,11,16,2,47,24,9,8,1,42,1,0,27,37,0.486111,0.513889,18,14
2022020377,2022-12-02,2,NYI,1,4,NSH,39,11,15,0,65,15,10,8,2,35,38,11,15,0,64,15,10,8,2,35,0,1,49,23,0.428571,0.571429,11,13
2022020378,2022-12-02,2,WPG,1,4,CBJ,27,18,25,0,70,17,10,15,4,46,27,17,25,0,69,17,9,15,4,45,0,1,38,26,0.477612,0.522388,6,10
2022020379,2022-12-03,2,MIN,5,4,ANA,43,13,17,5,78,28,10,8,3,49,39,11,15,3,68,24,7,7,2,40,1,0,49,33,0.530864,0.469136,8,8
2022020380,2022-12-03,2,BOS,5,1,COL,30,7,10,4,51,22,5,11,1,39,28,7,10,4,49,22,5,11,1,39,1,0,40,25,0.625,0.375,13,15
2022020381,2022-12-03,2,EDM,5,3,MTL,13,6,8,2,29,27,11,11,1,50,13,6,8,2,29,27,11,11,1,50,0,1,22,33,0.4,0.6,6,23
2022020382,2022-12-03,2,PHI,2,3,NJD,26,10,14,1,51,13,10,9,3,35,26,10,14,1,51,13,10,9,3,35,0,1,33,18,0.403846,0.596154,6,6
2022020383,2022-12-03,2,OTT,5,2,SJS,26,10,15,2,53,22,7,6,1,36,26,10,15,2,53,22,6,6,1,35,0,1,39,37,0.589286,0.410714,15,17
2022020384,2022-12-03,2,PIT,6,2,STL,24,12,13,4,53,18,7,11,2,38,24,12,13,4,53,18,7,11,2,38,1,0,38,28,0.509434,0.490566,4,18
2022020385,2022-12-03,2,TBL,4,3,TOR,22,11,10,2,45,24,5,7,1,37,22,11,10,1,44,23,5,7,1,36,0,1,33,39,0.393443,0.606557,14,16
2022020386,2022-12-03,2,DET,1,4,VGK,19,12,22,0,53,19,9,15,3,46,19,12,22,0,53,19,9,15,3,46,0,1,25,25,0.538462,0.461538,2,6
2022020387,2022-12-03,2,NYR,2,5,CHI,22,20,16,1,59,13,4,15,2,34,22,16,16,0,54,13,4,15,2,34,0,1,28,21,0.537037,0.462963,25,35
2022020388,2022-12-03,2,VAN,3,2,ARI,21,10,17,1,49,18,11,6,1,36,18,9,17,1,45,18,10,5,1,34,0,1,32,23,0.59322,0.40678,6,16
2022020389,2022-12-03,2,SEA,1,5,FLA,32,12,10,1,55,19,10,11,2,42,32,12,10,1,55,19,10,11,2,42,0,1,36,28,0.5,0.5,10,6
2022020390,2022-12-03,2,CGY,5,2,WSH,27,16,18,5,66,22,9,7,1,39,27,16,18,5,66,22,8,7,0,37,1,0,36,29,0.442623,0.557377,8,6
2022020391,2022-12-03,2,LAK,2,4,CAR,29,10,15,1,55,26,16,5,3,50,29,9,14,1,53,26,16,5,3,50,0,1,33,31,0.568966,0.431034,6,8
2022020392,2022-12-04,2,WPG,5,2,ANA,26,16,8,4,54,20,9,16,2,47,26,16,8,4,54,20,9,16,2,47,0,1,40,30,0.526316,0.473684,6,8
2022020393,2022-12-04,2,DAL,5,6,MIN,21,9,16,7,53,22,10,6,6,44,19,8,16,5,48,19,9,4,3,35,0,1,35,31,0.481481,0.518519,13,13
2022020394,2022-12-04,2,CBJ,2,4,DET,20,7,9,1,37,21,6,12,2,41,20,7,9,1,37,21,6,12,2,41,0,1,34,35,0.482759,0.517241,10,6
2022020395,2022-12-04,2,BUF,6,3,SJS,28,7,10,4,49,24,5,10,2,41,28,7,10,4,49,24,5,10,2,41,1,0,38,29,0.431034,0.568966,4,8
2022020396,2022-12-04,2,NYI,3,0,CHI,31,10,19,3,63,19,14,15,0,48,31,10,19,3,63,19,14,15,0,48,1,0,40,21,0.421053,0.578947,7,9
2022020397,2022-12-05,2,PHI,5,3,COL,23,5,8,3,39,26,11,20,2,59,23,5,8,3,39,26,11,20,2,59,0,1,34,32,0.489362,0.510638,10,6
2022020398,2022-12-05,2,NYR,6,4,STL,16,3,11,4,34,25,6,11,3,45,16,3,11,4,34,25,6,11,3,45,1,0,24,29,0.548387,0.451613,10,4
2022020399,2022-12-05,2,BOS,3,4,VGK,33,15,10,2,60,19,13,12,4,48,28,12,9,2,51,15,12,12,3,42,0,1,43,24,0.459016,0.540984,6,8
2022020400,2022-12-05,2,EDM,2,3,WSH,26,10,13,1,50,30,8,14,2,54,26,10,13,1,50,30,8,14,2,54,1,0,30,50,0.482143,0.517857,6,2
2022020401,2022-12-05,2,CGY,3,2,ARI,21,6,14,1,42,16,8,8,2,34,21,6,14,1,42,16,8,8,2,34,1,0,27,20,0.526316,0.473684,4,6
2022020402,2022-12-05,2,VAN,7,6,MTL,25,8,12,6,51,19,13,11,6,49,25,8,12,5,50,18,13,11,6,48,0,1,32,26,0.52459,0.47541,11,9
2022020403,2022-12-06,2,NJD,3,0,CHI,25,15,19,2,61,18,4,7,0,29,25,15,19,2,61,18,4,7,0,29,1,0,29,24,0.479167,0.520833,6,4
2022020404,2022-12-06,2,PIT,4,1,CBJ,23,15,6,3,47,29,10,19,1,59,22,14,6,2,44,29,10,19,1,59,0,1,34,39,0.473684,0.526316,10,10
2022020405,2022-12-06,2,TBL,2,4,DET,42,14,10,2,68,20,11,10,4,45,42,14,10,2,68,20,11,10,4,45,0,1,46,26,0.56,0.44,4,6
2022020406,2022-12-06,2,OTT,2,5,LAK,23,8,17,0,48,21,9,17,3,50,22,8,17,0,47,21,9,17,3,50,0,1,33,28,0.571429,0.428571,6,8
2022020407,2022-12-06,2,NYI,4,7,STL,33,7,16,3,59,19,9,7,7,42,33,7,16,3,59,19,9,7,7,42,0,1,40,28,0.590164,0.409836,4,4
2022020408,2022-12-06,2,WPG,5,2,FLA,19,12,7,3,41,31,13,10,1,55,19,12,7,3,41,31,13,10,1,55,1,0,31,41,0.672414,0.327586,13,13
2022020409,2022-12-06,2,DAL,0,4,TOR,25,15,18,0,58,16,10,9,4,39,25,15,18,0,58,16,10,9,4,39,0,1,44,29,0.403846,0.596154,4,14
2022020410,2022-12-06,2,ANA,4,3,CAR,20,5,16,4,45,29,13,18,3,63,20,5,16,3,44,29,13,18,3,63,1,0,30,37,0.442623,0.557377,4,4
2022020411,2022-12-06,2,SEA,2,4,MTL,26,12,14,2,54,10,6,11,4,31,26,12,14,2,54,10,6,11,3,30,0,1,33,16,0.5,0.5,8,6
2022020412,2022-12-07,2,CBJ,4,9,BUF,17,11,7,4,39,17,4,14,6,41,15,11,7,4,37,17,4,14,6,41,0,1,24,30,0.596154,0.403846,22,6
2022020413,2022-12-07,2,PHI,1,4,WSH,25,14,7,0,46,18,7,14,3,42,25,14,7,0,46,18,7,14,3,42,1,0,30,27,0.464286,0.535714,18,6
2022020414,2022-12-07,2,CGY,5,3,MIN,14,8,10,3,35,18,9,12,3,42,14,8,10,3,35,18,9,12,3,42,0,1,27,28,0.567164,0.432836,8,12
2022020415,2022-12-07,2,COL,0,4,BOS,22,6,8,0,36,28,9,13,4,54,20,6,8,0,34,28,9,13,4,54,0,1,23,37,0.533333,0.466667,11,13
2022020416,2022-12-07,2,EDM,8,2,ARI,18,9,12,6,45,15,7,5,2,29,18,8,12,6,44,14,7,5,1,27,1,0,35,18,0.509804,0.490196,11,27
2022020417,2022-12-07,2,VGK,1,5,NYR,17,5,24,0,46,22,5,8,3,38,16,5,24,0,45,22,5,7,3,37,0,1,26,37,0.540984,0.459016,27,13
2022020418,2022-12-07,2,SJS,5,6,VAN,32,9,19,3,63,18,10,12,4,44,28,8,18,3,57,16,8,12,3,39,1,0,39,27,0.54386,0.45614,11,11
2022020419,2022-12-08,2,FLA,5,1,DET,24,10,15,5,54,12,9,6,0,27,24,10,15,5,54,12,9,6,0,27,1,0,41,20,0.54386,0.45614,8,16
2022020420,2022-12-08,2,TOR,5,0,LAK,29,10,10,4,53,21,9,12,0,42,29,10,10,4,53,21,9,12,0,42,1,0,41,29,0.5,0.5,12,11
2022020421,2022-12-08,2,TBL,5,2,NSH,25,6,16,3,50,34,5,16,1,56,25,6,16,3,50,34,5,16,1,56,1,0,33,36,0.447761,0.552239,9,9
2022020422,2022-12-08,2,STL,2,5,WPG,25,3,18,2,48,13,11,14,4,42,25,3,18,2,48,13,11,14,4,42,0,1,31,20,0.531915,0.468085,2,4
2022020423,2022-12-08,2,DAL,4,3,OTT,21,10,16,4,51,22,11,22,3,58,17,10,16,3,46,20,11,21,3,55,1,0,32,31,0.533333,0.466667,6,4
2022020424,2022-12-09,2,CBJ,3,1,CGY,17,11,5,3,36,19,14,12,1,46,15,11,4,3,33,18,14,12,1,45,1,0,27,32,0.472727,0.527273,12,14
2022020425,2022-12-09,2,NJD,4,6,NYI,21,16,23,3,63,15,8,13,5,41,21,16,23,3,63,15,8,13,5,41,1,0,29,32,0.421875,0.578125,23,11
2022020426,2022-12-09,2,BUF,3,4,PIT,26,4,7,2,39,19,5,7,2,33,26,3,7,2,38,19,5,7,2,33,0,1,31,33,0.372549,0.627451,15,10
2022020427,2022-12-09,2,WSH,4,1,SEA,31,9,9,3,52,19,5,19,1,44,31,9,9,3,52,19,5,19,1,44,0,1,38,26,0.568182,0.431818,4,9
2022020428,2022-12-09,2,CHI,1,3,WPG,16,8,12,1,37,25,18,11,2,56,16,8,12,1,37,25,18,11,2,56,0,1,23,32,0.641791,0.358209,12,10
2022020429,2022-12-09,2,EDM,5,2,MIN,30,5,12,3,50,26,4,11,1,42,30,5,12,3,50,26,4,11,1,42,1,0,38,44,0.493506,0.506494,10,6
2022020430,2022-12-09,2,COL,1,2,NYR,41,9,15,1,66,28,9,12,3,52,34,9,15,1,59,27,7,12,1,47,1,0,42,29,0.509804,0.490196,2,2
2022020431,2022-12-09,2,ARI,4,3,BOS,8,5,7,4,24,32,11,6,1,50,8,5,7,4,24,32,11,6,1,50,1,0,16,46,0.377358,0.622642,12,8
2022020432,2022-12-09,2,VGK,2,1,PHI,30,7,21,2,60,27,15,14,1,57,30,7,21,1,59,26,13,14,1,54,1,0,34,28,0.606061,0.393939,0,4
2022020433,2022-12-09,2,ANA,1,6,SJS,19,6,11,1,37,16,16,8,5,45,16,6,11,1,34,15,15,8,5,43,0,1,24,28,0.483871,0.516129,15,13
2022020434,2022-12-10,2,NSH,2,3,OTT,16,8,9,2,35,24,7,13,1,45,16,8,9,2,35,24,7,13,1,45,1,0,29,33,0.464286,0.535714,17,13
2022020435,2022-12-10,2,DAL,3,2,DET,26,18,11,2,57,20,13,10,2,45,26,18,11,1,56,19,13,9,2,43,0,1,33,26,0.551724,0.448276,4,8
2022020436,2022-12-10,2,TBL,4,1,FLA,24,11,10,4,49,21,12,16,1,50,23,11,10,4,48,21,12,16,1,50,1,0,38,25,0.473684,0.526316,10,8
2022020437,2022-12-10,2,PIT,3,1,BUF,23,12,6,2,43,32,12,16,1,61,23,12,6,2,43,32,12,16,1,61,1,0,31,38,0.54902,0.45098,6,6
2022020438,2022-12-10,2,TOR,5,4,CGY,21,10,10,2,43,18,5,10,3,36,21,10,10,2,43,17,5,10,2,34,1,0,34,26,0.508197,0.491803,8,16
2022020439,2022-12-10,2,MTL,2,4,LAK,11,14,16,2,43,24,10,6,4,44,11,14,16,2,43,24,10,6,4,44,0,1,22,35,0.392857,0.607143,8,6
2022020440,2022-12-10,2,NYI,0,3,CAR,15,6,14,0,35,20,16,30,3,69,14,5,14,0,33,20,15,30,3,68,0,1,16,29,0.425,0.575,4,6
2022020441,2022-12-10,2,VAN,0,3,MIN,26,12,18,0,56,26,16,12,1,55,26,12,18,0,56,26,16,12,1,55,0,1,35,33,0.490566,0.509434,9,11
2022020442,2022-12-11,2,STL,2,3,COL,26,10,8,0,44,22,7,9,3,41,26,10,8,0,44,21,7,9,2,39,0,1,32,31,0.6,0.4,6,8
2022020443,2022-12-11,2,CBJ,6,5,LAK,18,13,18,3,52,31,18,12,5,66,17,13,18,2,50,31,18,12,5,66,1,0,26,38,0.523077,0.476923,4,6
2022020444,2022-12-11,2,FLA,2,5,SEA,13,10,8,2,33,17,11,7,4,39,13,10,8,2,33,17,11,7,4,39,0,1,25,32,0.655738,0.344262,25,8
2022020445,2022-12-11,2,ARI,5,4,PHI,22,7,13,4,46,36,20,16,4,76,21,6,13,3,43,33,19,14,3,69,1,0,29,41,0.533333,0.466667,11,9
2022020446,2022-12-11,2,WPG,2,5,WSH,23,6,18,2,49,24,8,11,3,46,23,6,18,2,49,24,8,11,3,46,0,1,31,36,0.480769,0.519231,14,6
2022020447,2022-12-11,2,VGK,1,3,BOS,25,10,15,0,50,21,5,18,3,47,25,10,15,0,50,21,5,18,3,47,1,0,31,27,0.46,0.54,4,8
2022020448,2022-12-12,2,MTL,2,1,CGY,22,10,13,3,48,26,10,9,1,46,21,7,12,1,41,24,9,9,0,42,0,1,38,35,0.506494,0.493506,19,21
2022020449,2022-12-12,2,PIT,2,1,DAL,21,7,17,1,46,20,7,20,1,48,21,7,17,1,46,20,7,20,1,48,0,1,25,27,0.465517,0.534483,4,6
2022020450,2022-12-12,2,NYR,4,3,NJD,14,8,9,3,34,25,15,11,3,54,14,8,9,2,33,24,13,10,3,50,0,1,23,29,0.415094,0.584906,6,6
2022020451,2022-12-12,2,OTT,3,0,ANA,31,13,14,1,59,23,5,19,0,47,30,13,14,1,58,23,5,19,0,47,1,0,38,32,0.587302,0.412698,8,10
2022020452,2022-12-12,2,MIN,2,1,EDM,23,13,6,1,43,14,8,12,0,34,23,13,6,1,43,14,8,12,0,34,1,0,30,21,0.392157,0.607843,10,6
2022020453,2022-12-12,2,STL,1,0,NSH,17,9,15,1,42,20,10,15,0,45,14,9,15,0,38,19,10,15,0,44,0,0,24,25,0.489362,0.510638,8,6
2022020454,2022-12-13,2,TOR,7,0,ANA,25,14,11,7,57,25,11,2,0,38,25,14,11,7,57,25,11,2,0,38,1,0,42,28,0.578125,0.421875,4,8
2022020455,2022-12-13,2,FLA,4,0,CBJ,16,15,11,4,46,20,10,14,0,44,16,15,11,4,46,20,10,14,0,44,1,0,26,22,0.511111,0.488889,6,6
2022020456,2022-12-13,2,NJD,1,4,DAL,32,11,19,1,63,26,11,14,4,55,32,11,19,1,63,26,11,14,4,55,0,1,36,32,0.4375,0.5625,2,4
2022020457,2022-12-13,2,BUF,6,0,LAK,18,9,16,3,46,30,6,6,0,42,18,9,16,3,46,30,6,6,0,42,1,0,31,40,0.5,0.5,6,12
2022020458,2022-12-13,2,BOS,4,3,NYI,28,11,13,3,55,22,14,22,4,62,20,11,11,1,43,20,11,22,3,56,1,0,33,26,0.587302,0.412698,11,9
2022020459,2022-12-13,2,TBL,6,2,SEA,23,10,10,5,48,33,13,15,2,63,23,9,10,4,46,33,13,14,2,62,1,0,30,38,0.46875,0.53125,19,29
2022020460,2022-12-13,2,DET,0,1,CAR,26,10,7,0,43,25,11,15,0,51,25,10,7,0,42,24,11,15,0,50,0,1,27,27,0.508475,0.491525,4,6
2022020461,2022-12-13,2,NSH,3,6,EDM,21,14,14,3,52,28,10,10,4,52,21,14,14,3,52,28,10,10,4,52,1,0,32,37,0.516667,0.483333,4,10
2022020462,2022-12-13,2,WPG,5,6,VGK,26,14,11,4,55,25,9,12,4,50,26,14,11,4,55,25,9,12,4,50,1,0,34,33,0.507937,0.492063,6,4
2022020463,2022-12-13,2,CHI,3,7,WSH,16,7,12,2,37,22,13,20,6,61,16,7,12,2,37,22,13,20,6,61,0,1,29,30,0.609756,0.390244,2,6
2022020464,2022-12-13,2,COL,3,2,PHI,20,5,18,2,45,24,6,10,2,42,20,5,18,2,45,24,6,9,2,41,0,1,25,28,0.5,0.5,4,6
2022020465,2022-12-13,2,SJS,3,2,ARI,27,15,8,3,53,17,9,10,1,37,27,15,8,3,53,17,9,10,1,37,1,0,33,22,0.551724,0.448276,10,4
2022020466,2022-12-14,2,OTT,3,2,MTL,16,7,8,1,32,19,7,10,2,38,16,7,8,1,32,19,7,10,2,38,1,0,31,25,0.509804,0.490196,6,14
2022020467,2022-12-14,2,MIN,4,1,DET,11,8,9,3,31,12,12,12,1,37,11,8,9,3,31,12,11,11,1,35,1,0,22,17,0.528302,0.471698,11,13
2022020468,2022-12-14,2,CGY,3,4,VAN,30,15,11,2,58,19,12,15,4,50,25,10,11,2,48,11,9,14,3,37,0,1,38,27,0.5,0.5,8,12
2022020469,2022-12-15,2,MTL,2,5,ANA,22,11,11,1,45,25,6,6,4,41,19,11,11,1,42,24,6,6,4,40,0,1,25,32,0.508772,0.491228,6,10
2022020470,2022-12-15,2,TBL,4,1,CBJ,19,12,14,4,49,23,9,16,1,49,19,12,14,4,49,23,9,16,1,49,1,0,29,25,0.482143,0.517857,2,6
2022020471,2022-12-15,2,WSH,1,2,DAL,41,11,13,1,66,19,12,10,1,42,41,11,13,1,66,19,12,10,1,42,1,0,46,26,0.53125,0.46875,4,4
2022020472,2022-12-15,2,BOS,2,3,LAK,21,14,15,3,53,26,9,13,4,52,16,13,14,1,44,19,8,13,1,41,1,0,35,30,0.492063,0.507937,14,14
2022020473,2022-12-15,2,NJD,1,2,PHI,38,8,20,0,66,18,9,13,1,41,38,8,20,0,66,18,9,13,1,41,1,0,49,24,0.473684,0.526316,20,16
2022020474,2022-12-15,2,FLA,2,4,PIT,29,12,8,2,51,30,14,3,1,48,29,12,8,2,51,30,14,3,1,48,1,0,34,39,0.478873,0.521127,6,6
2022020475,2022-12-15,2,CAR,3,2,SEA,32,10,13,3,58,13,6,8,2,29,32,10,13,2,57,13,6,8,2,29,1,0,39,17,0.529412,0.470588,4,4
2022020476,2022-12-15,2,NYR,3,1,TOR,12,7,10,2,31,18,16,14,1,49,12,7,10,2,31,18,16,14,1,49,1,0,20,23,0.510204,0.489796,6,2
2022020477,2022-12-15,2,WPG,2,1,NSH,30,20,12,2,64,21,6,8,1,36,28,19,11,0,58,18,6,8,1,33,0,1,41,26,0.469388,0.530612,15,17
2022020478,2022-12-15,2,CHI,1,4,VGK,22,4,14,1,41,20,10,10,2,42,22,4,14,1,41,20,10,10,2,42,0,1,25,25,0.543478,0.456522,2,4
2022020479,2022-12-15,2,COL,2,4,BUF,33,17,23,2,75,15,7,4,3,29,33,17,23,2,75,15,7,4,3,29,0,1,41,21,0.695652,0.304348,4,4
2022020480,2022-12-15,2,EDM,3,4,STL,20,17,8,1,46,24,9,14,3,50,17,16,7,1,41,20,8,14,2,44,1,0,27,32,0.473684,0.526316,8,10
2022020481,2022-12-16,2,MIN,4,1,CHI,15,8,17,3,43,23,5,11,0,39,14,8,17,3,42,23,5,11,0,39,1,0,22,30,0.392857,0.607143,12,6
2022020482,2022-12-16,2,CGY,2,5,STL,35,17,15,2,69,17,7,6,4,34,35,17,15,2,69,17,7,6,4,34,0,1,43,24,0.469697,0.530303,4,6
2022020483,2022-12-16,2,ARI,5,4,NYI,16,4,13,5,38,15,11,12,4,42,16,4,13,5,38,15,11,12,4,42,0,1,29,34,0.484375,0.515625,12,12
2022020484,2022-12-17,2,BOS,4,2,CBJ,33,10,19,2,64,19,10,9,0,38,33,10,19,2,64,19,10,9,0,38,1,0,39,33,0.703704,0.296296,12,8
2022020485,2022-12-17,2,DET,3,6,OTT,17,6,12,2,37,11,4,10,1,26,17,6,12,2,37,11,4,10,1,26,1,0,32,28,0.372549,0.627451,10,14
2022020486,2022-12-17,2,EDM,3,4,ANA,33,15,9,1,58,11,11,8,3,33,31,15,9,1,56,10,11,7,3,31,1,0,49,17,0.432836,0.567164,8,16
2022020487,2022-12-17,2,CAR,5,4,DAL,29,11,14,3,57,21,7,14,2,44,25,10,14,2,51,18,6,13,2,39,1,0,38,30,0.493151,0.506849,14,12
2022020488,2022-12-17,2,NJD,2,4,FLA,27,17,18,2,64,23,7,16,3,49,27,17,18,2,64,22,7,16,3,48,0,1,32,29,0.45614,0.54386,6,8
2022020489,2022-12-17,2,PHI,3,6,NYR,22,10,16,2,50,27,12,11,5,55,22,10,16,2,50,27,12,11,5,55,1,0,32,34,0.481481,0.518519,2,8
2022020490,2022-12-17,2,MTL,1,5,TBL,19,7,12,1,39,11,6,7,3,27,19,7,12,1,39,11,6,7,3,27,0,1,23,27,0.576923,0.423077,19,13
2022020491,2022-12-17,2,WSH,5,2,TOR,21,6,9,5,41,28,19,14,2,63,21,6,9,5,41,28,19,14,2,63,1,0,28,36,0.395349,0.604651,4,4
2022020492,2022-12-17,2,ARI,2,5,BUF,19,7,10,1,37,25,4,8,3,40,18,7,10,1,36,25,4,8,3,40,1,0,31,43,0.525424,0.474576,10,12
2022020493,2022-12-17,2,COL,3,1,NSH,17,11,16,2,46,20,9,16,1,46,17,11,16,2,46,20,9,16,1,46,1,0,30,26,0.461538,0.538462,4,6
2022020494,2022-12-17,2,VGK,2,5,NYI,34,18,14,0,66,20,9,13,5,47,33,18,14,0,65,20,9,13,5,47,0,1,38,26,0.592593,0.407407,4,6
2022020495,2022-12-17,2,VAN,1,5,WPG,21,6,14,0,41,21,9,5,4,39,21,6,14,0,41,21,9,5,4,39,0,1,23,27,0.58,0.42,4,6
2022020496,2022-12-17,2,LAK,3,2,SJS,31,7,17,3,58,20,10,17,2,49,25,5,17,1,48,18,8,15,1,42,1,0,41,25,0.491803,0.508197,6,8
2022020497,2022-12-18,2,MIN,4,2,OTT,14,8,14,4,40,19,7,16,2,44,14,8,14,4,40,19,7,16,2,44,1,0,23,28,0.490196,0.509804,6,6
2022020498,2022-12-18,2,CAR,3,2,PIT,23,8,11,3,45,18,16,8,1,43,22,8,11,3,44,18,15,8,1,42,1,0,29,25,0.537037,0.462963,10,6
2022020499,2022-12-18,2,CHI,1,7,NYR,27,12,15,1,55,19,12,7,6,44,27,12,15,1,55,19,12,7,6,44,0,1,30,26,0.6,0.4,2,2
2022020500,2022-12-18,2,SEA,3,2,WPG,25,11,15,3,54,10,7,12,0,29,25,11,15,3,54,9,7,12,0,28,0,1,34,17,0.58,0.42,8,6
2022020501,2022-12-18,2,SJS,2,5,CGY,15,9,4,0,28,18,11,11,4,44,15,9,4,0,28,18,11,11,4,44,0,1,26,25,0.547945,0.452055,13,21
2022020502,2022-12-19,2,CBJ,1,2,DAL,26,18,12,1,57,32,13,26,2,73,26,18,12,1,57,32,13,26,2,73,0,1,28,34,0.372549,0.627451,0,2
2022020503,2022-12-19,2,WSH,4,3,DET,34,15,12,4,65,13,8,14,2,37,32,15,12,3,62,12,7,12,2,33,0,1,42,19,0.553191,0.446809,8,8
2022020504,2022-12-19,2,BOS,7,3,FLA,15,11,11,5,42,30,10,12,3,55,15,11,11,5,42,30,10,12,3,55,1,0,26,39,0.564516,0.435484,8,10
2022020505,2022-12-19,2,NSH,4,3,EDM,29,13,9,3,54,29,7,15,1,52,29,12,8,2,51,26,7,14,1,48,1,0,35,33,0.538462,0.461538,6,4
2022020506,2022-12-19,2,COL,1,0,NYI,41,16,23,1,81,25,13,14,0,52,38,15,23,0,76,24,10,12,0,46,0,0,46,26,0.453125,0.546875,2,4
2022020507,2022-12-19,2,VGK,2,3,BUF,30,12,12,2,56,15,18,9,3,45,29,12,12,2,55,15,18,9,3,45,0,1,43,18,0.555556,0.444444,2,6
2022020508,2022-12-19,2,ARI,2,3,MTL,31,10,11,2,54,20,10,9,3,42,31,10,11,2,54,19,10,9,2,40,0,1,39,26,0.433333,0.566667,4,4
2022020509,2022-12-19,2,VAN,1,5,STL,22,12,3,1,38,19,11,6,3,39,22,12,3,1,38,19,11,6,3,39,0,1,34,27,0.454545,0.545455,8,10
2022020510,2022-12-20,2,PHI,5,3,CBJ,34,11,14,4,63,29,11,11,3,54,34,11,14,4,63,29,11,11,3,54,1,0,39,33,0.557692,0.442308,2,2
2022020511,2022-12-20,2,PIT,3,2,NYR,20,6,11,1,38,21,11,19,2,53,20,6,11,1,38,21,11,19,2,53,0,1,24,28,0.561404,0.438596,6,6
2022020512,2022-12-20,2,CAR,4,1,NJD,12,11,5,3,31,25,12,9,1,47,12,11,5,3,31,25,12,9,1,47,1,0,20,38,0.563636,0.436364,8,8
2022020513,2022-12-20,2,TOR,4,1,TBL,30,8,4,3,45,18,10,13,1,42,30,8,4,3,45,18,10,13,1,42,1,0,40,19,0.511111,0.488889,6,6
2022020514,2022-12-20,2,WPG,5,1,OTT,18,15,8,5,46,31,14,16,0,61,18,15,8,5,46,31,14,16,0,61,1,0,24,36,0.44898,0.55102,4,2
2022020515,2022-12-20,2,SEA,5,2,STL,24,16,7,5,52,13,13,15,1,42,24,16,7,5,52,13,13,15,1,42,1,0,33,24,0.604167,0.395833,6,6
2022020516,2022-12-20,2,LAK,4,1,ANA,27,10,14,3,54,18,8,12,0,38,27,10,14,3,54,18,8,12,0,38,1,0,41,25,0.625,0.375,12,12
2022020517,2022-12-20,2,SJS,3,7,CGY,18,6,14,3,41,29,14,15,7,65,18,6,14,3,41,29,14,15,7,65,0,1,27,39,0.447761,0.552239,9,11
2022020518,2022-12-21,2,FLA,2,4,NJD,30,14,26,1,71,27,11,10,3,51,30,14,26,1,71,27,11,10,3,51,1,0,36,33,0.509434,0.490566,41,17
2022020519,2022-12-21,2,DET,7,4,TBL,18,4,10,7,39,24,6,17,4,51,17,4,10,7,38,22,6,14,4,46,0,1,31,38,0.377358,0.622642,14,10
2022020520,2022-12-21,2,COL,2,1,MTL,33,14,22,1,70,18,7,15,1,41,33,14,22,0,69,17,7,15,1,40,0,1,36,20,0.557692,0.442308,2,4
2022020521,2022-12-21,2,CHI,2,4,NSH,31,10,9,2,52,29,13,17,3,62,31,10,9,2,52,29,13,17,3,62,0,1,39,37,0.5,0.5,4,8
2022020522,2022-12-21,2,DAL,3,6,EDM,19,10,11,2,42,27,12,14,5,58,16,8,10,2,36,25,12,14,5,56,1,0,27,34,0.59322,0.40678,6,10
2022020523,2022-12-21,2,VGK,5,2,ARI,18,9,20,2,49,19,11,12,2,44,18,9,20,2,49,19,11,12,2,44,1,0,34,23,0.537037,0.462963,4,8
2022020524,2022-12-21,2,ANA,1,4,MIN,20,13,8,1,42,20,13,15,3,51,19,13,7,0,39,19,13,15,3,50,1,0,22,42,0.446429,0.553571,24,6
2022020525,2022-12-22,2,TOR,4,3,PHI,22,10,10,3,45,12,7,14,2,35,21,10,10,3,44,10,6,13,2,31,0,1,34,19,0.56,0.44,12,12
2022020526,2022-12-22,2,PIT,3,4,CAR,20,9,7,1,37,27,13,22,4,66,20,9,7,1,37,26,13,21,3,63,1,0,27,36,0.528571,0.471429,12,8
2022020527,2022-12-22,2,NYR,5,3,NYI,15,14,11,4,44,12,9,10,3,34,15,14,11,4,44,12,9,10,3,34,0,1,34,18,0.557692,0.442308,4,12
2022020528,2022-12-22,2,OTT,2,3,WSH,14,9,20,1,44,33,8,13,2,56,13,8,20,1,42,31,6,13,1,51,1,0,25,40,0.559322,0.440678,6,12
2022020529,2022-12-22,2,BOS,3,2,WPG,31,11,7,2,51,17,13,8,2,40,31,11,7,2,51,17,13,8,2,40,0,1,39,27,0.641509,0.358491,4,8
2022020530,2022-12-22,2,VAN,6,5,SEA,27,14,18,4,63,28,13,20,5,66,27,11,18,4,60,26,13,20,5,64,0,1,37,36,0.5,0.5,7,11
2022020531,2022-12-22,2,LAK,4,3,CGY,22,15,12,4,53,25,10,18,2,55,21,13,11,3,48,23,10,18,2,53,0,1,32,30,0.45614,0.54386,6,8
2022020532,2022-12-22,2,SJS,5,2,MIN,14,8,13,3,38,14,13,10,2,39,13,8,13,3,37,14,13,10,1,38,1,0,25,26,0.508772,0.491228,13,28
2022020533,2022-12-23,2,NJD,3,4,BOS,36,6,27,2,71,19,5,13,4,41,36,6,27,2,71,19,5,13,4,41,1,0,40,23,0.510204,0.489796,2,4
2022020534,2023-02-27,2,OTT,6,2,DET,26,7,10,4,47,19,4,13,1,37,25,7,10,3,45,19,4,13,1,37,0,1,42,24,0.536232,0.463768,8,12
2022020535,2022-12-23,2,CAR,6,5,PHI,28,11,15,4,58,21,10,6,3,40,28,11,15,4,58,21,10,6,3,40,1,0,37,31,0.5,0.5,4,8
2022020536,2023-03-04,2,BUF,5,3,TBL,26,8,10,3,47,25,8,10,1,44,25,8,10,2,45,23,8,10,1,42,0,1,34,36,0.372881,0.627119,17,17
2022020537,2022-12-23,2,WSH,4,1,WPG,20,9,14,4,47,21,7,14,1,43,20,9,14,4,47,21,7,14,1,43,1,0,27,26,0.553571,0.446429,4,8
2022020538,2022-12-23,2,NYI,5,1,FLA,29,14,14,5,62,15,7,14,1,37,29,13,14,5,61,13,7,11,0,31,0,1,43,23,0.468085,0.531915,23,29
2022020539,2022-12-23,2,NSH,2,3,COL,32,10,10,1,53,36,11,19,3,69,31,7,10,1,49,35,10,19,2,66,1,0,39,46,0.492308,0.507692,8,6
2022020540,2022-12-23,2,CHI,5,2,CBJ,24,6,8,4,42,18,10,11,1,40,22,6,8,4,40,17,9,11,1,38,1,0,38,29,0.646154,0.353846,19,21
2022020541,2022-12-23,2,DAL,4,2,MTL,23,12,16,1,52,17,6,9,1,33,23,12,16,1,52,17,6,9,1,33,0,1,36,24,0.602941,0.397059,4,20
2022020542,2022-12-23,2,EDM,2,5,VAN,24,8,18,2,52,20,11,11,4,46,24,8,18,2,52,20,11,11,4,46,1,0,33,30,0.584906,0.415094,4,6
2022020543,2022-12-23,2,ARI,2,1,LAK,19,11,15,1,46,21,10,9,0,40,17,9,15,0,41,16,9,8,0,33,1,0,24,27,0.422222,0.577778,8,16
2022020544,2022-12-23,2,ANA,2,3,CGY,17,12,10,0,39,30,15,13,3,61,17,11,9,0,37,30,15,13,2,60,0,1,23,45,0.430769,0.569231,13,15
2022020545,2022-12-23,2,VGK,5,4,STL,24,5,11,5,45,22,10,14,4,50,18,5,9,3,35,20,8,11,3,42,1,0,32,29,0.543478,0.456522,6,4
2022020546,2022-12-27,2,OTT,3,2,BOS,27,7,14,2,50,41,9,21,2,73,19,6,12,1,38,35,8,18,2,63,1,0,32,51,0.33871,0.66129,6,4
2022020547,2023-04-14,2,CBJ,2,5,BUF,27,9,11,2,49,31,14,15,5,65,27,9,11,2,49,31,14,15,5,65,1,0,31,35,0.42,0.58,2,2
2022020548,2022-12-27,2,CAR,3,0,CHI,39,12,11,3,65,21,7,15,0,43,39,12,11,3,65,21,7,15,0,43,1,0,49,24,0.442308,0.557692,6,6
2022020549,2022-12-27,2,NYR,0,4,WSH,19,13,11,0,43,22,5,4,2,33,19,13,11,0,43,22,5,4,2,33,0,1,32,30,0.444444,0.555556,6,10
2022020550,2022-12-27,2,NYI,5,1,PIT,34,13,18,5,70,19,11,12,1,43,34,13,18,5,70,19,11,12,1,43,1,0,42,21,0.518519,0.481481,2,6
2022020551,2022-12-27,2,NSH,2,3,DAL,21,10,12,1,44,26,10,17,2,55,20,10,12,0,42,26,10,17,2,55,0,1,28,33,0.557692,0.442308,12,6
2022020552,2022-12-27,2,WPG,1,4,MIN,30,10,9,1,50,24,16,9,3,52,29,10,8,1,48,22,13,9,3,47,0,1,32,28,0.596774,0.403226,4,6
2022020553,2022-12-27,2,STL,4,5,TOR,23,11,13,3,50,27,14,7,4,52,21,11,13,3,48,24,13,7,3,47,0,1,34,37,0.471698,0.528302,4,8
2022020554,2022-12-27,2,ARI,6,3,COL,23,7,7,5,42,27,13,17,2,59,23,7,7,5,42,27,13,17,2,59,1,0,33,31,0.4,0.6,2,6
2022020555,2022-12-27,2,CGY,1,2,EDM,42,16,25,1,84,15,4,6,1,26,42,16,25,1,84,15,4,6,1,26,1,0,47,22,0.534483,0.465517,6,2
2022020556,2022-12-27,2,VAN,6,2,SJS,17,10,13,6,46,23,13,19,1,56,17,10,13,6,46,23,13,19,1,56,1,0,25,26,0.471698,0.528302,4,2
2022020557,2022-12-27,2,LAK,4,2,VGK,20,9,11,4,44,18,11,14,1,44,20,9,11,4,44,18,11,14,1,44,1,0,25,25,0.538462,0.461538,6,4
2022020558,2022-12-28,2,NJD,1,3,BOS,30,20,20,1,71,20,15,8,3,46,29,20,20,1,70,19,14,8,3,44,0,1,31,27,0.384615,0.615385,11,9
2022020559,2022-12-28,2,TBL,4,1,MTL,30,11,10,3,54,17,3,12,1,33,30,11,10,3,54,17,3,12,1,33,1,0,38,26,0.606557,0.393443,17,9
2022020560,2022-12-28,2,PIT,4,5,DET,25,14,13,2,54,32,5,16,3,56,23,14,13,2,52,31,4,15,2,52,1,0,31,46,0.480769,0.519231,8,4
2022020561,2022-12-28,2,SEA,2,3,CGY,29,14,14,2,59,28,15,6,2,51,29,14,14,2,59,28,15,6,2,51,0,1,31,44,0.444444,0.555556,8,2
2022020562,2022-12-28,2,ANA,3,2,VGK,16,8,16,2,42,34,11,17,1,63,14,8,15,2,39,33,11,15,1,60,1,0,27,51,0.424242,0.575758,10,10
2022020563,2022-12-29,2,BUF,6,3,DET,25,9,13,5,52,24,8,7,2,41,25,8,13,5,51,22,7,6,2,37,1,0,35,31,0.539683,0.460317,6,10
2022020564,2022-12-29,2,FLA,7,2,MTL,22,6,9,4,41,19,6,7,0,32,22,6,9,4,41,19,6,7,0,32,1,0,41,27,0.587302,0.412698,27,41
2022020565,2022-12-29,2,TBL,2,1,NYR,41,16,20,3,80,42,14,10,2,68,34,15,18,1,68,35,10,10,1,56,0,1,40,46,0.618182,0.381818,6,2
2022020566,2022-12-29,2,WSH,3,4,OTT,16,11,14,3,44,36,16,11,4,67,16,9,14,3,42,34,16,10,3,63,1,0,23,45,0.462963,0.537037,4,4
2022020567,2022-12-29,2,NYI,2,1,CBJ,32,14,10,1,57,17,12,15,1,45,32,14,10,1,57,17,11,15,1,44,1,0,36,21,0.629032,0.370968,6,8
2022020568,2022-12-29,2,STL,3,1,CHI,20,6,8,3,37,18,6,13,0,37,20,6,8,3,37,18,6,13,0,37,1,0,29,22,0.488372,0.511628,4,6
2022020569,2022-12-29,2,MIN,1,4,DAL,20,15,15,1,51,30,7,13,2,52,20,15,15,1,51,30,7,13,2,52,0,1,24,43,0.28125,0.71875,18,6
2022020570,2022-12-29,2,WPG,4,2,VAN,34,14,14,2,64,16,7,9,2,34,34,14,14,1,63,16,6,8,2,32,0,1,39,22,0.480769,0.519231,6,8
2022020571,2022-12-29,2,COL,4,5,LAK,24,8,17,3,52,20,13,9,4,46,20,7,16,2,45,16,11,9,2,38,0,1,27,27,0.473684,0.526316,10,12
2022020572,2022-12-29,2,ARI,6,3,TOR,14,4,9,4,31,25,8,15,1,49,13,3,9,4,29,25,8,15,1,49,1,0,23,32,0.54717,0.45283,11,13
2022020573,2022-12-29,2,SJS,3,4,PHI,18,11,6,2,37,18,8,15,4,45,18,11,6,2,37,18,8,15,3,44,1,0,28,26,0.461538,0.538462,2,6
2022020574,2022-12-30,2,ANA,1,6,NSH,24,20,9,1,54,37,17,17,5,76,24,20,9,1,54,37,17,17,5,76,0,1,27,43,0.489362,0.510638,2,2
2022020575,2022-12-30,2,CAR,4,0,FLA,24,6,5,1,36,15,12,8,0,35,24,6,5,1,36,14,12,8,0,34,1,0,34,19,0.557143,0.442857,14,12
2022020576,2022-12-30,2,PIT,2,4,NJD,11,6,10,2,29,16,11,9,2,38,10,6,10,2,28,16,11,9,2,38,1,0,27,28,0.45,0.55,12,18
2022020577,2022-12-30,2,SEA,2,7,EDM,31,12,14,2,59,23,5,17,5,50,31,12,14,2,59,23,5,17,5,50,0,1,38,32,0.553571,0.446429,11,13
2022020578,2022-12-31,2,BOS,3,4,BUF,25,6,14,2,47,15,4,9,4,32,24,6,14,2,46,15,4,9,3,31,1,0,40,25,0.555556,0.444444,13,17
2022020579,2022-12-31,2,VGK,5,4,NSH,27,12,20,5,64,32,8,15,3,58,26,12,19,4,61,30,7,14,3,54,0,1,32,37,0.491525,0.508475,14,21
2022020580,2022-12-31,2,WSH,9,2,MTL,28,9,11,7,55,29,12,15,1,57,26,9,11,6,52,24,11,15,1,51,1,0,40,33,0.508197,0.491803,8,12
2022020581,2022-12-31,2,LAK,2,4,PHI,24,11,15,1,51,14,6,8,2,30,24,11,15,1,51,14,6,8,2,30,1,0,29,23,0.614035,0.385965,6,10
2022020582,2022-12-31,2,TBL,5,3,ARI,29,9,9,3,50,25,6,7,3,41,29,9,9,3,50,25,6,7,3,41,0,1,35,31,0.653846,0.346154,7,11
2022020583,2022-12-31,2,CBJ,4,1,CHI,28,10,14,1,53,17,10,4,1,32,28,10,14,1,53,16,9,4,1,30,0,1,38,28,0.40625,0.59375,10,6
2022020584,2022-12-31,2,DET,4,2,OTT,15,10,14,4,43,17,14,17,2,50,14,9,14,4,41,17,13,17,2,49,0,1,25,23,0.531915,0.468085,8,8
2022020585,2022-12-31,2,COL,2,6,TOR,22,10,19,2,53,24,2,9,5,40,22,10,19,2,53,24,2,9,5,40,0,1,28,32,0.411765,0.588235,8,6
2022020586,2022-12-31,2,DAL,5,2,SJS,21,6,12,2,41,28,10,15,2,55,21,6,12,2,41,28,10,15,2,55,0,1,31,31,0.5,0.5,8,6
2022020587,2022-12-31,2,CGY,3,2,VAN,20,12,8,2,42,19,10,9,2,40,20,12,8,2,42,19,10,9,2,40,1,0,30,24,0.583333,0.416667,8,4
2022020588,2022-12-31,2,EDM,1,2,WPG,23,12,12,1,48,11,8,6,1,26,23,12,12,1,48,11,8,6,1,26,0,1,32,17,0.446809,0.553191,6,10
2022020589,2022-12-31,2,STL,2,5,MIN,26,13,10,2,51,26,12,14,5,57,22,12,10,2,46,25,11,14,5,55,1,0,31,32,0.714286,0.285714,16,20
2022020590,2023-01-01,2,NJD,4,5,CAR,21,8,7,4,40,35,13,18,3,69,15,8,5,3,31,30,12,17,2,61,0,1,28,47,0.421053,0.578947,10,8
2022020591,2023-01-01,2,FLA,3,5,NYR,25,12,10,2,49,15,7,11,3,36,25,12,10,2,49,15,6,11,3,35,0,1,35,28,0.571429,0.428571,8,8
2022020592,2023-01-01,2,OTT,3,1,BUF,30,9,7,2,48,31,17,14,1,63,30,9,7,2,48,31,17,14,1,63,1,0,33,34,0.482759,0.517241,6,2
2022020593,2023-01-01,2,CHI,2,5,SJS,16,11,12,2,41,21,9,10,5,45,16,11,12,2,41,21,9,10,5,45,1,0,22,28,0.510204,0.489796,6,6
2022020594,2023-01-01,2,SEA,4,1,NYI,24,5,15,3,47,16,13,11,1,41,24,5,15,3,47,16,13,11,1,41,1,0,35,19,0.345455,0.654545,4,4
2022020595,2023-01-02,2,BOS,2,1,PIT,22,9,16,2,49,24,14,16,1,55,22,9,15,2,48,24,14,14,1,53,0,1,29,27,0.438356,0.561644,6,6
2022020596,2023-01-02,2,COL,2,3,VGK,20,6,9,2,37,22,14,7,3,46,19,6,9,2,36,21,12,7,3,43,1,0,29,28,0.45098,0.54902,9,17
2022020597,2023-01-02,2,ANA,1,4,PHI,18,6,8,1,33,22,7,9,4,42,18,6,8,1,33,22,7,9,4,42,0,1,29,33,0.468085,0.531915,4,10
2022020598,2023-01-03,2,FLA,5,3,ARI,26,8,9,4,47,32,11,13,2,58,26,8,9,4,47,32,11,13,2,58,1,0,37,36,0.58209,0.41791,6,6
2022020599,2023-01-03,2,WSH,4,5,BUF,27,12,10,4,53,20,9,13,4,46,25,12,10,4,51,20,9,13,3,45,0,1,32,29,0.693548,0.306452,6,2
2022020600,2023-01-03,2,NYR,5,3,CAR,20,7,8,2,37,13,7,11,3,34,20,7,8,2,37,13,7,11,3,34,0,1,31,23,0.528302,0.471698,8,12
2022020601,2023-01-03,2,OTT,4,0,CBJ,19,9,14,1,43,19,6,15,0,40,19,9,14,1,43,19,6,15,0,40,1,0,34,22,0.52459,0.47541,6,12
2022020602,2023-01-03,2,TOR,5,6,STL,20,16,14,6,56,25,8,14,5,52,18,14,13,4,49,19,7,10,2,38,0,1,25,32,0.622642,0.377358,4,6
2022020603,2023-01-03,2,WPG,3,2,CGY,17,12,13,3,45,24,13,14,2,53,17,12,12,3,44,24,11,14,2,51,1,0,25,35,0.45614,0.54386,6,10
2022020604,2023-01-03,2,NSH,6,3,MTL,25,19,15,4,63,18,8,9,3,38,23,17,14,4,58,16,7,9,3,35,1,0,34,27,0.571429,0.428571,10,10
2022020605,2023-01-03,2,CHI,1,4,TBL,17,6,16,0,39,21,14,12,2,49,17,5,15,0,37,21,14,11,2,48,1,0,26,29,0.557377,0.442623,10,12
2022020606,2023-01-03,2,EDM,2,5,SEA,24,10,14,1,49,17,9,8,4,38,24,10,14,1,49,17,9,8,4,38,1,0,32,24,0.612903,0.387097,6,6
2022020607,2023-01-03,2,VAN,2,6,NYI,19,14,15,1,49,20,7,3,4,34,19,14,15,1,49,20,7,3,4,34,1,0,26,29,0.591837,0.408163,4,6
2022020608,2023-01-03,2,LAK,3,2,DAL,26,12,14,2,54,22,11,11,2,46,26,12,14,2,54,22,11,11,2,46,1,0,35,30,0.568627,0.431373,6,6
2022020609,2023-01-04,2,DET,1,5,NJD,30,14,11,0,55,20,6,11,3,40,30,14,11,0,55,20,6,11,3,40,0,1,33,27,0.606061,0.393939,6,4
2022020610,2023-01-04,2,MIN,5,1,TBL,23,9,11,4,47,28,13,11,0,52,23,9,11,4,47,28,13,11,0,52,1,0,33,35,0.368421,0.631579,12,10
2022020611,2023-01-04,2,ANA,2,0,DAL,22,10,14,1,47,28,12,20,0,60,22,10,14,1,47,28,12,20,0,60,1,0,27,35,0.382353,0.617647,8,2
2022020612,2023-01-05,2,PHI,6,2,ARI,27,13,15,4,59,21,5,14,2,42,27,13,15,4,59,21,5,14,2,42,0,1,34,23,0.553191,0.446809,2,6
2022020613,2023-01-05,2,MTL,1,4,NYR,13,13,16,1,43,23,11,17,2,53,13,13,15,1,42,23,11,16,2,52,0,1,18,31,0.490196,0.509804,6,4
2022020614,2023-01-05,2,CAR,3,5,NSH,53,15,15,2,85,17,6,13,4,40,53,15,15,1,84,15,6,13,4,38,1,0,67,25,0.594203,0.405797,8,10
2022020615,2023-01-05,2,TOR,1,5,SEA,21,15,9,0,45,17,7,13,4,41,21,15,9,0,45,17,7,13,4,41,0,1,27,26,0.571429,0.428571,4,10
2022020616,2023-01-05,2,NJD,3,5,STL,28,13,18,2,61,9,6,7,4,26,28,13,18,2,61,9,6,7,4,26,0,1,39,19,0.636364,0.363636,4,8
2022020617,2023-01-05,2,CBJ,2,6,WSH,24,11,12,2,49,30,11,15,4,60,23,11,10,2,46,29,11,15,4,59,1,0,27,37,0.346939,0.653061,6,4
2022020618,2023-01-05,2,EDM,4,2,NYI,26,12,16,2,56,16,4,10,2,32,26,12,16,2,56,16,4,10,2,32,1,0,38,22,0.470588,0.529412,6,8
2022020619,2023-01-05,2,VAN,4,2,COL,26,6,5,3,40,23,10,22,1,56,21,5,5,3,34,19,8,19,1,47,0,1,43,32,0.575758,0.424242,10,24
2022020620,2023-01-05,2,VGK,5,2,PIT,24,11,11,4,50,30,9,17,2,58,24,11,11,4,50,30,9,17,2,58,1,0,31,40,0.516129,0.483871,6,2
2022020621,2023-01-05,2,LAK,2,5,BOS,26,8,20,2,56,17,6,15,4,42,26,8,20,2,56,17,6,15,4,42,1,0,29,22,0.55102,0.44898,7,7
2022020622,2023-01-06,2,WSH,2,3,NSH,27,6,16,2,51,15,10,15,3,43,27,6,16,2,51,15,10,15,3,43,0,1,32,21,0.4,0.6,4,6
2022020623,2023-01-06,2,DET,2,3,FLA,22,15,14,2,53,15,9,7,1,32,21,14,14,2,51,15,9,7,1,32,1,0,31,20,0.648148,0.351852,4,10
2022020624,2023-01-06,2,WPG,4,2,TBL,10,13,8,1,32,20,11,13,2,46,10,12,8,0,30,16,11,12,2,41,0,1,20,28,0.428571,0.571429,17,21
2022020625,2023-01-06,2,CHI,2,0,ARI,27,13,10,2,52,22,6,12,0,40,27,13,10,2,52,22,6,12,0,40,1,0,32,22,0.7,0.3,2,4
2022020626,2023-01-06,2,CGY,4,1,NYI,15,16,17,4,52,21,4,8,1,34,15,16,17,4,52,21,4,8,1,34,1,0,21,25,0.42,0.58,2,4
2022020627,2023-01-06,2,ANA,5,4,SJS,21,16,13,5,55,35,14,9,4,62,20,16,13,3,52,35,14,8,4,61,0,1,29,41,0.625,0.375,9,13
2022020628,2023-01-07,2,NJD,4,3,NYR,34,4,25,3,66,28,10,11,3,52,31,4,25,2,62,27,9,11,3,50,0,1,43,34,0.455882,0.544118,4,8
2022020629,2023-01-07,2,CBJ,4,3,CAR,12,4,5,4,25,32,11,12,3,58,10,4,5,1,20,30,8,12,1,51,1,0,18,42,0.403509,0.596491,14,12
2022020630,2023-01-07,2,TOR,4,1,DET,19,5,9,3,36,16,12,6,1,35,19,5,7,3,34,15,12,6,1,34,0,1,29,23,0.518519,0.481481,8,10
2022020631,2023-01-07,2,BUF,6,5,MIN,28,9,16,4,57,30,8,4,3,45,25,9,15,3,52,24,8,4,3,39,1,0,37,44,0.483333,0.516667,8,6
2022020632,2023-01-07,2,OTT,4,8,SEA,17,12,16,3,48,13,7,9,8,37,17,12,16,3,48,13,7,9,8,37,0,1,23,24,0.590164,0.409836,2,6
2022020633,2023-01-07,2,MTL,5,4,STL,15,6,8,4,33,16,10,13,3,42,15,6,7,4,32,16,10,13,3,42,0,1,27,22,0.444444,0.555556,6,8
2022020634,2023-01-07,2,EDM,2,3,COL,17,6,9,0,32,33,13,9,3,58,15,4,9,0,28,32,13,9,1,55,1,0,30,46,0.545455,0.454545,10,12
2022020635,2023-01-07,2,VGK,1,5,LAK,12,11,12,1,36,14,9,7,4,34,12,11,12,1,36,14,9,7,4,34,0,1,20,23,0.396226,0.603774,2,6
2022020636,2023-01-07,2,SJS,2,4,BOS,22,13,18,2,55,25,9,12,3,49,22,13,18,2,55,25,9,12,3,49,0,1,30,29,0.428571,0.571429,6,10
2022020637,2023-01-08,2,DAL,5,1,FLA,26,10,7,4,47,25,13,15,1,54,26,10,7,4,47,25,13,15,1,54,1,0,34,28,0.514706,0.485294,8,4
2022020638,2023-01-08,2,WPG,7,4,VAN,19,7,13,6,45,30,3,5,3,41,19,7,13,6,45,30,3,5,3,41,1,0,27,38,0.490909,0.509091,6,0
2022020639,2023-01-08,2,WSH,1,0,CBJ,15,11,14,1,41,31,11,24,0,66,15,11,14,1,41,31,11,24,0,66,1,0,19,38,0.625,0.375,9,9
2022020640,2023-01-08,2,CHI,4,3,CGY,21,8,14,4,47,38,12,19,1,70,21,8,14,3,46,36,12,19,1,68,1,0,25,47,0.461538,0.538462,13,9
2022020641,2023-01-08,2,ARI,1,4,PIT,14,11,9,1,35,18,6,15,4,43,14,11,9,1,35,18,6,15,4,43,1,0,24,28,0.5,0.5,12,4
2022020642,2023-01-08,2,MIN,0,3,STL,28,17,23,0,68,16,7,7,2,32,28,17,23,0,68,16,7,7,2,32,0,1,35,24,0.510638,0.489362,8,6
2022020643,2023-01-08,2,PHI,2,6,TOR,29,18,14,2,63,21,9,12,4,46,28,18,13,2,61,20,9,11,4,44,0,1,36,35,0.444444,0.555556,6,10
2022020644,2023-01-08,2,ANA,1,7,BOS,20,8,18,1,47,32,12,9,6,59,20,8,17,1,46,29,11,9,6,55,0,1,29,42,0.464286,0.535714,6,6
2022020645,2023-01-09,2,OTT,0,3,NSH,24,11,16,0,51,19,7,4,3,33,24,11,15,0,50,17,6,4,3,30,0,1,38,36,0.57377,0.42623,17,17
2022020646,2023-01-09,2,MTL,0,4,SEA,17,10,20,0,47,28,5,12,3,48,17,10,20,0,47,27,5,12,3,47,0,1,21,41,0.456522,0.543478,27,9
2022020647,2023-01-09,2,LAK,6,3,EDM,22,8,9,2,41,19,9,15,3,46,22,8,9,2,41,19,9,15,3,46,1,0,38,31,0.573529,0.426471,29,41
2022020648,2023-01-10,2,TBL,6,3,CBJ,36,9,11,3,59,18,16,16,3,53,35,9,11,3,58,18,16,16,3,53,1,0,46,24,0.666667,0.333333,4,10
2022020649,2023-01-10,2,NYR,4,3,MIN,34,12,26,5,77,30,10,4,4,48,31,11,25,2,69,26,10,4,3,43,0,1,43,32,0.565217,0.434783,4,8
2022020650,2023-01-10,2,CAR,3,5,NJD,18,23,24,1,66,13,8,7,5,33,18,23,24,1,66,13,8,7,5,33,1,0,28,22,0.548387,0.451613,8,6
2022020651,2023-01-10,2,BUF,3,4,SEA,26,13,12,2,53,18,10,4,3,35,25,13,12,2,52,17,10,4,3,34,1,0,35,22,0.446154,0.553846,4,10
2022020652,2023-01-10,2,PIT,5,4,VAN,21,10,14,3,48,16,10,6,4,36,21,10,13,2,46,16,9,6,4,35,0,1,36,24,0.62963,0.37037,10,12
2022020653,2023-01-10,2,NYI,1,2,DAL,28,18,20,0,66,25,9,17,2,53,23,18,20,0,61,20,8,13,1,42,0,1,28,26,0.517857,0.482143,2,6
2022020654,2023-01-10,2,DET,7,5,WPG,11,7,10,6,34,31,21,22,4,78,11,7,10,6,34,30,21,22,4,77,1,0,23,37,0.476923,0.523077,6,6
2022020655,2023-01-10,2,STL,4,3,CGY,23,9,4,3,39,26,13,10,3,52,23,9,3,2,37,25,13,10,3,51,1,0,27,31,0.45283,0.54717,4,4
2022020656,2023-01-10,2,COL,4,5,FLA,25,7,15,4,51,27,10,11,3,51,25,7,15,4,51,26,10,11,3,50,0,1,31,37,0.447761,0.552239,13,15
2022020657,2023-01-10,2,ARI,2,4,SJS,22,10,14,2,48,27,3,15,4,49,22,10,14,2,48,27,3,15,4,49,0,1,29,33,0.482759,0.517241,9,13
2022020658,2023-01-11,2,TOR,2,1,NSH,27,12,10,1,50,23,2,12,1,38,27,12,10,1,50,23,2,12,1,38,1,0,35,33,0.537037,0.462963,4,10
2022020659,2023-01-11,2,PHI,5,3,WSH,29,12,6,2,49,23,8,15,3,49,29,12,6,2,49,23,8,15,3,49,1,0,36,29,0.555556,0.444444,2,12
2022020660,2023-01-11,2,ANA,2,6,EDM,17,10,5,2,34,43,11,13,5,72,17,10,5,2,34,43,11,13,5,72,0,1,23,53,0.460317,0.539683,6,6
2022020661,2023-01-11,2,LAK,4,3,SJS,31,12,8,4,55,26,16,24,2,68,30,12,8,4,54,26,16,24,2,68,1,0,37,30,0.473684,0.526316,4,4
2022020662,2023-01-12,2,CBJ,2,6,CAR,17,7,8,2,34,26,10,17,5,58,16,7,8,1,32,25,10,16,3,54,0,1,23,41,0.4375,0.5625,10,8
2022020663,2023-01-12,2,NYR,2,1,DAL,22,9,19,2,52,23,4,17,0,44,21,9,19,1,50,23,4,17,0,44,0,1,31,25,0.571429,0.428571,2,8
2022020664,2023-01-12,2,MTL,4,3,NSH,29,16,16,2,63,36,13,19,3,71,28,15,16,1,60,35,13,18,3,69,0,1,35,42,0.54902,0.45098,15,15
2022020665,2023-01-12,2,BOS,0,3,SEA,23,13,16,0,52,25,6,9,3,43,23,13,16,0,52,25,6,9,3,43,0,1,27,31,0.731707,0.268293,6,2
2022020666,2023-01-12,2,DET,4,1,TOR,17,7,7,2,33,25,8,11,1,45,17,7,7,2,33,25,8,11,1,45,1,0,23,33,0.541667,0.458333,6,10
2022020667,2023-01-12,2,TBL,5,4,VAN,23,7,14,3,47,28,6,13,3,50,23,7,14,3,47,28,6,13,3,50,0,1,35,40,0.485714,0.514286,23,13
2022020668,2023-01-12,2,BUF,2,4,WPG,30,12,12,2,56,21,5,8,4,38,29,12,12,2,55,21,5,8,4,38,0,1,41,27,0.483871,0.516129,6,10
2022020669,2023-01-12,2,NYI,1,3,MIN,13,11,12,1,37,24,10,12,2,48,13,11,12,1,37,24,10,12,2,48,1,0,20,36,0.407407,0.592593,12,8
2022020670,2023-01-12,2,STL,1,4,CGY,18,10,8,1,37,34,11,14,4,63,18,10,8,1,37,34,11,14,4,63,0,1,26,40,0.5,0.5,2,6
2022020671,2023-01-12,2,CHI,3,2,COL,16,4,7,3,30,26,14,15,2,57,16,4,7,3,30,26,14,15,2,57,1,0,30,33,0.553571,0.446429,10,6
2022020672,2023-01-12,2,ARI,3,5,OTT,23,14,20,2,59,35,15,11,4,65,23,13,20,2,58,34,15,11,4,64,0,1,29,47,0.542373,0.457627,31,6
2022020673,2023-01-12,2,VGK,4,2,FLA,27,16,12,3,58,34,14,19,1,68,27,16,12,3,58,34,14,19,1,68,0,1,33,39,0.575758,0.424242,15,11
2022020674,2023-01-13,2,PIT,1,4,WPG,20,6,10,1,37,28,7,13,3,51,20,6,10,1,37,28,7,13,3,51,0,1,23,40,0.542373,0.457627,9,9
2022020675,2023-01-13,2,ANA,2,6,NJD,26,11,10,1,48,32,11,7,5,55,26,11,10,1,48,32,11,7,5,55,0,1,33,39,0.423077,0.576923,11,15
2022020676,2023-01-13,2,SJS,1,7,EDM,18,8,11,1,38,24,5,9,4,42,18,8,11,1,38,24,5,9,4,42,0,1,26,41,0.650794,0.349206,8,8
2022020677,2023-01-14,2,DAL,5,6,CGY,26,14,8,4,52,21,12,11,4,48,26,14,8,4,52,21,12,11,4,48,0,1,33,36,0.492308,0.507692,10,4
2022020678,2023-01-14,2,DET,3,4,CBJ,22,7,13,3,45,20,9,6,4,39,22,7,13,3,45,20,9,6,4,39,0,1,28,25,0.469388,0.530612,2,4
2022020679,2023-01-14,2,NYI,2,1,MTL,33,11,20,2,66,19,8,14,1,42,33,11,20,2,66,19,8,14,1,42,1,0,38,23,0.509434,0.490566,4,4
2022020680,2023-01-14,2,COL,7,0,OTT,24,10,13,6,53,27,10,14,0,51,24,10,13,6,53,27,10,14,0,51,1,0,33,29,0.419355,0.580645,13,11
2022020681,2023-01-14,2,WSH,1,3,PHI,33,17,24,1,75,20,3,13,2,38,32,17,23,1,73,18,3,13,2,36,0,1,40,25,0.54902,0.45098,10,10
2022020682,2023-01-14,2,CAR,2,1,PIT,25,17,9,2,53,26,13,12,0,51,25,17,9,2,53,26,13,12,0,51,1,0,36,35,0.561404,0.438596,12,4
2022020683,2023-01-14,2,BOS,4,3,TOR,27,10,14,4,55,17,12,22,2,53,26,10,13,4,53,17,12,21,2,52,0,1,34,21,0.509091,0.490909,21,21
2022020684,2023-01-14,2,FLA,4,3,VAN,26,8,10,2,46,26,9,8,2,45,26,8,10,2,46,26,9,8,2,45,0,1,35,38,0.5,0.5,12,8
2022020685,2023-01-14,2,MIN,2,1,ARI,20,10,7,1,38,24,10,15,1,50,20,10,7,1,38,24,10,15,1,50,1,0,27,28,0.574074,0.425926,2,4
2022020686,2023-01-14,2,NSH,3,5,BUF,33,9,16,2,60,23,15,8,3,49,33,9,16,2,60,23,15,8,3,49,0,1,41,33,0.539683,0.460317,8,6
2022020687,2023-01-14,2,CHI,5,8,SEA,20,12,4,3,39,18,9,9,8,44,20,12,4,3,39,18,9,9,8,44,0,1,27,30,0.483871,0.516129,4,4
2022020688,2023-01-14,2,STL,2,4,TBL,19,7,8,2,36,24,14,18,3,59,19,7,8,2,36,24,14,18,3,59,1,0,25,30,0.418182,0.581818,4,6
2022020689,2023-01-14,2,VGK,3,4,EDM,26,11,12,3,52,28,12,10,4,54,26,11,12,3,52,28,12,10,4,54,0,1,30,37,0.46875,0.53125,2,4
2022020690,2023-01-14,2,LAK,2,5,NJD,30,14,10,0,54,16,9,15,4,44,29,14,10,0,53,16,9,15,4,44,1,0,37,28,0.521739,0.478261,6,8
2022020691,2023-01-15,2,NYR,1,2,MTL,34,15,23,1,73,29,10,6,1,46,34,15,23,1,73,29,10,6,1,46,0,1,39,31,0.547619,0.452381,4,4
2022020692,2023-01-15,2,CAR,3,4,VAN,29,19,16,4,68,27,7,11,5,50,26,15,13,3,57,22,7,11,3,43,1,0,32,32,0.539683,0.460317,2,4
2022020693,2023-01-15,2,WPG,2,1,ARI,20,11,9,1,41,15,12,7,1,35,20,11,9,1,41,15,12,7,1,35,1,0,24,21,0.630435,0.369565,6,4
2022020694,2023-01-16,2,BUF,1,4,FLA,24,9,12,1,46,27,3,11,4,45,24,9,12,1,46,27,3,11,4,45,0,1,29,34,0.460317,0.539683,8,8
2022020695,2023-01-16,2,BOS,6,0,PHI,19,8,13,5,45,21,12,11,0,44,18,8,13,4,43,20,11,11,0,42,1,0,29,29,0.633333,0.366667,28,20
2022020696,2023-01-16,2,COL,6,3,DET,13,9,23,4,49,22,11,9,3,45,13,8,23,3,47,20,11,8,2,41,1,0,27,29,0.377358,0.622642,6,10
2022020697,2023-01-16,2,SJS,3,4,NJD,27,11,12,2,52,33,6,22,4,65,22,10,11,2,45,28,6,20,3,57,0,1,32,41,0.54717,0.45283,4,8
2022020698,2023-01-16,2,SEA,1,4,TBL,19,9,9,1,38,20,10,13,4,47,19,9,9,1,38,20,10,13,4,47,0,1,23,31,0.395349,0.604651,4,6
2022020699,2023-01-16,2,VGK,0,4,DAL,22,12,12,0,46,28,14,18,4,64,22,12,12,0,46,28,14,18,4,64,0,1,27,36,0.446429,0.553571,4,4
2022020700,2023-01-16,2,PIT,4,3,ANA,35,11,18,4,68,21,5,10,1,37,33,11,18,3,65,19,5,10,1,35,1,0,45,29,0.568627,0.431373,8,8
2022020701,2023-01-16,2,CBJ,1,3,NYR,19,5,11,1,36,25,11,16,2,54,19,5,11,0,35,24,10,16,1,51,0,1,25,33,0.509434,0.490566,10,8
2022020702,2023-01-16,2,NYI,3,4,WSH,25,9,13,3,50,30,13,14,4,61,23,9,13,3,48,27,11,13,2,53,1,0,30,35,0.431373,0.568627,4,4
2022020703,2023-01-16,2,NSH,2,1,CGY,25,12,19,2,58,28,11,9,1,49,25,12,19,2,58,28,11,9,1,49,1,0,29,39,0.603175,0.396825,8,6
2022020704,2023-01-16,2,STL,2,1,OTT,17,7,19,2,45,27,8,8,1,44,17,7,19,2,45,27,8,8,1,44,1,0,20,33,0.685185,0.314815,7,9
2022020705,2023-01-17,2,PHI,5,2,ANA,23,12,11,3,49,21,9,8,1,39,23,12,11,3,49,21,9,8,1,39,1,0,39,27,0.461538,0.538462,11,15
2022020706,2023-01-17,2,TOR,5,4,FLA,24,11,10,3,48,11,8,15,2,36,22,10,10,2,44,11,8,13,2,34,0,1,37,19,0.583333,0.416667,12,18
2022020707,2023-01-17,2,WSH,2,4,MIN,32,18,15,2,67,15,8,17,4,44,31,17,14,1,63,14,8,17,4,43,1,0,36,22,0.490909,0.509091,6,8
2022020708,2023-01-17,2,MTL,4,1,WPG,23,7,9,4,43,23,18,16,0,57,23,7,9,4,43,23,18,16,0,57,0,1,28,26,0.470588,0.529412,9,11
2022020709,2023-01-17,2,CHI,4,3,BUF,21,13,14,4,52,28,17,12,2,59,19,13,14,3,49,26,16,12,2,56,1,0,26,33,0.581395,0.418605,4,12
2022020710,2023-01-17,2,ARI,4,3,DET,17,10,20,5,52,33,10,16,2,61,15,8,17,3,43,31,9,15,2,57,0,1,23,40,0.555556,0.444444,6,4
2022020711,2023-01-17,2,EDM,5,2,SEA,25,8,13,5,51,25,7,9,1,42,25,8,13,5,51,25,7,9,1,42,0,1,33,31,0.5,0.5,8,6
2022020712,2023-01-18,2,OTT,5,4,PIT,25,12,6,1,44,8,11,4,2,25,25,12,6,0,43,7,11,4,2,24,0,1,40,19,0.483333,0.516667,10,18
2022020713,2023-01-18,2,NYI,1,4,BOS,19,10,19,1,49,18,12,5,3,38,18,9,18,1,46,17,12,5,3,37,1,0,26,24,0.372549,0.627451,8,14
2022020714,2023-01-18,2,CGY,1,4,COL,31,9,12,0,52,24,12,7,3,46,31,9,12,0,52,24,12,7,3,46,0,1,35,30,0.563636,0.436364,16,4
2022020715,2023-01-18,2,VAN,2,5,TBL,32,14,17,0,63,16,5,4,5,30,32,14,17,0,63,16,5,4,5,30,0,1,39,25,0.508772,0.491228,2,8
2022020716,2023-01-18,2,SJS,5,3,DAL,20,14,9,4,47,30,7,8,3,48,20,14,9,4,47,30,7,8,3,48,0,1,28,36,0.5,0.5,6,6
2022020717,2023-01-19,2,CBJ,3,5,ANA,26,15,12,3,56,22,9,8,5,44,26,15,12,3,56,22,9,8,5,44,1,0,33,33,0.472727,0.527273,11,7
2022020718,2023-01-19,2,NYR,1,3,BOS,27,13,21,1,62,21,10,7,3,41,27,12,21,1,61,21,8,7,3,39,0,1,32,27,0.490566,0.509434,8,6
2022020719,2023-01-19,2,PHI,1,4,CHI,33,17,20,1,71,25,10,16,4,55,33,17,20,1,71,25,10,16,4,55,1,0,38,29,0.5,0.5,0,4
2022020720,2023-01-19,2,MTL,2,6,FLA,11,6,14,2,33,17,10,9,2,38,11,6,14,2,33,17,10,9,2,38,0,1,25,40,0.56,0.44,53,37
2022020721,2023-01-19,2,CAR,5,2,MIN,12,11,13,2,38,16,9,12,1,38,12,11,13,2,38,16,9,12,1,38,0,1,29,31,0.508197,0.491803,21,24
2022020722,2023-01-19,2,BUF,3,2,NYI,37,15,24,3,79,21,12,9,2,44,37,15,24,2,78,21,12,9,2,44,0,1,45,26,0.440678,0.559322,2,6
2022020723,2023-01-19,2,TOR,4,1,WPG,21,10,4,3,38,29,15,14,0,58,21,10,4,3,38,29,15,14,0,58,1,0,27,38,0.410714,0.589286,8,2
2022020724,2023-01-19,2,STL,5,2,NSH,24,11,9,4,48,19,10,6,2,37,23,11,9,4,47,16,8,4,1,29,1,0,33,26,0.714286,0.285714,13,15
2022020725,2023-01-19,2,EDM,5,3,TBL,26,10,16,4,56,25,13,10,3,51,24,10,16,4,54,24,12,9,3,48,1,0,34,31,0.45,0.55,20,24
2022020726,2023-01-19,2,ARI,0,4,WSH,25,8,6,0,39,23,13,16,3,55,24,8,6,0,38,23,13,15,3,54,0,1,26,33,0.471698,0.528302,8,6
2022020727,2023-01-19,2,VGK,2,3,DET,33,11,15,2,61,22,10,12,2,46,33,11,15,2,61,22,10,12,2,46,0,1,35,25,0.59322,0.40678,2,0
2022020728,2023-01-19,2,SEA,4,3,NJD,35,17,19,4,75,25,14,15,2,56,35,14,19,3,71,23,13,15,2,53,1,0,40,30,0.491803,0.508197,6,6
2022020729,2023-01-19,2,LAK,0,4,DAL,21,10,17,0,48,15,10,11,4,40,21,10,17,0,48,15,10,11,4,40,0,1,34,24,0.576923,0.423077,8,8
2022020730,2023-01-20,2,PIT,4,1,OTT,32,8,13,3,56,34,7,10,1,52,30,7,13,3,53,32,7,9,1,49,1,0,44,45,0.655738,0.344262,18,26
2022020731,2023-01-20,2,VAN,1,4,COL,20,7,5,1,33,18,8,11,2,39,20,7,5,1,33,18,8,11,2,39,0,1,29,29,0.526316,0.473684,8,8
2022020732,2023-01-21,2,BUF,6,3,ANA,28,11,8,5,52,32,10,11,3,56,28,11,8,5,52,32,10,11,3,56,1,0,39,37,0.490909,0.509091,7,9
2022020733,2023-01-21,2,CGY,6,3,TBL,29,10,14,5,58,14,10,7,3,34,29,10,14,5,58,14,10,7,3,34,1,0,41,24,0.354839,0.645161,21,27
2022020734,2023-01-21,2,FLA,5,3,MIN,19,12,12,4,47,24,17,11,1,53,19,12,12,4,47,24,17,11,1,53,1,0,27,32,0.491228,0.508772,19,9
2022020735,2023-01-21,2,DET,1,2,PHI,28,10,27,1,66,19,11,11,2,43,26,10,26,1,63,19,11,11,2,43,0,1,31,25,0.59322,0.40678,6,8
2022020736,2023-01-21,2,CBJ,5,3,SJS,20,15,13,4,52,19,8,3,3,33,20,15,13,4,52,19,8,3,3,33,0,1,29,25,0.526316,0.473684,7,9
2022020737,2023-01-21,2,MTL,3,2,TOR,20,6,11,3,40,30,17,19,2,68,18,5,10,2,35,28,16,19,2,65,0,1,31,38,0.367347,0.632653,6,10
2022020738,2023-01-21,2,OTT,1,5,WPG,19,5,10,1,35,19,13,7,3,42,19,4,10,1,34,19,12,7,3,41,0,1,26,30,0.519231,0.480769,53,15
2022020739,2023-01-21,2,NYI,2,5,CAR,25,10,15,2,52,20,16,16,5,57,25,10,15,2,52,20,16,16,5,57,0,1,31,26,0.516667,0.483333,10,8
2022020740,2023-01-21,2,DAL,4,0,ARI,25,10,5,3,43,25,9,9,0,43,25,10,5,3,43,25,9,9,0,43,1,0,39,33,0.612245,0.387755,6,8
2022020741,2023-01-21,2,STL,3,5,CHI,27,8,14,2,51,10,5,8,4,27,27,8,14,2,51,10,5,8,4,27,0,1,32,18,0.52,0.48,11,15
2022020742,2023-01-21,2,NSH,5,3,LAK,22,13,15,4,54,23,10,13,2,48,19,12,15,4,50,23,9,13,2,47,1,0,28,34,0.54902,0.45098,15,9
2022020743,2023-01-21,2,SEA,1,2,COL,24,22,11,1,58,22,11,17,2,52,24,18,11,1,54,21,9,17,1,48,0,1,27,27,0.531915,0.468085,4,4
2022020744,2023-01-21,2,VAN,2,4,EDM,24,8,10,2,44,25,8,7,3,43,23,7,8,2,40,24,8,7,3,42,0,1,29,29,0.45283,0.54717,4,6
2022020745,2023-01-21,2,VGK,6,2,WSH,20,15,9,6,50,17,8,15,2,42,18,15,8,6,47,14,8,14,2,38,1,0,27,22,0.571429,0.428571,8,4
2022020746,2023-01-22,2,NJD,2,1,PIT,21,10,19,1,51,25,17,13,1,56,20,8,19,1,48,25,17,13,0,55,1,0,25,26,0.52,0.48,4,4
2022020747,2023-01-22,2,CHI,1,2,LAK,17,11,11,1,40,25,14,7,2,48,16,10,11,1,38,25,13,7,2,47,0,1,19,27,0.604651,0.395349,2,6
2022020748,2023-01-22,2,BOS,4,0,SJS,14,10,10,3,37,17,11,8,0,36,12,10,10,2,34,17,9,8,0,34,1,0,22,18,0.464286,0.535714,11,15
2022020749,2023-01-22,2,PHI,3,5,WPG,25,6,11,1,43,20,10,11,5,46,23,6,11,1,41,20,10,11,5,46,0,1,31,30,0.5,0.5,10,8
2022020750,2023-01-22,2,ARI,4,1,VGK,15,12,10,4,41,31,17,14,0,62,14,11,10,4,39,31,17,14,0,62,1,0,23,36,0.375,0.625,8,2
2022020751,2023-01-23,2,NYR,6,2,FLA,18,9,13,5,45,29,9,20,1,59,18,9,13,5,45,29,9,20,1,59,1,0,26,35,0.507463,0.492537,4,2
2022020752,2023-01-23,2,TOR,5,2,NYI,25,14,10,4,53,29,16,23,2,70,23,14,10,4,51,28,16,22,2,68,0,1,39,33,0.45283,0.54717,6,6
2022020753,2023-01-23,2,DAL,2,3,BUF,24,6,12,1,43,21,12,13,3,49,24,6,12,1,43,20,12,13,2,47,1,0,31,25,0.62,0.38,6,2
2022020754,2023-01-23,2,CGY,4,3,CBJ,40,15,19,4,78,20,8,11,1,40,37,14,18,3,72,19,6,11,1,37,1,0,49,25,0.577465,0.422535,15,11
2022020755,2023-01-24,2,MTL,2,4,BOS,17,11,11,1,40,20,9,15,3,47,17,11,11,1,40,20,9,14,3,46,1,0,22,29,0.55,0.45,8,8
2022020756,2023-01-24,2,PIT,7,6,FLA,39,13,23,4,79,28,15,12,4,59,36,12,23,4,75,26,14,12,4,56,0,1,49,39,0.587302,0.412698,6,10
2022020757,2023-01-24,2,PHI,3,4,LAK,22,5,7,3,37,29,11,11,3,54,21,4,7,3,35,27,10,11,2,50,1,0,31,38,0.33871,0.66129,24,8
2022020758,2023-01-24,2,TBL,4,2,MIN,23,3,13,3,42,28,13,11,0,52,22,3,12,3,40,28,13,11,0,52,0,1,39,35,0.54386,0.45614,23,15
2022020759,2023-01-24,2,NJD,3,2,VGK,30,12,21,2,65,25,8,18,2,53,29,11,21,2,63,25,8,17,2,52,1,0,36,30,0.648148,0.351852,11,7
2022020760,2023-01-24,2,DET,3,2,SJS,28,11,8,3,50,26,10,22,2,60,21,8,8,2,39,26,10,22,2,60,1,0,35,30,0.559322,0.440678,4,6
2022020761,2023-01-24,2,STL,3,5,BUF,24,7,4,3,38,20,7,5,4,36,23,6,4,3,36,19,6,4,4,33,0,1,28,31,0.574468,0.425532,6,6
2022020762,2023-01-24,2,NSH,2,1,WPG,36,11,10,2,59,28,10,13,1,52,36,11,10,2,59,28,10,13,1,52,0,1,41,33,0.5,0.5,13,11
2022020763,2023-01-24,2,ARI,2,5,ANA,31,11,18,1,61,34,9,8,4,55,31,11,18,1,61,34,9,8,4,55,0,1,39,43,0.507937,0.492063,27,18
2022020764,2023-01-24,2,COL,3,2,WSH,23,7,15,3,48,33,15,15,2,65,23,7,15,3,48,33,15,15,2,65,1,0,26,39,0.525424,0.474576,4,0
2022020765,2023-01-24,2,VAN,5,2,CHI,34,9,14,4,61,3,10,6,2,21,34,9,14,4,61,3,10,6,2,21,0,1,48,14,0.478261,0.521739,16,30
2022020766,2023-01-25,2,OTT,2,1,NYI,31,21,17,1,70,31,13,10,1,55,31,21,17,1,70,31,13,10,1,55,1,0,38,36,0.446429,0.553571,11,11
2022020767,2023-01-25,2,TOR,3,2,NYR,24,14,14,3,55,20,11,9,2,42,24,14,14,2,54,20,11,9,2,42,1,0,35,29,0.5,0.5,4,6
2022020768,2023-01-25,2,DAL,2,3,CAR,19,3,8,2,32,20,12,18,2,52,19,3,8,2,32,20,11,17,1,49,0,1,21,24,0.412698,0.587302,9,9
2022020769,2023-01-25,2,EDM,2,3,CBJ,31,7,24,1,63,21,14,19,3,57,31,5,23,1,60,19,13,19,2,53,0,1,36,27,0.566038,0.433962,4,2
2022020770,2023-01-25,2,SEA,6,1,VAN,26,10,17,4,57,16,4,11,1,32,26,10,17,4,57,16,4,11,1,32,1,0,35,20,0.555556,0.444444,17,13
2022020771,2023-01-26,2,TBL,3,2,BOS,30,13,9,2,54,35,6,9,2,52,28,12,9,2,51,35,6,9,1,51,1,0,35,39,0.539683,0.460317,13,15
2022020772,2023-01-26,2,MTL,3,4,DET,15,10,17,2,44,36,9,24,3,72,14,10,17,2,43,33,8,22,2,65,0,1,23,42,0.526316,0.473684,9,9
2022020773,2023-01-26,2,WSH,3,2,PIT,29,6,17,3,55,37,9,17,3,66,28,5,17,1,51,31,9,17,2,59,1,0,45,37,0.461538,0.538462,6,10
2022020774,2023-01-26,2,WPG,2,3,BUF,17,14,15,1,47,29,7,11,2,49,17,14,15,1,47,29,7,11,2,49,0,1,21,36,0.44186,0.55814,4,6
2022020775,2023-01-26,2,NSH,6,4,NJD,30,15,12,5,62,27,9,16,4,56,30,15,12,5,62,27,9,16,4,56,0,1,41,39,0.415385,0.584615,4,4
2022020776,2023-01-26,2,COL,3,5,ANA,39,13,15,2,69,24,6,11,5,46,39,13,15,2,69,24,6,11,5,46,1,0,44,32,0.548387,0.451613,4,4
2022020777,2023-01-26,2,CGY,1,5,CHI,31,16,16,1,64,22,12,6,5,45,31,16,16,1,64,22,12,6,5,45,0,1,35,29,0.438596,0.561404,2,6
2022020778,2023-01-26,2,MIN,3,2,PHI,19,11,21,2,53,24,7,13,2,46,17,11,20,1,49,23,7,13,2,45,0,1,23,30,0.557692,0.442308,28,28
2022020779,2023-01-26,2,ARI,5,0,STL,19,9,10,4,42,24,10,15,0,49,19,9,10,4,42,24,10,15,0,49,1,0,25,33,0.433962,0.566038,11,9
2022020780,2023-01-27,2,NYI,2,0,DET,22,15,9,2,48,12,11,8,0,31,22,15,9,2,48,12,10,8,0,30,1,0,29,23,0.48,0.52,10,10
2022020781,2023-01-27,2,FLA,3,4,LAK,40,10,15,3,68,27,5,13,2,47,40,10,14,3,67,23,5,12,2,42,0,1,48,33,0.516667,0.483333,8,15
2022020782,2023-01-27,2,TOR,2,6,OTT,26,13,13,1,53,18,11,3,5,37,24,12,13,1,50,17,11,3,4,35,0,1,33,34,0.4,0.6,12,8
2022020783,2023-01-27,2,CAR,5,4,SJS,25,16,15,4,60,22,8,12,4,46,24,16,15,3,58,21,8,12,4,45,0,1,36,30,0.522388,0.477612,4,4
2022020784,2023-01-27,2,NYR,4,1,VGK,30,14,6,4,54,25,9,9,1,44,30,14,6,4,54,25,9,9,1,44,1,0,40,34,0.446429,0.553571,9,9
2022020785,2023-01-27,2,DAL,2,3,NJD,28,9,21,1,59,22,5,11,3,41,27,9,20,1,57,22,5,10,2,39,1,0,35,29,0.619048,0.380952,6,8
2022020786,2023-01-27,2,SEA,2,5,CGY,16,13,10,2,41,26,11,12,5,54,16,13,10,2,41,26,11,12,5,54,1,0,30,38,0.387097,0.612903,6,12
2022020787,2023-01-27,2,VAN,5,2,CBJ,26,8,10,2,46,23,8,7,0,38,26,8,10,2,46,23,8,7,0,38,1,0,34,26,0.59322,0.40678,8,8
2022020788,2023-01-28,2,COL,4,2,STL,24,12,14,4,54,23,9,14,1,47,23,12,13,4,52,23,9,14,1,47,1,0,31,28,0.542373,0.457627,10,10
2022020789,2023-01-28,2,FLA,4,3,BOS,28,14,19,4,65,25,11,14,3,53,28,14,19,3,64,25,11,14,3,53,0,1,37,40,0.5,0.5,10,4
2022020790,2023-01-28,2,TBL,5,2,LAK,19,9,14,5,47,23,9,9,2,43,19,9,13,5,46,23,9,9,2,43,1,0,25,28,0.586207,0.413793,14,14
2022020791,2023-01-28,2,OTT,5,0,MTL,26,16,10,3,55,20,9,15,0,44,26,16,10,3,55,20,9,15,0,44,1,0,36,28,0.488889,0.511111,6,6
2022020792,2023-01-28,2,WPG,0,4,PHI,32,16,14,0,62,27,13,14,4,58,32,15,14,0,61,24,11,13,4,52,0,1,40,33,0.534483,0.465517,6,8
2022020793,2023-01-28,2,PIT,4,6,SJS,34,12,21,1,68,24,11,17,6,58,34,12,21,1,68,24,11,17,6,58,0,1,41,32,0.508197,0.491803,9,13
2022020794,2023-01-28,2,NYI,2,1,VGK,30,9,22,2,63,37,7,15,1,60,30,8,21,1,60,33,7,15,1,56,1,0,38,46,0.559322,0.440678,4,2
2022020795,2023-01-28,2,MIN,3,2,BUF,25,10,9,4,48,30,8,14,3,55,22,10,9,1,42,28,6,13,2,49,0,1,35,31,0.526316,0.473684,2,8
2022020796,2023-01-28,2,ANA,2,1,ARI,37,10,16,2,65,30,13,10,1,54,33,9,16,1,59,28,12,9,1,50,0,1,45,34,0.442623,0.557377,20,10
2022020797,2023-01-28,2,EDM,7,3,CHI,33,8,16,5,62,23,6,15,2,46,33,8,16,5,62,23,6,15,2,46,1,0,43,29,0.573529,0.426471,11,11
2022020798,2023-01-28,2,SEA,3,1,CBJ,26,15,14,3,58,20,11,13,1,45,26,15,13,3,57,20,11,13,1,45,1,0,31,25,0.451613,0.548387,4,4
2022020799,2023-01-29,2,CAR,4,1,BOS,26,6,5,2,39,16,5,4,1,26,26,6,5,2,39,16,5,4,1,26,1,0,36,25,0.423729,0.576271,14,10
2022020800,2023-01-29,2,TOR,5,1,WSH,20,10,7,4,41,17,9,14,0,40,19,10,6,4,39,17,9,13,0,39,0,1,27,24,0.5,0.5,10,6
2022020801,2023-01-30,2,WPG,4,2,STL,26,9,13,4,52,19,6,11,1,37,26,9,13,4,52,19,6,11,1,37,0,1,39,26,0.491803,0.508197,4,12
2022020802,2023-01-31,2,CAR,5,4,LAK,25,20,13,3,61,17,8,7,3,35,22,19,13,3,57,16,8,6,3,33,1,0,30,21,0.569231,0.430769,4,4
2022020803,2023-01-31,2,MTL,4,5,OTT,20,7,12,2,41,18,8,13,3,42,20,7,12,2,41,18,8,13,3,42,0,1,32,29,0.589286,0.410714,6,10
2022020804,2023-01-31,2,CBJ,3,4,WSH,30,9,21,3,63,26,7,18,4,55,30,9,19,3,61,24,5,17,3,49,0,1,34,34,0.459016,0.540984,8,8
2022020805,2023-02-01,2,BUF,1,5,CAR,25,8,9,1,43,26,4,15,3,48,25,8,9,1,43,26,4,15,3,48,0,1,30,34,0.384615,0.615385,4,8
2022020806,2023-02-01,2,TOR,2,5,BOS,33,14,19,1,67,22,10,9,4,45,31,14,18,1,64,22,10,9,3,44,0,1,35,29,0.510204,0.489796,9,11
2022020807,2023-02-06,2,PHI,1,2,NYI,22,11,16,1,50,25,11,15,1,52,22,11,16,1,50,25,11,15,1,52,0,1,26,30,0.452381,0.547619,6,4
2022020808,2023-02-06,2,FLA,7,1,TBL,36,11,15,6,68,30,13,11,1,55,35,11,13,5,64,29,12,10,1,52,1,0,49,33,0.467742,0.532258,16,16
2022020809,2023-02-06,2,NYR,5,4,CGY,21,12,13,4,50,21,11,15,3,50,17,12,12,3,44,21,10,15,3,49,1,0,33,32,0.433333,0.566667,21,41
2022020810,2023-02-06,2,NJD,5,4,VAN,23,8,12,4,47,21,10,18,4,53,21,8,12,4,45,21,9,18,4,52,0,1,34,30,0.566667,0.433333,2,8
2022020811,2023-02-06,2,DAL,3,2,ANA,31,17,19,4,71,24,10,9,2,45,26,15,18,2,61,21,9,8,1,39,1,0,41,34,0.655172,0.344828,8,20
2022020812,2023-02-06,2,ARI,3,2,MIN,25,17,12,2,56,28,12,12,2,54,22,17,12,2,53,28,11,12,2,53,0,1,36,35,0.535714,0.464286,8,12
2022020813,2023-02-07,2,PIT,2,1,COL,35,15,24,2,76,34,10,13,1,58,32,15,23,1,71,33,10,11,0,54,0,1,38,42,0.490566,0.509434,8,2
2022020814,2023-02-07,2,TBL,3,4,SJS,31,12,19,2,64,16,11,5,2,34,31,12,19,2,64,16,10,4,1,31,1,0,37,22,0.514706,0.485294,11,17
2022020815,2023-02-07,2,DET,2,5,EDM,22,6,7,2,37,15,7,7,3,32,20,6,7,2,35,14,7,6,3,30,1,0,32,27,0.509434,0.490566,14,18
2022020816,2023-02-07,2,NYI,4,0,SEA,22,10,13,4,49,28,14,15,0,57,22,10,13,4,49,28,14,15,0,57,1,0,28,32,0.588235,0.411765,2,2
2022020817,2023-02-07,2,NSH,1,5,VGK,13,19,11,1,44,21,8,14,5,48,12,18,11,1,42,19,8,14,5,46,1,0,17,30,0.489796,0.510204,6,6
2022020818,2023-02-07,2,CHI,2,3,ANA,22,15,15,2,54,20,4,9,3,36,21,13,15,2,51,19,4,8,2,33,1,0,29,26,0.596154,0.403846,4,6
2022020819,2023-02-08,2,NYR,4,3,VAN,14,11,10,4,39,22,6,10,3,41,14,11,10,4,39,22,6,10,3,41,1,0,21,25,0.5,0.5,2,6
2022020820,2023-02-08,2,DAL,4,1,MIN,28,9,15,4,56,35,13,17,0,65,27,9,15,4,55,35,13,17,0,65,1,0,37,39,0.6,0.4,6,2
2022020821,2023-02-09,2,TBL,5,0,COL,19,13,16,3,51,23,12,15,0,50,19,13,16,3,51,23,12,15,0,50,1,0,32,30,0.693548,0.306452,14,26
2022020822,2023-02-09,2,PHI,2,1,EDM,34,6,14,3,57,33,12,11,2,58,30,5,13,1,49,27,10,11,1,49,1,0,36,35,0.519231,0.480769,0,6
2022020823,2023-02-09,2,FLA,4,1,SJS,36,14,15,2,67,26,12,11,1,50,36,14,15,2,67,26,12,11,1,50,0,1,42,34,0.484375,0.515625,11,7
2022020824,2023-02-09,2,NJD,3,1,SEA,23,9,11,1,44,26,7,22,1,56,23,9,11,1,44,26,7,22,1,56,0,1,27,34,0.603448,0.396552,6,8
2022020825,2023-02-09,2,DET,2,1,CGY,6,9,7,1,23,28,11,12,1,52,6,9,7,1,23,28,11,12,1,52,0,1,17,36,0.488889,0.511111,6,10
2022020826,2023-02-09,2,NYI,5,6,VAN,18,8,12,3,41,22,10,8,4,44,18,8,12,3,41,22,10,8,4,44,1,0,29,34,0.530612,0.469388,8,6
2022020827,2023-02-09,2,MIN,1,5,VGK,25,12,16,0,53,26,5,13,5,49,25,12,16,0,53,26,5,13,4,48,0,1,28,31,0.485294,0.514706,6,8
2022020828,2023-02-10,2,NYR,6,3,SEA,14,9,10,3,36,21,17,17,2,57,14,9,10,3,36,21,15,14,2,52,1,0,28,29,0.596491,0.403509,10,6
2022020829,2023-02-10,2,CBJ,0,3,TOR,25,10,12,0,47,27,8,15,2,52,25,10,12,0,47,27,8,15,2,52,0,1,30,41,0.589286,0.410714,18,6
2022020830,2023-02-10,2,CHI,4,3,ARI,35,9,8,4,56,22,13,11,3,49,32,9,8,3,52,20,13,9,3,45,0,1,44,26,0.538462,0.461538,4,4
2022020831,2023-02-10,2,ANA,3,6,PIT,23,5,6,2,36,44,13,15,5,77,23,5,6,2,36,44,13,15,5,77,0,1,31,59,0.454545,0.545455,10,6
2022020832,2023-02-11,2,DET,5,2,VAN,16,4,6,3,29,26,10,19,1,56,16,4,6,3,29,26,9,19,1,55,1,0,25,34,0.469388,0.530612,6,12
2022020833,2023-02-11,2,BUF,2,7,CGY,11,5,17,1,34,28,13,11,6,58,11,5,17,1,34,28,13,10,6,57,1,0,23,40,0.5,0.5,10,10
2022020834,2023-02-11,2,OTT,3,6,EDM,22,11,11,2,46,22,4,16,3,45,22,10,9,2,43,22,4,16,2,44,0,1,29,40,0.491803,0.508197,15,13
2022020835,2023-02-11,2,MTL,4,3,NYI,23,10,12,4,49,25,8,19,2,54,21,10,12,3,46,22,6,18,2,48,1,0,31,30,0.44898,0.55102,4,4
2022020836,2023-02-11,2,PHI,1,2,NSH,23,9,13,1,46,23,12,30,2,67,23,9,13,1,46,23,12,30,1,66,0,1,24,25,0.384615,0.615385,12,10
2022020837,2023-02-11,2,DAL,1,3,TBL,22,19,14,1,56,26,14,16,3,59,21,19,14,1,55,25,13,15,3,56,0,1,29,31,0.509091,0.490909,4,10
2022020838,2023-02-11,2,BOS,1,2,WSH,22,12,11,1,46,19,12,16,1,48,20,12,11,1,44,17,11,16,1,45,0,1,28,23,0.551724,0.448276,12,12
2022020839,2023-02-11,2,FLA,3,5,COL,31,6,14,3,54,36,5,10,3,54,31,6,14,3,54,36,5,10,3,54,0,1,45,50,0.535211,0.464789,11,13
2022020840,2023-02-11,2,TOR,3,4,CBJ,22,14,17,2,55,24,10,16,4,54,21,14,17,2,54,24,10,16,4,54,1,0,29,40,0.490909,0.509091,10,4
2022020841,2023-02-11,2,CAR,2,6,NYR,23,20,14,2,59,12,12,8,5,37,23,20,14,2,59,12,12,8,5,37,0,1,29,19,0.564516,0.435484,2,4
2022020842,2023-02-11,2,STL,6,5,ARI,19,11,11,6,47,18,5,13,3,39,18,11,10,5,44,18,5,13,3,39,0,1,37,28,0.666667,0.333333,8,10
2022020843,2023-02-11,2,MIN,3,2,NJD,22,15,21,3,61,24,9,12,2,47,19,12,20,1,52,18,8,10,2,38,1,0,24,29,0.47541,0.52459,21,13
2022020844,2023-02-11,2,WPG,4,1,CHI,19,13,16,3,51,24,12,17,1,54,19,13,16,3,51,24,12,17,1,54,1,0,28,32,0.508475,0.491525,11,11
2022020845,2023-02-11,2,LAK,6,0,PIT,21,8,10,4,43,16,13,18,0,47,21,8,10,4,43,16,13,18,0,47,1,0,31,25,0.46,0.54,20,30
2022020846,2023-02-12,2,MTL,6,2,EDM,15,3,13,3,34,18,7,15,1,41,15,3,13,3,34,18,7,15,1,41,1,0,30,31,0.27451,0.72549,21,15
2022020847,2023-02-12,2,WSH,1,4,SJS,16,9,12,1,38,25,16,21,3,65,16,9,12,1,38,25,16,21,3,65,0,1,21,33,0.375,0.625,8,6
2022020848,2023-02-12,2,PHI,3,4,SEA,13,9,15,1,38,16,14,24,4,58,13,9,15,1,38,16,14,24,4,58,1,0,18,21,0.44186,0.55814,2,4
2022020849,2023-02-12,2,VGK,7,2,ANA,30,12,13,7,62,16,13,11,2,42,30,12,13,6,61,16,13,11,2,42,1,0,39,25,0.588235,0.411765,6,4
2022020850,2023-02-13,2,OTT,4,3,CGY,18,8,9,4,39,28,18,24,2,72,17,8,8,3,36,24,15,23,2,64,1,0,25,37,0.428571,0.571429,10,10
2022020851,2023-02-13,2,NSH,2,4,ARI,22,10,11,1,44,15,10,8,3,36,22,10,11,1,44,15,10,8,3,36,0,1,31,19,0.693878,0.306122,2,10
2022020852,2023-02-13,2,MIN,1,2,FLA,20,12,11,2,45,17,11,18,3,49,15,9,9,1,34,17,10,16,1,44,0,1,28,34,0.568966,0.431034,16,12
2022020853,2023-02-13,2,VAN,1,6,DET,23,12,8,1,44,16,7,11,5,39,22,12,8,1,43,16,7,11,5,39,0,1,30,23,0.568182,0.431818,2,8
2022020854,2023-02-13,2,LAK,5,2,BUF,18,12,9,2,41,24,9,14,1,48,18,12,9,2,41,24,9,14,1,48,1,0,28,29,0.603448,0.396552,12,8
2022020855,2023-02-14,2,WSH,2,3,CAR,28,11,13,2,54,25,18,13,2,58,28,11,13,2,54,25,18,13,2,58,0,1,36,30,0.585714,0.414286,2,6
2022020856,2023-02-14,2,MTL,4,0,CHI,24,8,13,3,48,19,7,12,0,38,24,8,13,3,48,19,7,12,0,38,1,0,31,22,0.519231,0.480769,28,16
2022020857,2023-02-14,2,CBJ,2,3,NJD,28,6,10,1,45,28,18,22,3,71,28,6,10,1,45,28,18,22,3,71,0,1,33,32,0.538462,0.461538,4,6
2022020858,2023-02-14,2,NYI,2,3,OTT,33,17,15,1,66,23,10,15,3,51,28,16,14,1,59,22,10,15,1,48,1,0,48,34,0.484375,0.515625,6,12
2022020859,2023-02-14,2,STL,6,2,FLA,22,15,7,5,49,29,12,19,2,62,22,15,7,5,49,29,12,19,2,62,1,0,28,36,0.519231,0.480769,4,4
2022020860,2023-02-14,2,WPG,3,2,SEA,34,13,10,4,61,23,12,9,1,45,31,10,10,2,53,19,10,7,1,37,1,0,40,29,0.540984,0.459016,8,6
2022020861,2023-02-14,2,DAL,2,3,BOS,20,11,17,2,50,32,7,13,3,55,19,10,17,2,48,32,7,13,2,54,0,1,31,37,0.806452,0.193548,6,8
2022020862,2023-02-14,2,COL,3,4,TBL,37,6,10,3,56,29,19,15,4,67,34,4,7,3,48,27,16,15,3,61,1,0,46,35,0.462963,0.537037,13,9
2022020863,2023-02-14,2,SJS,1,3,PIT,33,6,11,1,51,21,10,12,3,46,33,6,11,1,51,21,10,12,3,46,0,1,39,28,0.666667,0.333333,6,4
2022020864,2023-02-15,2,TOR,5,2,CHI,33,8,11,5,57,23,5,12,2,42,33,8,11,5,57,23,5,12,2,42,1,0,42,29,0.557692,0.442308,6,6
2022020865,2023-02-15,2,ARI,1,0,TBL,24,10,12,2,48,35,18,9,1,63,23,9,12,0,44,28,13,8,0,49,0,0,26,47,0.520833,0.479167,10,4
2022020866,2023-02-15,2,MIN,2,3,COL,40,18,19,1,78,15,5,17,3,40,40,18,19,1,78,15,5,17,3,40,0,1,43,19,0.576923,0.423077,7,9
2022020867,2023-02-15,2,EDM,4,5,DET,40,19,17,4,80,19,7,4,4,34,35,16,16,3,70,16,5,3,2,26,0,1,45,23,0.538462,0.461538,4,6
2022020868,2023-02-15,2,ANA,3,7,BUF,17,7,9,3,36,25,8,9,6,48,17,7,9,3,36,25,8,9,6,48,0,1,22,44,0.578947,0.421053,24,18
2022020869,2023-02-15,2,VAN,4,6,NYR,23,7,15,3,48,21,5,9,6,41,23,7,15,3,48,21,5,9,6,41,1,0,29,28,0.631579,0.368421,2,4
2022020870,2023-02-16,2,WSH,3,6,FLA,29,10,18,1,58,23,12,9,6,50,29,10,18,1,58,23,12,9,6,50,0,1,32,36,0.561404,0.438596,6,12
2022020871,2023-02-16,2,CAR,6,2,MTL,29,16,9,5,59,17,7,4,1,29,29,16,9,5,59,17,7,4,1,29,0,1,41,22,0.535714,0.464286,6,6
2022020872,2023-02-16,2,CBJ,3,1,WPG,13,4,8,2,27,23,13,16,0,52,13,3,8,2,26,23,12,16,0,51,0,1,24,38,0.542373,0.457627,14,10
2022020873,2023-02-16,2,NSH,0,5,BOS,23,13,9,0,45,15,10,10,4,39,23,13,9,0,45,15,10,10,4,39,0,1,28,30,0.377358,0.622642,18,6
2022020874,2023-02-16,2,STL,4,2,NJD,27,12,16,3,58,32,11,19,2,64,27,12,16,3,58,32,11,19,2,64,1,0,35,36,0.5,0.5,4,8
2022020875,2023-02-16,2,CGY,2,5,DET,27,22,21,1,71,16,5,6,3,30,27,22,21,1,71,16,5,6,3,30,1,0,35,24,0.440678,0.559322,8,4
2022020876,2023-02-16,2,SEA,6,2,PHI,17,12,15,3,47,17,13,18,2,50,17,12,15,3,47,17,13,18,2,50,1,0,30,19,0.389831,0.610169,11,11
2022020877,2023-02-16,2,VGK,2,1,SJS,20,12,17,2,51,22,10,16,1,49,20,12,17,2,51,22,10,16,1,49,0,1,38,26,0.650794,0.349206,2,24
2022020878,2023-02-17,2,OTT,3,4,CHI,23,9,13,3,48,24,9,6,3,42,19,9,13,3,44,23,9,6,2,40,0,1,31,32,0.491803,0.508197,6,6
2022020879,2023-02-17,2,NYI,5,4,PIT,21,5,11,4,41,39,19,17,4,79,21,5,11,4,41,39,19,17,4,79,0,1,28,44,0.428571,0.571429,2,4
2022020880,2023-02-17,2,MIN,2,1,DAL,29,9,13,2,53,23,11,21,2,57,23,8,12,0,43,17,9,21,1,48,1,0,32,30,0.465517,0.534483,12,8
2022020881,2023-02-17,2,EDM,4,5,NYR,19,10,15,2,46,29,9,9,1,48,15,9,15,2,41,26,8,7,1,42,1,0,29,38,0.516129,0.483871,8,8
2022020882,2023-02-17,2,ANA,3,6,LAK,21,16,9,2,48,28,16,13,3,60,21,16,9,2,48,28,16,13,3,60,0,1,27,41,0.307692,0.692308,16,13
2022020883,2023-02-18,2,STL,1,4,COL,15,8,10,1,34,22,11,10,2,45,15,8,10,1,34,22,11,10,2,45,0,1,20,33,0.566038,0.433962,8,6
2022020884,2023-02-18,2,NSH,7,3,FLA,17,12,12,5,46,25,12,8,2,47,17,12,12,5,46,25,12,8,2,47,1,0,26,33,0.5,0.5,6,8
2022020885,2023-02-18,2,BOS,6,2,NYI,17,15,9,5,46,26,13,12,2,53,16,15,8,4,43,23,13,12,2,50,1,0,27,28,0.547619,0.452381,4,6
2022020886,2023-02-18,2,PIT,2,5,NJD,25,10,19,1,55,34,8,9,3,54,25,10,19,1,55,33,8,9,3,53,1,0,31,43,0.518519,0.481481,6,10
2022020887,2023-02-18,2,DAL,1,4,CBJ,27,15,18,1,61,30,17,16,4,67,27,15,18,1,61,30,17,16,4,67,0,1,29,36,0.464286,0.535714,2,2
2022020888,2023-02-18,2,TOR,5,1,MTL,32,8,11,4,55,27,10,13,1,51,32,8,11,4,55,27,10,13,1,51,0,1,41,30,0.603448,0.396552,2,6
2022020889,2023-02-18,2,CAR,4,1,WSH,24,13,13,3,53,23,7,5,1,36,24,13,13,3,53,23,7,5,1,36,1,0,35,25,0.5,0.5,9,13
2022020890,2023-02-18,2,CGY,3,2,NYR,25,16,12,2,55,16,6,11,1,34,25,16,12,2,55,15,6,11,1,33,1,0,32,20,0.488889,0.511111,14,6
2022020891,2023-02-18,2,VAN,6,2,PHI,17,5,8,3,33,30,17,23,1,71,17,5,8,3,33,30,17,23,1,71,1,0,23,37,0.603175,0.396825,4,4
2022020892,2023-02-18,2,LAK,6,5,ARI,26,11,15,6,58,22,7,9,4,42,22,9,15,4,50,16,6,9,4,35,1,0,37,32,0.519231,0.480769,8,10
2022020893,2023-02-18,2,SJS,2,4,BUF,28,12,9,2,51,27,10,18,4,59,27,11,9,2,49,23,10,16,4,53,0,1,35,31,0.486486,0.513514,4,4
2022020894,2023-02-18,2,SEA,4,2,DET,21,17,15,4,57,20,20,12,2,54,18,17,15,3,53,20,19,11,2,52,1,0,26,23,0.540984,0.459016,16,16
2022020895,2023-02-18,2,VGK,5,4,TBL,18,7,13,5,43,16,19,16,3,54,17,7,13,5,42,16,19,16,3,54,0,1,26,24,0.454545,0.545455,8,6
2022020896,2023-02-19,2,MIN,4,3,NSH,22,10,15,3,50,18,12,16,3,49,22,10,15,3,50,18,12,16,3,49,1,0,35,26,0.469388,0.530612,4,10
2022020897,2023-02-19,2,OTT,7,2,STL,17,5,4,6,32,21,7,12,2,42,15,5,4,6,30,21,7,12,2,42,1,0,34,32,0.565217,0.434783,19,25
2022020898,2023-02-19,2,COL,6,5,EDM,27,4,12,6,49,32,9,22,5,68,21,3,12,5,41,29,8,20,5,62,0,1,42,40,0.531646,0.468354,2,8
2022020899,2023-02-19,2,CHI,5,3,TOR,21,6,6,5,38,30,11,19,2,62,21,6,6,5,38,30,11,19,2,62,1,0,28,35,0.442308,0.557692,4,6
2022020900,2023-02-19,2,NJD,4,2,WPG,24,8,11,4,47,20,10,16,2,48,24,8,11,4,47,20,10,16,2,48,0,1,29,25,0.611111,0.388889,6,4
2022020901,2023-02-19,2,ARI,3,2,CBJ,21,10,18,3,52,26,19,10,1,56,20,10,18,2,50,25,18,10,1,54,1,0,25,36,0.465517,0.534483,16,12
2022020902,2023-02-20,2,FLA,4,3,ANA,47,11,21,4,83,23,2,10,2,37,44,10,20,3,77,23,1,9,2,35,0,1,55,32,0.532258,0.467742,8,8
2022020903,2023-02-20,2,BOS,3,1,OTT,20,9,15,3,47,27,2,13,1,43,20,9,15,3,47,27,2,13,1,43,1,0,32,31,0.587302,0.412698,8,10
2022020904,2023-02-20,2,CGY,3,4,PHI,26,11,27,3,67,15,5,5,4,29,26,11,27,3,67,14,5,5,4,28,0,1,35,22,0.581081,0.418919,9,13
2022020905,2023-02-20,2,SJS,4,0,SEA,18,12,7,4,41,23,11,13,0,47,18,12,7,4,41,23,11,13,0,47,1,0,23,26,0.433962,0.566038,4,4
2022020906,2023-02-20,2,PIT,2,4,NYI,39,11,13,1,64,23,6,19,4,52,39,11,13,1,64,23,6,19,4,52,1,0,46,32,0.392857,0.607143,30,32
2022020907,2023-02-20,2,NYR,1,4,WPG,40,8,7,1,56,16,6,9,3,34,40,8,7,1,56,16,6,9,3,34,0,1,51,21,0.540984,0.459016,7,13
2022020908,2023-02-21,2,TBL,6,1,ANA,28,16,11,4,59,18,4,6,1,29,28,16,11,4,59,18,4,6,1,29,1,0,44,25,0.618182,0.381818,28,30
2022020909,2023-02-21,2,WSH,1,3,DET,23,17,20,0,60,15,16,10,2,43,22,17,20,0,59,15,15,10,2,42,0,1,27,25,0.510638,0.489362,6,19
2022020910,2023-02-21,2,NJD,2,5,MTL,30,11,27,1,69,10,8,7,5,30,30,10,27,1,68,9,8,7,5,29,0,1,40,18,0.607843,0.392157,4,6
2022020911,2023-02-21,2,CAR,4,1,STL,32,19,18,4,73,30,10,5,1,46,32,19,18,4,73,30,10,5,1,46,1,0,36,36,0.59375,0.40625,6,0
2022020912,2023-02-21,2,BUF,3,6,TOR,29,6,17,3,55,20,3,7,5,35,29,6,17,3,55,20,3,7,5,35,0,1,32,29,0.410714,0.589286,6,4
2022020913,2023-02-21,2,MIN,2,1,LAK,13,8,10,2,33,32,17,21,1,71,13,8,10,2,33,31,17,21,1,70,1,0,20,34,0.425,0.575,2,6
2022020914,2023-02-21,2,NSH,5,4,VAN,18,10,14,3,45,28,10,18,3,59,16,7,14,3,40,26,9,16,3,54,1,0,26,39,0.596154,0.403846,8,8
2022020915,2023-02-21,2,CHI,3,2,VGK,34,10,13,2,59,34,10,16,2,62,27,10,13,1,51,31,6,14,2,53,0,1,39,36,0.465517,0.534483,12,6
2022020916,2023-02-21,2,EDM,4,2,PHI,19,9,11,1,40,17,7,9,2,35,19,9,11,1,40,17,7,9,2,35,0,1,27,26,0.551724,0.448276,6,8
2022020917,2023-02-22,2,NYI,2,1,WPG,16,6,9,2,33,19,10,11,0,40,14,6,9,1,30,18,10,10,0,38,1,0,22,26,0.407407,0.592593,10,10
2022020918,2023-02-22,2,DAL,3,4,CHI,27,16,20,2,65,18,14,9,3,44,27,16,20,2,65,16,14,9,3,42,1,0,32,23,0.4375,0.5625,4,6
2022020919,2023-02-22,2,ARI,3,6,CGY,11,15,10,2,38,38,12,16,3,69,11,15,10,2,38,38,12,16,3,69,0,1,14,51,0.47541,0.52459,10,4
2022020920,2023-02-23,2,WSH,2,4,ANA,33,15,17,1,66,13,8,16,4,41,33,15,17,1,66,13,8,16,4,41,1,0,43,21,0.5,0.5,16,16
2022020921,2023-02-23,2,TBL,5,6,BUF,29,14,8,4,55,15,13,10,4,42,29,14,8,4,55,15,13,10,4,42,1,0,41,23,0.45283,0.54717,4,6
2022020922,2023-02-23,2,PIT,2,7,EDM,19,11,8,1,39,32,8,10,5,55,19,11,8,1,39,32,8,10,4,54,1,0,24,44,0.589286,0.410714,6,8
2022020923,2023-02-23,2,NJD,4,3,LAK,23,14,14,4,55,17,10,8,3,38,19,14,14,3,50,17,10,8,3,38,0,1,32,22,0.6,0.4,2,8
2022020924,2023-02-23,2,CBJ,0,2,MIN,26,15,25,0,66,23,19,11,2,55,26,15,25,0,66,23,19,11,2,55,0,1,30,25,0.711538,0.288462,2,2
2022020925,2023-02-23,2,DET,4,1,NYR,15,7,8,3,33,23,13,21,1,58,15,7,8,3,33,23,12,21,1,57,1,0,23,31,0.526316,0.473684,11,15
2022020926,2023-02-23,2,STL,2,3,VAN,13,5,10,1,29,32,12,11,2,57,9,4,10,1,24,31,11,11,1,54,1,0,22,41,0.530612,0.469388,13,11
2022020927,2023-02-23,2,SEA,5,6,BOS,31,12,10,4,57,26,17,9,5,57,28,11,10,3,52,25,16,9,4,54,1,0,41,33,0.396552,0.603448,6,12
2022020928,2023-02-23,2,VGK,4,3,CGY,22,10,17,3,52,16,12,17,2,47,22,9,17,2,50,15,12,17,2,46,0,1,29,28,0.527273,0.472727,8,4
2022020929,2023-02-23,2,SJS,2,6,NSH,18,12,17,1,48,20,8,14,3,45,16,12,17,1,46,19,8,14,3,44,0,1,24,31,0.534483,0.465517,8,12
2022020930,2023-02-24,2,FLA,1,3,BUF,42,22,11,1,76,25,11,7,2,45,40,21,11,1,73,24,11,7,2,44,0,1,50,33,0.411765,0.588235,10,12
2022020931,2023-02-24,2,TOR,2,1,MIN,19,12,13,2,46,20,14,25,1,60,18,12,13,1,44,20,14,25,1,60,0,1,24,25,0.711538,0.288462,2,4
2022020932,2023-02-24,2,PHI,2,5,MTL,24,6,15,2,47,21,12,16,4,53,24,6,15,2,47,21,12,16,4,53,0,1,26,31,0.446429,0.553571,19,5
2022020933,2023-02-24,2,CAR,4,0,OTT,24,19,12,4,59,23,13,6,0,42,23,19,12,4,58,23,13,6,0,42,1,0,30,32,0.587302,0.412698,10,4
2022020934,2023-02-24,2,NYI,2,3,LAK,14,13,13,1,41,24,6,8,3,41,13,12,13,1,39,23,6,8,3,40,0,1,18,28,0.421053,0.578947,4,6
2022020935,2023-02-24,2,WPG,1,5,COL,24,14,10,0,48,23,6,12,5,46,24,14,10,0,48,22,6,12,5,45,0,1,27,36,0.47541,0.52459,6,10
2022020936,2023-02-25,2,CBJ,6,5,EDM,15,11,6,5,37,37,13,16,3,69,15,11,6,5,37,37,13,16,3,69,1,0,26,47,0.360656,0.639344,20,10
2022020937,2023-02-25,2,WSH,6,3,NYR,19,14,11,5,49,20,15,14,2,51,17,14,11,5,47,19,15,14,2,50,1,0,27,26,0.471698,0.528302,17,11
2022020938,2023-02-25,2,CAR,2,3,ANA,42,13,15,2,72,10,6,6,3,25,39,13,13,2,67,10,6,6,2,24,0,1,53,16,0.491803,0.508197,6,8
2022020939,2023-02-25,2,VAN,1,3,BOS,22,9,7,1,39,25,6,11,2,44,22,9,7,1,39,25,6,11,2,44,0,1,27,35,0.350877,0.649123,6,6
2022020940,2023-02-25,2,MTL,2,5,OTT,25,8,10,2,45,16,17,16,5,54,25,8,10,2,45,16,17,16,5,54,0,1,32,22,0.523077,0.476923,7,11
2022020941,2023-02-25,2,NJD,7,0,PHI,27,16,10,7,60,22,16,12,0,50,27,16,10,7,60,22,16,12,0,50,1,0,36,23,0.559322,0.440678,9,7
2022020942,2023-02-25,2,DET,0,3,TBL,37,9,23,0,69,12,7,10,3,32,36,9,23,0,68,11,7,10,3,31,0,1,45,18,0.481481,0.518519,4,8
2022020943,2023-02-25,2,STL,2,3,PIT,20,9,12,2,43,38,21,12,3,74,19,9,12,2,42,37,21,11,2,71,1,0,27,48,0.465517,0.534483,4,6
2022020944,2023-02-25,2,COL,4,1,CGY,18,5,10,3,36,24,13,19,0,56,18,5,10,3,36,22,13,19,0,54,1,0,22,29,0.5,0.5,17,15
2022020945,2023-02-25,2,VGK,2,3,DAL,33,12,13,2,60,33,8,13,4,58,24,12,11,2,49,30,8,12,2,52,1,0,43,43,0.509434,0.490566,8,4
2022020946,2023-02-25,2,SJS,3,4,CHI,45,14,18,3,80,24,14,6,4,48,37,14,18,3,72,22,12,6,3,43,0,1,48,35,0.610169,0.389831,13,7
2022020947,2023-02-26,2,BUF,7,4,WSH,26,9,7,7,49,23,13,9,3,48,26,9,7,7,49,23,13,9,3,48,1,0,37,30,0.578947,0.421053,11,13
2022020948,2023-02-26,2,MIN,3,2,CBJ,35,15,13,2,65,21,8,15,2,46,35,15,13,1,64,20,7,14,2,43,0,1,44,24,0.490909,0.509091,4,4
2022020949,2023-02-26,2,WPG,0,4,NYI,18,20,22,0,60,19,9,8,3,39,18,20,22,0,60,19,9,8,3,39,0,1,23,24,0.489796,0.510204,7,11
2022020950,2023-02-26,2,NYR,5,2,LAK,14,12,6,4,36,22,13,13,1,49,12,11,6,4,33,21,12,13,1,47,1,0,21,28,0.439024,0.560976,11,8
2022020951,2023-02-26,2,PIT,7,3,TBL,26,7,15,6,54,24,14,14,2,54,25,7,14,6,52,23,13,14,1,51,1,0,36,29,0.545455,0.454545,6,4
2022020952,2023-02-26,2,ARI,2,6,NSH,22,13,15,1,51,24,5,12,4,45,22,13,15,1,51,22,5,10,4,41,1,0,27,34,0.482143,0.517857,16,10
2022020953,2023-02-26,2,SEA,1,5,TOR,20,12,14,1,47,23,10,10,5,48,20,12,14,1,47,23,10,10,5,48,1,0,27,33,0.285714,0.714286,2,4
2022020954,2023-02-27,2,EDM,2,3,BOS,21,10,12,2,45,17,7,13,3,40,21,10,12,1,44,17,7,13,3,40,1,0,24,28,0.571429,0.428571,10,4
2022020955,2023-02-27,2,DAL,4,5,VAN,21,15,17,2,55,11,8,7,4,30,21,15,17,2,55,11,8,7,3,29,0,1,38,21,0.588235,0.411765,6,10
2022020956,2023-02-27,2,COL,3,0,VGK,29,9,16,3,57,30,6,11,0,47,27,9,16,3,55,30,6,11,0,47,1,0,34,31,0.428571,0.571429,6,6
2022020957,2023-02-27,2,ANA,4,2,CHI,19,8,11,3,41,21,12,8,0,41,19,8,10,3,40,21,11,7,0,39,0,1,33,26,0.535714,0.464286,8,10
2022020958,2023-02-28,2,BUF,3,5,CBJ,31,12,11,2,56,28,13,9,4,54,31,12,11,2,56,28,13,9,4,54,0,1,41,36,0.533333,0.466667,2,6
2022020959,2023-02-28,2,OTT,6,1,DET,13,11,9,3,36,11,8,6,1,26,12,9,9,2,32,9,4,6,1,20,0,1,27,17,0.491803,0.508197,27,33
2022020960,2023-02-28,2,TBL,1,4,FLA,23,16,17,0,56,30,14,13,4,61,23,16,17,0,56,30,14,13,4,61,0,1,29,41,0.538462,0.461538,4,10
2022020961,2023-02-28,2,WPG,5,6,LAK,26,11,21,4,62,24,9,17,5,55,20,11,20,4,55,21,7,15,4,47,1,0,31,37,0.459016,0.540984,10,8
2022020962,2023-02-28,2,MIN,2,1,NYI,29,9,13,2,53,40,11,13,1,65,25,9,11,1,46,33,10,11,1,55,0,1,31,40,0.404762,0.595238,5,7
2022020963,2023-02-28,2,NSH,1,3,PIT,18,8,19,1,46,27,16,18,3,64,18,8,19,1,46,27,16,18,3,64,1,0,25,34,0.363636,0.636364,6,4
2022020964,2023-02-28,2,STL,3,5,SEA,18,6,15,2,41,16,10,17,5,48,18,6,15,1,40,15,10,17,5,47,0,1,25,26,0.423077,0.576923,4,8
2022020965,2023-02-28,2,CGY,3,4,BOS,44,12,20,3,79,11,6,11,3,31,38,12,19,3,72,9,4,11,2,26,0,1,57,20,0.477612,0.522388,13,13
2022020966,2023-02-28,2,ARI,4,1,CHI,27,3,13,4,47,20,13,12,1,46,27,3,13,4,47,20,13,12,1,46,1,0,33,24,0.4375,0.5625,9,7
2022020967,2023-02-28,2,SJS,1,3,MTL,33,12,17,1,63,25,7,7,3,42,32,12,17,1,62,23,7,7,3,40,1,0,39,32,0.515152,0.484848,8,6
2022020968,2023-03-01,2,PHI,2,3,NYR,26,11,7,1,45,19,10,12,2,43,26,11,7,1,45,19,10,12,1,42,0,1,28,25,0.413043,0.586957,2,6
2022020969,2023-03-01,2,EDM,5,2,TOR,24,8,12,4,48,21,7,11,1,40,23,8,12,4,47,21,7,11,1,40,1,0,32,28,0.435484,0.564516,11,13
2022020970,2023-03-01,2,DAL,4,2,ARI,28,10,10,2,50,13,7,9,1,30,28,10,10,2,50,13,7,9,1,30,0,1,41,20,0.641509,0.358491,10,8
2022020971,2023-03-01,2,COL,5,7,NJD,25,9,17,5,56,20,10,15,6,51,25,9,17,5,56,20,10,15,6,51,0,1,31,29,0.5,0.5,4,2
2022020972,2023-03-01,2,VGK,3,2,CAR,17,11,16,3,47,24,18,19,2,63,17,11,16,3,47,24,18,19,2,63,1,0,20,26,0.561404,0.438596,0,2
2022020973,2023-03-01,2,ANA,2,3,WSH,19,15,8,2,44,27,8,6,3,44,19,15,8,2,44,26,8,6,2,42,0,1,23,39,0.542373,0.457627,11,9
2022020974,2023-03-02,2,BOS,7,1,BUF,26,7,5,4,42,21,11,13,1,46,26,7,5,4,42,21,11,13,1,46,1,0,42,27,0.423729,0.576271,8,8
2022020975,2023-03-02,2,FLA,1,2,NSH,30,23,28,1,82,21,8,10,1,40,30,23,28,1,82,21,8,10,1,40,0,1,31,23,0.431373,0.568627,2,0
2022020976,2023-03-02,2,NYR,3,5,OTT,18,10,13,2,43,24,11,5,5,45,18,10,13,2,43,24,11,5,5,45,1,0,32,34,0.490196,0.509804,6,21
2022020977,2023-03-02,2,TBL,4,5,PIT,20,9,7,2,38,17,6,8,5,36,19,9,7,2,37,17,6,7,4,34,1,0,31,32,0.5,0.5,10,10
2022020978,2023-03-02,2,DET,4,5,SEA,20,6,7,4,37,25,10,15,4,54,19,5,7,4,35,24,10,14,4,52,0,1,29,37,0.603175,0.396825,15,11
2022020979,2023-03-02,2,CHI,2,5,DAL,16,7,13,2,38,27,14,15,3,59,16,7,13,2,38,27,14,15,3,59,0,1,21,36,0.481481,0.518519,6,4
2022020980,2023-03-02,2,CGY,1,2,TOR,22,11,17,0,50,26,8,6,2,42,22,11,17,0,50,26,8,6,2,42,1,0,26,34,0.444444,0.555556,4,4
2022020981,2023-03-02,2,VAN,1,2,MIN,15,6,11,0,32,25,13,13,2,53,15,6,11,0,32,25,13,13,2,53,0,1,22,36,0.474576,0.525424,15,11
2022020982,2023-03-02,2,LAK,3,2,MTL,23,12,9,3,47,14,7,9,1,31,23,12,9,3,47,14,7,9,1,31,0,1,33,21,0.508772,0.491228,6,8
2022020983,2023-03-02,2,SJS,3,6,STL,17,13,15,2,47,16,7,8,4,35,17,13,15,2,47,16,7,8,4,35,1,0,25,23,0.589286,0.410714,6,2
2022020984,2023-03-03,2,CBJ,2,4,SEA,15,18,9,1,43,26,15,12,2,55,15,18,9,1,43,26,15,12,2,55,1,0,23,35,0.516129,0.483871,8,8
2022020985,2023-03-03,2,EDM,6,3,WPG,15,12,7,4,38,18,4,5,2,29,15,12,7,4,38,18,4,5,2,29,1,0,33,28,0.508197,0.491803,8,20
2022020986,2023-03-03,2,ARI,1,6,CAR,12,9,8,1,30,27,20,12,3,62,12,9,8,1,30,27,20,12,3,62,0,1,18,42,0.436364,0.563636,8,6
2022020987,2023-03-03,2,ANA,3,2,MTL,26,10,14,1,51,23,8,9,2,42,26,10,14,1,51,23,8,9,2,42,0,1,33,28,0.462963,0.537037,6,6
2022020988,2023-03-03,2,VGK,4,3,NJD,22,12,13,4,51,49,17,26,2,94,19,12,12,3,46,36,15,26,2,79,1,0,27,50,0.459016,0.540984,4,2
2022020989,2023-03-04,2,NYI,4,1,DET,29,14,10,3,56,19,6,11,0,36,29,14,10,3,56,19,6,11,0,36,0,1,36,23,0.682927,0.317073,6,4
2022020990,2023-01-09,2,BUF,0,4,PHI,26,12,7,0,45,27,8,12,4,51,26,12,7,0,45,27,8,12,4,51,0,1,28,38,0.471698,0.528302,8,4
2022020991,2023-03-04,2,BOS,4,2,NYR,13,11,14,3,41,19,6,9,1,35,13,11,14,3,41,19,6,9,1,35,1,0,24,26,0.568966,0.431034,11,11
2022020992,2023-03-04,2,FLA,4,1,PIT,25,10,5,3,43,25,6,9,0,40,25,10,5,3,43,25,6,9,0,40,1,0,42,32,0.4,0.6,32,32
2022020993,2023-03-04,2,SJS,3,8,WSH,27,8,17,2,54,18,8,15,7,48,27,8,17,2,54,18,8,15,7,48,1,0,41,30,0.389831,0.610169,6,8
2022020994,2023-03-04,2,OTT,5,2,CBJ,31,14,14,4,63,16,4,14,1,35,30,14,14,4,62,15,4,14,1,34,1,0,39,21,0.592593,0.407407,6,6
2022020995,2023-03-04,2,WPG,7,5,EDM,27,12,13,6,58,28,7,15,2,52,27,12,13,6,58,28,7,15,2,52,0,1,39,35,0.507463,0.492537,11,11
2022020996,2023-03-04,2,VAN,4,1,TOR,18,9,15,1,43,29,9,14,0,52,18,9,15,1,43,29,9,14,0,52,1,0,24,37,0.46,0.54,13,21
2022020997,2023-03-04,2,DAL,7,3,COL,19,11,15,7,52,24,9,17,2,52,19,11,15,7,52,24,9,17,2,52,1,0,29,35,0.557692,0.442308,8,10
2022020998,2023-03-04,2,CHI,1,3,NSH,20,11,9,1,41,20,8,7,2,37,18,11,7,1,37,19,8,6,2,35,1,0,28,25,0.461538,0.538462,10,8
2022020999,2023-03-04,2,CGY,0,3,MIN,27,10,15,0,52,27,14,14,3,58,27,10,15,0,52,27,14,14,3,58,0,1,31,33,0.390625,0.609375,4,4
2022021000,2023-03-04,2,LAK,4,2,STL,30,8,14,3,55,18,4,15,1,38,30,8,14,3,55,18,4,15,1,38,1,0,38,26,0.510204,0.489796,6,6
2022021001,2023-03-05,2,CAR,6,0,TBL,22,6,7,2,37,11,10,9,0,30,22,6,7,2,37,11,10,9,0,30,1,0,38,14,0.540984,0.459016,16,22
2022021002,2023-03-05,2,PHI,3,1,DET,27,14,19,2,62,21,8,15,1,45,27,14,19,2,62,21,8,15,1,45,0,1,37,26,0.388889,0.611111,6,8
2022021003,2023-03-05,2,VGK,4,3,MTL,22,17,28,4,71,20,8,17,3,48,22,17,28,4,71,20,8,17,3,48,1,0,28,28,0.5,0.5,9,7
2022021004,2023-03-05,2,ARI,4,5,NJD,22,8,12,4,46,35,4,20,4,63,21,8,12,4,45,34,4,20,3,61,0,1,29,40,0.529412,0.470588,2,4
2022021005,2023-03-05,2,COL,2,3,SEA,16,7,8,2,33,22,9,14,3,48,16,7,8,2,33,22,9,14,2,47,1,0,23,35,0.578947,0.421053,10,4
2022021006,2023-03-06,2,BUF,2,3,EDM,32,12,7,1,52,29,14,9,3,55,32,12,7,1,52,29,14,9,3,55,0,1,39,37,0.352941,0.647059,2,4
2022021007,2023-03-06,2,WPG,2,3,SJS,26,11,11,2,50,16,18,15,3,52,22,11,10,2,45,14,18,15,2,49,0,1,38,24,0.316667,0.683333,6,14
2022021008,2023-03-06,2,DAL,4,5,CGY,24,14,8,2,48,24,9,9,5,47,24,14,8,2,48,24,9,9,5,47,0,1,33,37,0.444444,0.555556,4,8
2022021009,2023-03-06,2,CHI,5,0,OTT,12,7,2,5,26,26,16,14,0,56,11,7,2,5,25,24,16,13,0,53,1,0,21,35,0.431373,0.568627,15,47
2022021010,2023-03-06,2,VAN,4,3,NSH,23,8,7,4,42,29,12,18,3,62,17,6,7,3,33,27,11,17,3,58,1,0,29,32,0.571429,0.428571,7,11
2022021011,2023-03-06,2,LAK,4,2,WSH,33,14,9,4,60,15,6,8,1,30,30,12,8,4,54,14,5,8,1,28,0,1,41,22,0.509434,0.490566,10,10
2022021012,2023-03-07,2,MTL,3,4,CAR,25,10,7,5,47,36,20,23,6,85,20,10,6,3,39,26,17,20,3,66,1,0,24,39,0.433333,0.566667,6,10
2022021013,2023-03-07,2,PIT,5,4,CBJ,37,21,27,4,89,18,8,9,3,38,35,21,27,4,87,18,8,9,3,38,0,1,47,27,0.5,0.5,4,4
2022021014,2023-03-07,2,TBL,5,2,PHI,26,8,17,2,53,27,7,11,2,47,25,8,17,2,52,25,7,11,2,45,0,1,39,35,0.625,0.375,6,23
2022021015,2023-03-07,2,NJD,3,4,TOR,26,13,9,2,50,20,9,7,2,38,26,13,9,2,50,20,9,7,2,38,0,1,33,25,0.44,0.56,4,8
2022021016,2023-03-07,2,FLA,2,1,VGK,29,9,24,2,64,17,7,12,0,36,29,9,24,2,64,16,7,11,0,34,1,0,34,23,0.54902,0.45098,10,6
2022021017,2023-03-07,2,NYI,3,2,BUF,32,10,8,3,53,22,3,31,2,58,32,10,8,3,53,22,3,31,2,58,0,1,39,24,0.64,0.36,4,4
2022021018,2023-03-07,2,MIN,0,1,CGY,30,14,7,1,52,22,7,19,2,50,27,12,7,0,46,17,7,17,0,41,0,0,40,26,0.47541,0.52459,8,12
2022021019,2023-03-07,2,COL,6,0,SJS,26,9,12,5,52,10,5,14,0,29,26,9,12,5,52,10,5,14,0,29,1,0,43,13,0.474576,0.525424,6,30
2022021020,2023-03-07,2,ARI,6,2,STL,17,7,10,5,39,31,7,10,2,50,17,7,10,5,39,31,7,10,2,50,0,1,27,42,0.522388,0.477612,12,4
2022021021,2023-03-07,2,SEA,5,2,ANA,21,11,9,4,45,18,8,10,2,38,21,10,8,4,43,18,8,10,2,38,1,0,31,22,0.509091,0.490909,8,6
2022021022,2023-03-08,2,DET,4,3,CHI,32,13,10,3,58,14,4,10,2,30,31,13,10,3,57,14,4,10,2,30,0,1,41,20,0.578125,0.421875,6,6
2022021023,2023-03-08,2,WPG,2,4,MIN,40,9,23,2,74,18,9,2,4,33,40,9,23,2,74,18,9,2,4,33,0,1,48,23,0.604651,0.395349,2,6
2022021024,2023-03-08,2,VAN,3,2,ANA,31,17,12,2,62,19,9,14,2,44,31,17,12,1,61,19,9,14,2,44,0,1,34,22,0.574468,0.425532,4,0
2022021025,2023-03-09,2,BUF,4,10,DAL,23,9,7,4,43,33,9,6,9,57,23,9,7,4,43,33,9,6,9,57,0,1,29,49,0.411765,0.588235,6,4
2022021026,2023-03-09,2,BOS,2,3,EDM,26,9,11,2,48,16,9,9,3,37,26,9,11,2,48,16,9,9,3,37,1,0,28,22,0.469388,0.530612,2,4
2022021027,2023-03-09,2,PIT,3,4,NYI,30,13,8,3,54,15,12,21,3,51,28,12,8,3,51,14,12,20,2,48,0,1,36,28,0.44898,0.55102,10,8
2022021028,2023-03-09,2,MTL,3,4,NYR,20,4,19,2,45,24,7,12,1,44,19,3,19,2,43,20,7,12,1,40,1,0,26,33,0.462963,0.537037,8,6
2022021029,2023-03-09,2,WSH,2,3,NJD,19,10,15,2,46,35,12,11,2,60,14,8,14,2,38,32,10,11,1,54,1,0,22,40,0.453125,0.546875,6,4
2022021030,2023-03-09,2,CAR,1,0,PHI,23,13,18,0,54,17,5,6,0,28,23,13,18,0,54,17,5,6,0,28,1,0,29,19,0.630435,0.369565,4,10
2022021031,2023-03-09,2,TBL,3,4,VGK,32,17,14,2,65,11,7,8,2,28,31,16,13,2,62,8,7,8,1,24,0,1,37,21,0.478261,0.521739,71,75
2022021032,2023-03-09,2,STL,4,2,SJS,21,7,9,3,40,26,9,14,2,51,20,7,9,3,39,22,9,14,2,47,0,1,30,34,0.376812,0.623188,8,8
2022021033,2023-03-09,2,COL,2,5,LAK,27,14,14,1,56,22,2,6,5,35,27,14,14,1,56,22,2,6,5,35,0,1,30,31,0.4,0.6,8,6
2022021034,2023-03-09,2,ARI,4,1,NSH,34,13,12,3,62,29,16,13,1,59,33,13,11,3,60,27,15,13,1,56,1,0,43,40,0.360656,0.639344,17,13
2022021035,2023-03-09,2,SEA,4,5,OTT,26,13,8,3,50,15,13,16,5,49,26,13,8,3,50,14,13,15,5,47,0,1,33,31,0.358209,0.641791,10,4
2022021036,2023-03-10,2,FLA,4,3,CHI,30,8,17,3,58,18,15,3,3,39,27,8,17,2,54,17,14,3,3,37,0,1,43,24,0.433962,0.566038,22,8
2022021037,2023-03-10,2,CGY,1,3,ANA,32,11,20,0,63,15,6,9,3,33,32,11,20,0,63,15,6,9,3,33,1,0,37,18,0.619048,0.380952,0,4
2022021038,2023-03-11,2,BOS,3,2,DET,26,9,13,2,50,23,9,9,0,41,26,9,13,2,50,23,9,9,0,41,0,1,38,31,0.6,0.4,4,8
2022021039,2023-03-11,2,PIT,5,1,PHI,17,3,16,4,40,21,10,10,1,42,17,3,16,4,40,21,10,10,1,42,1,0,32,32,0.490566,0.509434,6,8
2022021040,2023-03-11,2,BUF,1,2,NYR,30,10,21,1,62,17,7,13,1,38,30,10,21,1,62,17,6,13,1,37,1,0,33,26,0.388889,0.611111,6,4
2022021041,2023-03-11,2,COL,3,2,ARI,35,23,20,2,80,14,4,4,2,24,34,22,20,1,77,14,4,4,2,24,1,0,44,20,0.491525,0.508475,2,6
2022021042,2023-03-11,2,TBL,3,1,CHI,32,13,14,3,62,21,11,7,1,40,32,13,14,3,62,21,11,7,1,40,1,0,37,23,0.571429,0.428571,9,7
2022021043,2023-03-11,2,TOR,7,4,EDM,24,7,8,5,44,18,11,9,3,41,22,6,8,5,41,16,10,9,3,38,1,0,38,26,0.535714,0.464286,16,20
2022021044,2023-03-11,2,MTL,1,3,NJD,23,8,20,1,52,34,11,26,3,74,23,8,20,1,52,34,11,26,3,74,0,1,24,37,0.5,0.5,0,0
2022021045,2023-03-11,2,CBJ,2,5,STL,32,13,13,1,59,17,8,14,5,44,32,13,13,1,59,16,8,14,5,43,0,1,39,24,0.650794,0.349206,4,6
2022021046,2023-03-11,2,CAR,0,4,VGK,32,18,19,0,69,19,5,8,4,36,32,18,19,0,69,19,5,8,4,36,0,1,33,24,0.484375,0.515625,2,2
2022021047,2023-03-11,2,FLA,4,5,WPG,34,10,17,1,62,16,5,8,3,32,30,9,17,1,57,15,3,6,2,26,0,1,48,27,0.546875,0.453125,8,12
2022021048,2023-03-11,2,NYI,1,5,WSH,11,16,12,1,40,16,6,5,5,32,10,16,11,1,38,16,6,4,5,31,1,0,18,27,0.583333,0.416667,8,10
2022021049,2023-03-11,2,SEA,3,4,DAL,26,10,12,2,50,18,10,17,4,49,23,9,12,2,46,18,10,17,3,48,0,1,31,25,0.436364,0.563636,2,8
2022021050,2023-03-11,2,VAN,5,2,OTT,17,9,9,3,38,14,12,12,2,40,15,9,9,3,36,14,12,12,2,40,1,0,30,20,0.477612,0.522388,13,21
2022021051,2023-03-11,2,SJS,2,5,MIN,31,11,17,0,59,16,11,7,3,37,30,11,17,0,58,16,11,7,3,37,0,1,37,29,0.492958,0.507042,8,10
2022021052,2023-03-11,2,LAK,1,2,NSH,27,20,19,1,67,24,16,14,1,55,21,18,19,1,59,17,14,12,0,43,1,0,27,30,0.54902,0.45098,6,8
2022021053,2023-03-12,2,DET,5,3,BOS,19,9,7,2,37,25,13,23,3,64,18,9,7,2,36,23,13,22,3,61,1,0,26,33,0.481481,0.518519,12,12
2022021054,2023-03-12,2,PIT,3,2,NYR,27,8,14,1,50,22,8,20,2,52,27,8,14,1,50,22,8,19,2,51,1,0,35,29,0.530303,0.469697,6,10
2022021055,2023-03-12,2,NJD,3,0,CAR,15,10,11,3,39,28,18,15,0,61,14,10,11,2,37,28,17,14,0,59,1,0,23,32,0.372549,0.627451,8,6
2022021056,2023-03-12,2,STL,3,5,VGK,25,12,16,2,55,24,9,8,5,46,25,12,16,2,55,24,9,8,5,46,0,1,33,31,0.530612,0.469388,4,2
2022021057,2023-03-12,2,TBL,2,3,WPG,26,12,12,1,51,17,9,8,2,36,26,12,12,1,51,17,9,8,2,36,1,0,35,22,0.45098,0.54902,4,6
2022021058,2023-03-12,2,ARI,5,4,MIN,18,9,10,4,41,26,7,22,4,59,15,8,9,3,35,25,6,20,4,55,1,0,23,34,0.54386,0.45614,28,24
2022021059,2023-03-12,2,CGY,5,1,OTT,25,16,21,3,65,23,3,10,1,37,25,16,21,3,65,23,3,10,1,37,1,0,39,31,0.492958,0.507042,8,6
2022021060,2023-03-12,2,ANA,4,5,NSH,32,9,8,4,53,30,10,10,4,54,30,9,8,4,51,29,10,10,3,52,0,1,37,36,0.395833,0.604167,7,7
2022021061,2023-03-13,2,TOR,3,4,BUF,22,11,9,3,45,20,11,14,3,48,22,11,9,3,45,20,11,14,3,48,1,0,28,29,0.655738,0.344262,6,2
2022021062,2023-03-13,2,MTL,4,8,COL,15,11,11,3,40,21,7,21,5,54,15,11,11,3,40,21,7,21,5,54,0,1,19,33,0.557692,0.442308,25,13
2022021063,2023-03-13,2,SEA,2,5,DAL,23,12,9,2,46,24,9,12,2,47,23,12,9,2,46,24,9,12,2,47,0,1,28,32,0.407407,0.592593,8,4
2022021064,2023-03-14,2,PIT,4,6,MTL,35,18,19,2,74,16,8,13,6,43,32,17,19,2,70,15,7,13,6,41,1,0,43,22,0.685185,0.314815,6,10
2022021065,2023-03-14,2,NJD,1,4,TBL,19,15,17,1,52,23,8,14,3,48,19,15,17,1,52,23,8,14,3,48,1,0,23,30,0.596154,0.403846,4,4
2022021066,2023-03-14,2,PHI,3,5,VGK,24,16,16,3,59,24,6,8,3,41,24,16,16,3,59,24,6,8,3,41,0,1,30,33,0.5,0.5,8,4
2022021067,2023-03-14,2,NYR,5,3,WSH,22,12,12,4,50,26,10,17,3,56,22,12,11,4,49,26,10,17,3,56,1,0,36,31,0.47541,0.52459,10,6
2022021068,2023-03-14,2,CAR,5,3,WPG,19,12,13,5,49,20,5,10,3,38,19,12,13,5,49,20,5,10,3,38,1,0,25,24,0.531915,0.468085,7,9
2022021069,2023-03-14,2,NSH,2,1,DET,7,4,8,2,21,22,15,17,0,54,7,4,8,2,21,22,13,17,0,52,1,0,16,29,0.581818,0.418182,8,10
2022021070,2023-03-14,2,CHI,6,3,BOS,21,5,8,5,39,35,9,7,3,54,21,5,8,5,39,35,8,7,3,53,1,0,29,42,0.426471,0.573529,4,6
2022021071,2023-03-14,2,EDM,6,3,OTT,21,8,13,5,47,20,3,4,1,28,21,8,13,5,47,20,3,4,1,28,1,0,33,32,0.603175,0.396825,10,6
2022021072,2023-03-14,2,ARI,4,3,CGY,21,13,9,3,46,36,9,14,3,62,20,12,8,2,42,36,9,14,3,62,0,1,25,45,0.428571,0.571429,4,2
2022021073,2023-03-14,2,VAN,5,2,DAL,10,7,9,4,30,19,18,12,1,50,10,7,9,4,30,19,18,12,1,50,1,0,19,27,0.4375,0.5625,8,8
2022021074,2023-03-14,2,SJS,5,6,CBJ,22,14,16,4,56,34,12,14,5,65,20,13,16,4,53,30,12,14,4,60,1,0,32,48,0.522388,0.477612,6,6
2022021075,2023-03-14,2,LAK,5,2,NYI,30,16,12,3,61,24,9,15,2,50,30,16,12,3,61,24,9,15,2,50,0,1,37,28,0.555556,0.444444,8,6
2022021076,2023-03-15,2,WSH,5,4,BUF,31,10,19,4,64,24,14,13,4,55,30,8,18,2,58,19,13,13,4,49,0,1,39,27,0.615385,0.384615,4,6
2022021077,2023-03-15,2,TOR,1,2,COL,15,9,10,1,35,24,13,19,1,57,14,6,9,1,30,19,12,16,0,47,1,0,18,29,0.54386,0.45614,10,6
2022021078,2023-03-15,2,STL,5,8,MIN,29,10,8,2,49,19,7,5,5,36,29,10,7,2,48,18,7,5,4,34,1,0,36,35,0.37931,0.62069,23,14
2022021079,2023-03-15,2,ANA,3,6,NYI,18,6,10,2,36,23,8,17,6,54,18,6,10,2,36,23,8,17,6,54,1,0,23,33,0.456522,0.543478,2,4
2022021080,2023-03-16,2,OTT,4,5,COL,21,9,16,2,48,23,9,13,4,49,19,8,14,2,43,22,9,13,4,48,0,1,36,30,0.537313,0.462687,10,14
2022021081,2023-03-16,2,FLA,9,5,MTL,25,12,10,8,55,21,10,4,4,39,25,12,10,8,55,21,10,4,4,39,0,1,42,30,0.539683,0.460317,2,31
2022021082,2023-03-16,2,NYR,4,2,PIT,29,9,16,4,58,29,14,14,2,59,29,9,16,4,58,29,14,14,2,59,1,0,35,32,0.471698,0.528302,0,4
2022021083,2023-03-16,2,NJD,3,4,TBL,26,14,16,3,59,20,10,18,4,52,20,14,16,2,52,16,9,16,2,43,0,1,35,24,0.596491,0.403509,6,8
2022021084,2023-03-16,2,WPG,0,3,BOS,25,11,17,0,53,18,11,11,3,43,23,10,17,0,50,18,11,11,3,43,0,1,36,24,0.489796,0.510204,6,10
2022021085,2023-03-16,2,NSH,1,2,CHI,31,14,16,1,62,17,15,13,2,47,30,14,16,1,61,17,15,13,2,47,0,1,36,21,0.649123,0.350877,2,4
2022021086,2023-03-16,2,EDM,4,1,DAL,22,12,9,2,45,21,7,13,1,42,19,12,9,2,42,21,7,13,1,42,1,0,30,26,0.425926,0.574074,6,8
2022021087,2023-03-16,2,VGK,2,7,CGY,13,4,16,2,35,21,12,15,6,54,13,4,16,2,35,21,12,15,6,54,0,1,19,30,0.56,0.44,9,13
2022021088,2023-03-16,2,ARI,3,2,VAN,23,14,15,1,53,19,16,5,2,42,22,14,15,1,52,19,16,5,2,42,0,1,27,31,0.596154,0.403846,20,6
2022021089,2023-03-16,2,LAK,4,1,CBJ,30,8,18,4,60,22,7,12,1,42,30,8,18,4,60,22,7,12,1,42,1,0,36,30,0.595745,0.404255,4,6
2022021090,2023-03-16,2,SJS,1,2,SEA,28,7,14,1,50,23,18,14,2,57,27,7,11,0,45,22,16,14,1,53,1,0,32,32,0.574468,0.425532,8,6
2022021091,2023-03-17,2,PHI,5,2,BUF,16,9,12,4,41,23,12,16,0,51,16,9,12,4,41,23,12,16,0,51,1,0,22,38,0.511628,0.488372,22,6
2022021092,2023-03-17,2,TOR,5,2,CAR,18,6,8,4,36,30,22,18,2,72,18,6,8,4,36,30,22,18,2,72,1,0,24,34,0.557692,0.442308,6,2
2022021093,2023-03-17,2,WSH,2,5,STL,25,11,18,1,55,17,5,6,5,33,25,11,18,1,55,17,5,6,5,33,0,1,34,22,0.64,0.36,2,8
2022021094,2023-03-17,2,ANA,7,4,CBJ,23,9,11,7,50,31,11,20,2,64,23,9,11,7,50,31,11,20,2,64,1,0,38,42,0.616667,0.383333,8,4
2022021095,2023-03-18,2,DET,1,5,COL,21,6,11,1,39,16,10,8,3,37,21,6,11,1,39,15,9,8,3,35,0,1,34,23,0.630137,0.369863,8,8
2022021096,2023-03-18,2,MIN,2,5,BOS,22,11,8,1,42,29,11,8,4,52,21,10,7,1,39,29,11,8,4,52,1,0,31,38,0.4,0.6,10,12
2022021097,2023-03-18,2,NSH,2,3,WPG,15,8,11,2,36,25,14,17,3,59,14,8,11,2,35,25,14,17,2,58,1,0,20,34,0.436364,0.563636,23,7
2022021098,2023-03-18,2,SEA,4,6,EDM,28,12,10,4,54,13,9,8,5,35,28,12,10,4,54,13,9,8,5,35,0,1,37,23,0.5,0.5,13,11
2022021099,2023-03-18,2,PHI,4,5,CAR,22,8,3,3,36,26,15,18,4,63,22,8,3,3,36,26,15,18,3,62,0,1,33,34,0.462687,0.537313,2,8
2022021100,2023-03-18,2,FLA,4,2,NJD,27,8,14,3,52,29,10,5,1,45,27,8,14,3,52,29,10,5,1,45,0,1,41,35,0.5,0.5,4,8
2022021101,2023-03-18,2,TBL,5,3,MTL,32,15,20,4,71,16,6,7,2,31,32,15,20,4,71,16,6,7,2,31,0,1,41,21,0.616667,0.383333,4,4
2022021102,2023-03-18,2,OTT,4,5,TOR,50,19,16,5,90,25,6,15,7,53,41,14,15,2,72,18,6,15,3,42,0,1,52,29,0.538462,0.461538,4,6
2022021103,2023-03-18,2,NYR,6,0,PIT,13,5,8,5,31,28,10,15,0,53,13,5,8,5,31,28,10,15,0,53,1,0,24,33,0.509091,0.490909,12,12
2022021104,2023-03-18,2,CGY,5,6,DAL,29,12,13,5,59,17,9,11,6,43,27,9,12,5,53,16,8,11,5,40,0,1,38,26,0.583333,0.416667,6,2
2022021105,2023-03-18,2,LAK,2,3,VAN,36,16,17,2,71,15,12,11,3,41,34,15,17,2,68,12,11,10,1,34,0,1,40,17,0.612245,0.387755,2,4
2022021106,2023-03-18,2,ARI,4,2,CHI,13,8,8,4,33,18,11,12,1,42,13,8,7,4,32,18,11,12,1,42,0,1,21,34,0.377778,0.622222,10,6
2022021107,2023-03-18,2,SJS,1,4,NYI,26,7,16,1,50,21,13,10,2,46,26,7,16,1,50,21,13,10,2,46,1,0,30,33,0.615385,0.384615,12,6
2022021108,2023-03-19,2,BUF,0,7,BOS,20,17,10,0,47,14,8,4,6,32,18,16,10,0,44,12,8,4,6,30,0,1,26,25,0.425532,0.574468,13,15
2022021109,2023-03-19,2,MIN,5,3,WSH,30,10,7,5,52,23,5,9,1,38,28,8,6,5,47,23,5,9,1,38,1,0,40,36,0.433333,0.566667,22,40
2022021110,2023-03-19,2,VGK,7,2,CBJ,32,4,13,5,54,29,6,16,2,53,32,4,13,5,54,29,6,16,2,53,1,0,41,37,0.603175,0.396825,4,4
2022021111,2023-03-19,2,NYR,7,0,NSH,24,7,11,6,48,17,4,18,0,39,24,7,11,5,47,17,4,18,0,39,1,0,34,22,0.333333,0.666667,4,8
2022021112,2023-03-19,2,TBL,2,5,NJD,19,15,13,2,49,32,9,16,5,62,19,15,13,2,49,32,9,16,5,62,1,0,24,39,0.377358,0.622642,2,8
2022021113,2023-03-19,2,STL,3,0,WPG,12,6,7,3,28,29,13,16,0,58,12,6,7,3,28,29,13,16,0,58,1,0,17,34,0.367347,0.632653,35,17
2022021114,2023-03-19,2,ANA,1,2,VAN,10,8,9,1,28,31,10,9,1,51,10,8,9,1,28,31,10,8,1,50,0,1,18,40,0.422222,0.577778,8,6
2022021115,2023-03-20,2,PIT,1,2,OTT,44,14,24,1,83,16,14,12,1,43,44,14,24,1,83,16,14,12,1,43,0,1,49,21,0.575758,0.424242,4,6
2022021116,2023-03-20,2,DET,2,5,FLA,19,14,8,2,43,17,16,11,4,48,18,14,8,2,42,17,16,11,4,48,0,1,22,25,0.452381,0.547619,6,4
2022021117,2023-03-20,2,COL,5,0,CHI,26,11,16,4,57,25,10,13,0,48,26,11,15,4,56,25,10,13,0,48,1,0,32,27,0.54386,0.45614,4,2
2022021118,2023-03-20,2,EDM,5,4,SJS,36,14,14,5,69,26,3,9,4,42,29,13,12,4,58,23,1,8,4,36,0,1,52,32,0.615385,0.384615,4,6
2022021119,2023-03-20,2,LAK,8,2,CGY,24,4,11,6,45,11,10,13,1,35,24,4,11,6,45,11,10,13,1,35,1,0,39,18,0.542373,0.457627,8,20
2022021120,2023-03-21,2,NYR,2,3,CAR,25,6,6,2,39,35,10,12,3,60,25,6,6,2,39,35,10,12,3,60,1,0,31,39,0.507937,0.492063,2,6
2022021121,2023-03-21,2,WSH,6,7,CBJ,30,16,15,6,67,32,7,17,6,62,28,15,15,6,64,32,6,17,5,60,1,0,37,39,0.576271,0.423729,4,4
2022021122,2023-03-21,2,PHI,6,3,FLA,16,8,6,6,36,28,13,17,2,60,16,8,6,6,36,28,13,17,2,60,0,1,24,44,0.508772,0.491228,23,9
2022021123,2023-03-21,2,NJD,1,2,MIN,40,12,16,1,69,25,21,16,2,64,35,11,15,1,62,21,20,15,1,57,0,1,48,29,0.470588,0.529412,2,6
2022021124,2023-03-21,2,BUF,3,7,NSH,24,13,5,2,44,16,9,7,7,39,24,13,5,2,44,16,9,7,7,39,0,1,31,27,0.44,0.56,11,13
2022021125,2023-03-21,2,BOS,2,1,OTT,24,9,13,1,47,31,12,8,1,52,24,9,13,1,47,31,12,8,1,52,0,1,35,41,0.45614,0.54386,6,8
2022021126,2023-03-21,2,MTL,3,2,TBL,15,11,7,3,36,26,8,17,1,52,14,11,7,3,35,23,8,16,1,48,1,0,20,33,0.425532,0.574468,6,6
2022021127,2023-03-21,2,NYI,7,2,TOR,22,6,9,7,44,24,15,19,2,60,22,6,8,6,42,24,15,19,2,60,0,1,29,27,0.596491,0.403509,7,9
2022021128,2023-03-21,2,WPG,2,1,ARI,14,14,11,1,40,25,6,11,1,43,14,14,11,1,40,25,6,11,1,43,1,0,25,30,0.603774,0.396226,11,17
2022021129,2023-03-21,2,STL,2,3,DET,20,10,12,2,44,26,14,11,2,53,15,7,12,2,36,23,11,10,1,45,1,0,22,30,0.46,0.54,6,6
2022021130,2023-03-21,2,DAL,4,5,SEA,18,10,16,3,47,22,18,8,5,53,16,9,16,3,44,20,18,8,4,50,0,1,29,27,0.6,0.4,4,8
2022021131,2023-03-21,2,ANA,1,5,CGY,16,10,7,0,33,31,13,7,3,54,16,10,7,0,33,31,13,7,3,54,0,1,20,43,0.451613,0.548387,10,6
2022021132,2023-03-21,2,VAN,3,4,VGK,30,10,11,1,52,19,6,11,4,40,29,10,11,1,51,19,6,11,4,40,0,1,34,27,0.465517,0.534483,10,4
2022021133,2023-03-22,2,COL,2,5,PIT,26,12,15,1,54,33,14,14,3,64,26,12,15,1,54,33,14,14,3,64,0,1,30,45,0.412698,0.587302,10,8
2022021134,2023-03-22,2,EDM,4,3,ARI,19,10,9,2,40,11,4,8,2,25,19,9,9,1,38,11,4,8,2,25,1,0,31,17,0.603774,0.396226,4,8
2022021135,2023-03-23,2,WSH,6,1,CHI,17,10,9,4,40,19,12,7,1,39,16,10,9,4,39,18,12,7,1,38,1,0,28,28,0.555556,0.444444,10,8
2022021136,2023-03-23,2,PHI,5,4,MIN,32,11,18,4,65,21,14,10,4,49,28,11,16,3,58,18,11,9,4,42,1,0,34,24,0.458333,0.541667,6,2
2022021137,2023-03-23,2,BOS,4,2,MTL,14,6,7,4,31,24,16,8,0,48,12,5,6,4,27,24,16,8,0,48,1,0,21,31,0.518519,0.481481,25,14
2022021138,2023-03-23,2,CAR,1,2,NYR,27,14,14,1,56,10,4,6,2,22,27,14,14,1,56,10,4,6,2,22,1,0,30,16,0.592593,0.407407,6,6
2022021139,2023-03-23,2,OTT,7,2,TBL,23,11,6,5,45,24,6,18,1,49,23,11,6,5,45,24,6,18,1,49,1,0,35,29,0.471698,0.528302,10,18
2022021140,2023-03-23,2,FLA,2,6,TOR,28,7,8,1,44,17,13,12,4,46,28,7,8,1,44,17,13,12,4,46,0,1,35,27,0.54386,0.45614,8,6
2022021141,2023-03-23,2,DET,3,4,STL,22,9,18,3,52,16,5,11,4,36,22,9,18,3,52,16,5,11,4,36,1,0,28,22,0.526316,0.473684,13,7
2022021142,2023-03-23,2,NSH,2,1,SEA,22,18,16,3,59,24,16,13,1,54,16,18,14,1,49,22,14,12,1,49,0,1,24,28,0.555556,0.444444,4,4
2022021143,2023-03-23,2,DAL,3,2,PIT,25,9,14,2,50,35,15,17,2,69,25,9,14,2,50,35,15,17,2,69,1,0,33,42,0.557143,0.442857,4,6
2022021144,2023-03-23,2,CGY,2,3,VGK,38,9,31,1,79,28,13,13,3,57,38,9,31,1,79,28,13,13,3,57,0,1,44,32,0.411765,0.588235,2,4
2022021145,2023-03-23,2,VAN,7,2,SJS,9,7,14,6,36,15,11,5,1,32,9,7,14,6,36,15,11,5,1,32,1,0,21,19,0.5,0.5,4,10
2022021146,2023-03-23,2,ANA,2,3,WPG,16,13,9,1,39,29,20,14,3,66,16,13,9,1,39,29,20,14,3,66,1,0,20,33,0.534483,0.465517,4,4
2022021147,2023-03-24,2,CBJ,5,4,NYI,20,12,12,3,47,33,21,17,3,74,20,12,12,3,47,33,21,17,3,74,0,1,27,38,0.461538,0.538462,2,8
2022021148,2023-03-24,2,BUF,5,4,NJD,19,7,2,4,32,23,12,13,3,51,19,7,2,4,32,23,12,13,3,51,1,0,26,31,0.525424,0.474576,6,8
2022021149,2023-03-24,2,COL,3,1,ARI,21,12,19,1,53,17,10,5,1,33,21,12,19,1,53,17,10,5,1,33,1,0,30,18,0.519231,0.480769,2,6
2022021150,2023-03-25,2,PHI,3,0,DET,14,10,8,3,35,19,5,10,0,34,14,10,8,2,34,18,5,10,0,33,1,0,22,29,0.482143,0.517857,14,6
2022021151,2023-03-25,2,BOS,2,1,TBL,22,4,14,1,41,18,14,8,0,40,22,4,14,1,41,17,13,8,0,38,1,0,34,27,0.66,0.34,17,21
2022021152,2023-03-25,2,NSH,2,7,SEA,13,9,9,2,33,28,8,9,6,51,13,9,9,2,33,28,8,9,6,51,0,1,16,39,0.538462,0.461538,10,8
2022021153,2023-03-25,2,CGY,5,3,SJS,22,21,11,5,59,26,6,14,3,49,22,21,11,5,59,26,6,14,3,49,1,0,30,31,0.47619,0.52381,6,2
2022021154,2023-03-25,2,LAK,4,1,WPG,18,4,10,3,35,15,14,12,0,41,17,4,10,3,34,15,14,11,0,40,1,0,29,26,0.666667,0.333333,15,6
2022021155,2023-03-25,2,MIN,3,1,CHI,17,14,11,3,45,20,15,6,1,42,17,14,10,3,44,19,14,6,1,40,1,0,25,23,0.6,0.4,6,4
2022021156,2023-03-25,2,FLA,3,4,NYR,26,8,23,3,60,34,3,10,4,51,26,8,23,3,60,34,3,10,4,51,1,0,34,42,0.552239,0.447761,8,4
2022021157,2023-03-25,2,NYI,0,2,BUF,22,7,12,0,41,29,8,15,2,54,22,7,12,0,41,29,8,15,2,54,0,1,26,35,0.714286,0.285714,6,4
2022021158,2023-03-25,2,MTL,8,2,CBJ,21,13,14,7,55,13,5,12,2,32,19,13,14,7,53,13,5,12,2,32,0,1,32,23,0.38,0.62,8,6
2022021159,2023-03-25,2,NJD,5,3,OTT,29,15,16,4,64,25,10,16,3,54,28,14,15,4,61,25,10,16,3,54,0,1,35,28,0.573529,0.426471,21,9
2022021160,2023-03-25,2,CAR,5,3,TOR,16,7,10,4,37,29,14,16,3,62,16,7,10,4,37,29,14,16,3,62,1,0,28,44,0.59322,0.40678,6,4
2022021161,2023-03-25,2,DAL,1,3,VAN,19,5,15,1,40,13,10,7,2,32,19,5,15,1,40,13,10,7,2,32,1,0,26,24,0.491228,0.508772,6,8
2022021162,2023-03-25,2,PIT,4,3,WSH,27,8,10,3,48,25,17,14,2,58,26,8,10,3,47,25,17,14,1,57,1,0,40,34,0.423729,0.576271,11,13
2022021163,2023-03-25,2,EDM,3,4,VGK,23,11,21,2,57,30,11,15,3,59,22,11,20,2,55,28,11,13,2,54,0,1,30,34,0.476923,0.523077,6,6
2022021164,2023-03-25,2,ANA,3,6,STL,18,16,13,2,49,28,7,4,6,45,17,15,13,2,47,28,7,4,5,44,1,0,25,36,0.576271,0.423729,8,10
2022021165,2023-03-26,2,ARI,3,4,COL,26,11,17,3,57,26,12,14,3,55,20,9,15,3,47,19,9,12,2,42,0,1,30,32,0.52381,0.47619,6,6
2022021166,2023-03-26,2,CAR,3,4,BOS,31,21,17,3,72,33,6,9,4,52,26,21,15,3,65,27,5,8,2,42,0,1,37,38,0.530303,0.469697,4,6
2022021167,2023-03-26,2,NSH,2,3,TOR,18,5,10,1,34,23,10,10,1,44,18,5,10,1,34,23,10,10,1,44,0,1,25,34,0.388889,0.611111,10,8
2022021168,2023-03-26,2,CHI,2,4,VAN,24,6,9,1,40,22,9,18,3,52,24,6,9,1,40,22,9,18,3,52,1,0,31,31,0.5,0.5,6,6
2022021169,2023-03-26,2,LAK,7,6,STL,24,19,5,2,50,15,6,18,4,43,24,18,5,2,49,15,6,18,4,43,1,0,31,22,0.525424,0.474576,4,20
2022021170,2023-03-27,2,OTT,5,2,FLA,14,5,6,2,27,26,11,13,2,52,14,5,6,2,27,26,11,13,2,52,1,0,27,34,0.55,0.45,8,8
2022021171,2023-03-27,2,BUF,3,4,MTL,27,9,13,3,52,32,9,14,5,60,21,8,12,2,43,26,7,13,3,49,0,1,33,41,0.508475,0.491525,6,8
2022021172,2023-03-27,2,NYI,5,1,NJD,29,13,14,4,60,27,16,17,0,60,29,13,14,4,60,27,16,17,0,60,1,0,36,31,0.584906,0.415094,4,2
2022021173,2023-03-27,2,MIN,5,1,SEA,11,11,6,4,32,31,10,13,1,55,10,11,6,4,31,29,10,11,1,51,1,0,20,36,0.471698,0.528302,18,18
2022021174,2023-03-27,2,ANA,1,5,COL,25,10,9,1,45,32,11,18,4,65,25,10,9,1,45,32,11,18,4,65,1,0,30,44,0.535714,0.464286,6,6
2022021175,2023-03-27,2,ARI,4,5,EDM,25,5,9,3,42,22,15,13,2,52,25,5,9,3,42,22,14,13,2,51,1,0,33,29,0.52459,0.47541,8,8
2022021176,2023-03-28,2,NYR,6,2,CBJ,27,9,11,5,52,21,9,7,1,38,27,9,11,5,52,21,9,7,1,38,1,0,36,30,0.413793,0.586207,8,4
2022021177,2023-03-28,2,PHI,3,2,MTL,22,10,15,3,50,27,7,18,2,54,22,10,15,3,50,27,7,18,2,54,1,0,27,29,0.431034,0.568966,0,4
2022021178,2023-03-28,2,BOS,1,2,NSH,27,16,14,1,58,11,3,8,2,24,27,16,14,1,58,11,3,8,2,24,0,1,36,23,0.508772,0.491228,10,10
2022021179,2023-03-28,2,CAR,0,4,TBL,27,15,5,0,47,14,9,18,4,45,27,15,5,0,47,14,9,18,4,45,0,1,31,21,0.517857,0.482143,4,6
2022021180,2023-03-28,2,DET,7,4,PIT,14,13,12,5,44,23,13,11,2,49,14,13,12,5,44,23,13,11,2,49,1,0,25,39,0.471429,0.528571,12,6
2022021181,2023-03-28,2,STL,6,5,VAN,25,11,9,5,50,30,19,16,3,68,25,11,9,4,49,30,19,16,3,68,0,1,31,37,0.411765,0.588235,11,7
2022021182,2023-03-28,2,CHI,1,4,DAL,15,5,8,1,29,21,9,10,2,42,15,5,8,1,29,21,9,10,2,42,0,1,18,33,0.425926,0.574074,23,7
2022021183,2023-03-28,2,CGY,2,1,LAK,26,18,10,1,55,27,8,11,1,47,26,18,10,1,55,27,8,11,1,47,1,0,32,33,0.433962,0.566038,4,6
2022021184,2023-03-28,2,VGK,4,7,EDM,11,8,6,3,28,32,9,16,4,61,11,8,6,3,28,32,9,16,4,61,1,0,22,39,0.40625,0.59375,6,6
2022021185,2023-03-28,2,SJS,3,0,WPG,24,9,14,2,49,37,17,15,0,69,24,9,14,2,49,37,17,15,0,69,1,0,30,41,0.462963,0.537037,6,6
2022021186,2023-03-29,2,TOR,2,3,FLA,32,10,8,2,52,19,7,10,2,38,29,9,7,2,47,19,6,9,1,35,0,1,40,29,0.653846,0.346154,10,10
2022021187,2023-03-29,2,WSH,1,2,NYI,27,10,15,2,54,28,9,25,3,65,20,9,12,1,42,23,9,25,1,58,0,1,26,29,0.45614,0.54386,4,2
2022021188,2023-03-29,2,COL,2,4,MIN,39,15,14,2,70,17,4,11,2,34,39,15,14,1,69,16,4,11,2,33,0,1,44,29,0.568966,0.431034,6,10
2022021189,2023-03-30,2,BOS,2,1,CBJ,20,12,9,1,42,15,5,12,1,33,20,12,9,0,41,15,5,12,1,33,0,1,31,26,0.461538,0.538462,25,25
2022021190,2023-03-30,2,MTL,2,5,FLA,18,10,19,1,48,24,14,13,4,55,18,10,19,1,48,24,14,13,4,55,1,0,20,30,0.477273,0.522727,4,4
2022021191,2023-03-30,2,NJD,2,1,NYR,25,14,17,1,57,23,12,8,0,43,25,14,17,1,57,23,12,8,0,43,1,0,31,25,0.481481,0.518519,4,4
2022021192,2023-03-30,2,PIT,2,0,NSH,30,20,14,1,65,20,4,12,0,36,30,20,14,1,65,20,4,12,0,36,1,0,45,28,0.508772,0.491228,6,8
2022021193,2023-03-30,2,OTT,5,4,PHI,37,18,10,4,69,7,10,7,2,26,36,18,10,3,67,7,9,7,2,25,1,0,46,11,0.546875,0.453125,41,33
2022021194,2023-03-30,2,TBL,5,1,WSH,28,12,15,3,58,26,5,11,1,43,25,12,15,3,55,25,5,11,1,42,1,0,34,31,0.537037,0.462963,8,4
2022021195,2023-03-30,2,DET,3,2,CAR,15,6,5,2,28,29,23,24,2,78,15,6,5,2,28,29,23,24,2,78,1,0,22,33,0.508197,0.491803,6,6
2022021196,2023-03-30,2,CHI,3,5,STL,27,15,16,1,59,21,8,13,5,47,27,15,16,1,59,21,8,13,5,47,0,1,33,29,0.391304,0.608696,4,6
2022021197,2023-03-30,2,EDM,2,0,LAK,30,7,10,1,48,35,7,12,0,54,30,7,10,1,48,35,7,12,0,54,1,0,37,43,0.439394,0.560606,6,4
2022021198,2023-03-30,2,SEA,4,1,ANA,33,18,15,3,69,15,3,11,1,30,32,18,15,2,67,14,3,10,1,28,1,0,39,19,0.439024,0.560976,6,6
2022021199,2023-03-30,2,SJS,4,3,VGK,20,17,11,4,52,19,12,12,2,45,20,17,10,3,50,19,11,12,2,44,1,0,25,26,0.625,0.375,6,6
2022021200,2023-03-31,2,BUF,3,2,NYR,30,13,14,3,60,27,15,12,2,56,30,12,13,2,57,25,15,12,2,54,1,0,34,33,0.491228,0.508772,2,4
2022021201,2023-03-31,2,WPG,6,2,DET,18,10,18,6,52,22,14,14,1,51,18,10,18,6,52,22,14,14,1,51,1,0,29,25,0.510204,0.489796,2,6
2022021202,2023-03-31,2,VAN,4,5,CGY,14,8,9,3,34,26,15,20,4,65,8,8,9,3,28,23,14,20,3,60,1,0,20,41,0.545455,0.454545,12,4
2022021203,2023-03-31,2,ARI,2,5,DAL,16,11,13,1,41,16,14,10,4,44,16,11,13,1,41,16,14,10,4,44,0,1,18,31,0.365385,0.634615,10,4
2022021204,2023-04-01,2,NSH,6,1,STL,26,14,11,3,54,15,9,11,1,36,26,14,11,3,54,15,9,11,1,36,1,0,35,22,0.75,0.25,10,10
2022021205,2023-04-01,2,PIT,3,4,BOS,14,9,10,3,36,25,11,13,2,51,14,9,10,3,36,25,11,13,2,51,0,1,24,35,0.54386,0.45614,6,12
2022021206,2023-04-01,2,PHI,3,6,BUF,36,17,11,3,67,20,10,7,5,42,36,17,11,3,67,20,10,7,5,42,1,0,42,29,0.603448,0.396552,16,14
2022021207,2023-04-01,2,MTL,0,3,CAR,12,5,6,0,23,44,12,14,2,72,12,5,6,0,23,44,12,14,2,72,0,1,14,50,0.392157,0.607843,4,6
2022021208,2023-04-01,2,CBJ,0,7,FLA,12,8,9,0,29,35,18,17,6,76,12,8,9,0,29,35,18,17,6,76,0,1,21,49,0.428571,0.571429,6,8
2022021209,2023-04-01,2,TBL,5,0,NYI,23,11,10,4,48,34,9,12,0,55,23,10,9,4,46,32,9,12,0,53,1,0,32,38,0.613636,0.386364,18,16
2022021210,2023-04-01,2,OTT,0,3,TOR,26,16,16,0,58,16,6,11,3,36,26,16,16,0,58,16,6,11,3,36,0,1,31,20,0.54717,0.45283,2,4
2022021211,2023-04-01,2,CHI,3,6,NJD,13,6,7,3,29,34,9,21,6,70,13,6,7,3,29,34,9,21,6,70,0,1,17,40,0.45098,0.54902,2,2
2022021212,2023-04-01,2,COL,5,2,DAL,21,5,13,4,43,23,10,9,0,42,21,5,13,4,43,23,10,9,0,42,1,0,32,28,0.557692,0.442308,10,6
2022021213,2023-04-01,2,EDM,6,0,ANA,32,8,7,4,51,32,3,6,0,41,32,8,7,4,51,32,3,6,0,41,1,0,45,36,0.507692,0.492308,8,8
2022021214,2023-04-01,2,SEA,1,3,LAK,22,11,11,0,44,16,16,8,3,43,22,11,11,0,44,16,16,8,3,43,0,1,26,19,0.359375,0.640625,2,4
2022021215,2023-04-01,2,VGK,4,1,MIN,35,11,13,4,63,22,16,20,1,59,34,11,12,3,60,20,16,19,1,56,0,1,43,30,0.44,0.56,6,6
2022021216,2023-04-01,2,ARI,2,7,SJS,28,10,17,1,56,15,4,4,4,27,28,10,17,1,56,15,4,4,4,27,0,1,31,31,0.409091,0.590909,14,4
2022021217,2023-04-02,2,WSH,2,5,NYR,23,16,11,2,52,23,13,8,4,48,22,15,11,2,50,23,13,8,4,48,0,1,28,34,0.410714,0.589286,33,19
2022021218,2023-04-02,2,STL,3,4,BOS,33,10,15,3,61,26,10,11,3,50,30,8,15,3,56,24,9,10,2,45,0,1,38,31,0.5,0.5,8,12
2022021219,2023-04-02,2,CAR,2,1,NYI,27,13,16,2,58,19,10,12,1,42,27,13,16,2,58,19,10,12,1,42,0,1,35,22,0.540984,0.459016,4,4
2022021220,2023-04-02,2,CBJ,4,3,OTT,17,12,9,3,41,19,20,12,3,54,17,12,9,2,40,19,20,12,3,54,1,0,22,27,0.607143,0.392857,4,4
2022021221,2023-04-02,2,PIT,4,2,PHI,23,11,7,3,44,25,11,14,2,52,19,10,6,3,38,23,11,14,2,50,1,0,31,33,0.482143,0.517857,34,12
2022021222,2023-04-02,2,TOR,2,5,DET,37,12,16,0,65,17,13,8,5,43,33,11,16,0,60,16,12,8,5,41,0,1,45,24,0.644068,0.355932,14,8
2022021223,2023-04-02,2,WPG,6,1,NJD,17,9,4,5,35,28,12,19,0,59,17,9,4,4,34,28,12,19,0,59,1,0,27,32,0.54717,0.45283,6,6
2022021224,2023-04-02,2,CGY,5,4,ANA,35,21,16,4,76,16,8,8,4,36,35,21,16,4,76,16,8,8,4,36,0,1,41,22,0.536232,0.463768,2,4
2022021225,2023-04-02,2,VAN,1,4,LAK,20,11,8,1,40,18,10,15,3,46,20,11,8,1,40,18,10,15,2,45,1,0,25,25,0.518519,0.481481,4,8
2022021226,2023-04-03,2,MIN,3,4,VGK,29,11,16,4,60,18,11,20,6,55,22,10,14,2,48,15,10,19,3,47,0,1,33,26,0.446429,0.553571,10,8
2022021227,2023-04-03,2,DAL,5,1,NSH,21,12,10,3,46,20,3,12,1,36,21,12,10,3,46,20,3,12,1,36,1,0,26,27,0.389831,0.610169,6,10
2022021228,2023-04-03,2,SEA,8,1,ARI,12,7,7,5,31,15,7,13,1,36,12,7,7,5,31,15,7,13,1,36,1,0,32,21,0.551724,0.448276,31,49
2022021229,2023-04-04,2,FLA,2,1,BUF,27,12,8,1,48,30,9,13,0,52,27,12,8,1,48,29,9,13,0,51,0,1,36,40,0.5625,0.4375,10,8
2022021230,2023-04-04,2,TOR,4,2,CBJ,34,15,13,4,66,20,7,16,2,45,34,15,13,4,66,20,7,16,2,45,1,0,50,26,0.561404,0.438596,4,6
2022021231,2023-04-04,2,MTL,0,5,DET,20,6,5,0,31,12,8,12,4,36,20,6,5,0,31,11,8,11,4,34,0,1,24,21,0.410256,0.589744,8,8
2022021232,2023-04-04,2,CAR,3,2,OTT,25,12,13,2,52,24,15,11,1,51,24,10,13,1,48,24,15,11,1,51,1,0,37,28,0.59322,0.40678,8,10
2022021233,2023-04-04,2,NJD,5,1,PIT,21,12,12,4,49,17,8,14,1,40,21,12,12,4,49,17,8,14,1,40,1,0,37,23,0.538462,0.461538,8,8
2022021234,2023-04-04,2,STL,4,2,PHI,24,10,13,4,51,28,13,8,2,51,24,10,13,4,51,28,13,8,2,51,1,0,32,34,0.538462,0.461538,6,6
2022021235,2023-04-04,2,NSH,3,2,VGK,22,6,13,1,42,21,17,18,2,58,21,6,13,1,41,21,17,18,2,58,1,0,27,32,0.387755,0.612245,6,8
2022021236,2023-04-04,2,CGY,3,4,CHI,31,17,23,3,74,19,9,9,4,41,31,17,23,3,74,19,9,9,4,41,0,1,36,23,0.472727,0.527273,0,2
2022021237,2023-04-04,2,LAK,1,3,EDM,16,6,7,1,30,26,7,11,1,45,16,6,7,1,30,25,7,10,1,43,0,1,21,33,0.403509,0.596491,10,10
2022021238,2023-04-04,2,VAN,2,5,SEA,11,5,10,2,28,17,7,8,3,35,11,5,10,2,28,17,7,8,3,35,1,0,18,28,0.519231,0.480769,13,15
2022021239,2023-04-04,2,SJS,3,4,COL,26,7,12,2,47,33,8,20,4,65,22,7,12,2,43,32,8,20,3,63,0,1,31,42,0.587302,0.412698,6,2
2022021240,2023-04-05,2,WPG,1,3,CGY,24,14,9,0,47,20,7,5,3,35,24,14,9,0,47,20,7,5,3,35,1,0,35,35,0.537313,0.462687,16,14
2022021241,2023-04-05,2,NYR,6,3,TBL,20,6,9,4,39,27,11,15,2,55,20,6,9,4,39,27,11,15,2,55,1,0,37,31,0.446809,0.553191,28,42
2022021242,2023-04-05,2,ANA,1,3,EDM,24,9,14,1,48,25,11,9,3,48,24,9,14,1,48,25,11,9,3,48,0,1,28,33,0.415094,0.584906,2,2
2022021243,2023-04-06,2,NJD,8,1,CBJ,21,17,11,5,54,12,6,9,1,28,21,17,11,5,54,12,6,9,1,28,1,0,36,17,0.382979,0.617021,24,20
2022021244,2023-04-06,2,PIT,4,1,MIN,22,1,9,3,35,20,13,16,0,49,22,1,9,3,35,20,13,16,0,49,1,0,31,28,0.566667,0.433333,10,8
2022021245,2023-04-06,2,FLA,7,2,OTT,14,3,9,3,29,39,13,14,2,68,14,3,9,3,29,38,13,13,1,65,1,0,30,58,0.448276,0.551724,78,88
2022021246,2023-04-06,2,BOS,2,1,TOR,24,8,11,2,45,27,9,11,1,48,24,7,11,1,43,27,9,11,1,48,0,1,33,32,0.54902,0.45098,21,13
2022021247,2023-04-06,2,MTL,6,2,WSH,19,9,15,4,47,20,8,13,1,42,19,9,15,4,47,20,8,13,1,42,0,1,32,26,0.555556,0.444444,15,21
2022021248,2023-04-06,2,DET,6,7,BUF,24,7,10,5,46,23,12,5,7,47,20,7,10,4,41,19,8,4,5,36,0,1,32,36,0.580645,0.419355,8,8
2022021249,2023-04-06,2,NYI,6,1,TBL,34,13,24,6,77,24,9,10,1,44,34,13,24,5,76,24,9,10,1,44,1,0,42,31,0.609375,0.390625,4,6
2022021250,2023-04-06,2,NSH,3,0,CAR,19,9,3,2,33,33,15,25,0,73,19,9,3,2,33,33,15,25,0,73,1,0,23,33,0.611111,0.388889,4,2
2022021251,2023-04-06,2,STL,3,2,NYR,18,10,12,3,43,22,7,17,0,46,16,10,10,2,38,22,7,17,0,46,1,0,22,24,0.348837,0.651163,4,2
2022021252,2023-04-06,2,DAL,4,1,PHI,23,10,18,2,53,22,11,9,1,43,23,10,18,2,53,22,11,9,1,43,1,0,30,25,0.490566,0.509434,8,8
2022021253,2023-04-06,2,SEA,4,2,ARI,24,5,6,4,39,24,11,9,2,46,24,5,6,4,39,24,11,9,2,46,1,0,33,29,0.439394,0.560606,16,40
2022021254,2023-04-06,2,VAN,3,0,CHI,17,8,7,2,34,25,8,9,0,42,17,8,7,2,34,25,8,9,0,42,1,0,29,33,0.454545,0.545455,8,8
2022021255,2023-04-06,2,VGK,5,2,LAK,25,7,12,4,48,29,13,16,0,58,25,6,12,4,47,28,13,15,0,56,1,0,37,32,0.5,0.5,19,14
2022021256,2023-04-06,2,SJS,2,6,COL,20,18,18,2,58,23,3,13,6,45,20,18,18,2,58,23,3,13,6,45,1,0,23,31,0.517241,0.482759,2,2
2022021257,2023-04-08,2,BUF,4,3,CAR,23,10,5,3,41,29,18,15,3,65,23,10,5,3,41,29,18,15,3,65,1,0,30,34,0.428571,0.571429,4,8
2022021258,2023-04-08,2,MIN,5,3,STL,19,9,13,2,43,33,9,15,3,60,19,9,13,2,43,33,9,15,3,60,0,1,30,40,0.490196,0.509804,4,8
2022021259,2023-04-08,2,SJS,1,6,EDM,22,16,16,1,55,27,12,7,5,51,22,16,16,1,55,27,12,7,5,51,0,1,23,35,0.607843,0.392157,2,4
2022021260,2023-04-08,2,ARI,5,4,ANA,25,12,11,4,52,21,6,11,3,41,23,11,11,3,48,18,6,11,3,38,1,0,39,29,0.515625,0.484375,15,15
2022021261,2023-04-08,2,WSH,2,4,FLA,17,6,10,2,35,19,14,20,3,56,17,6,10,2,35,18,14,20,3,55,1,0,24,37,0.471429,0.528571,10,8
2022021262,2023-04-08,2,TOR,7,1,MTL,35,13,7,3,58,17,7,10,1,35,35,13,7,3,58,17,7,10,1,35,1,0,46,21,0.45098,0.54902,17,21
2022021263,2023-04-08,2,CBJ,0,4,NYR,17,9,13,0,39,20,15,15,4,54,17,9,13,0,39,20,15,15,4,54,0,1,20,28,0.415094,0.584906,4,4
2022021264,2023-04-08,2,WPG,2,0,NSH,30,17,21,2,70,22,6,7,0,35,30,17,21,2,70,22,6,7,0,35,1,0,38,28,0.6,0.4,2,6
2022021265,2023-04-08,2,BOS,2,1,NJD,34,13,15,1,63,25,7,7,1,40,34,13,15,1,63,23,7,7,1,38,1,0,40,30,0.557143,0.442857,10,4
2022021266,2023-04-08,2,DET,1,5,PIT,17,10,12,1,40,20,4,13,4,41,16,10,11,1,38,19,4,12,4,39,0,1,20,28,0.645833,0.354167,8,6
2022021267,2023-04-08,2,OTT,7,4,TBL,23,12,9,6,50,16,4,11,1,32,23,12,9,6,50,16,4,11,1,32,1,0,40,24,0.586207,0.413793,10,18
2022021268,2023-04-08,2,NYI,4,0,PHI,15,14,16,4,49,23,14,14,0,51,15,14,16,4,49,23,14,14,0,51,1,0,21,27,0.659574,0.340426,4,4
2022021269,2023-04-08,2,DAL,2,1,VGK,24,11,15,2,52,20,11,12,1,44,21,9,15,1,46,16,9,9,1,35,0,1,25,20,0.561404,0.438596,4,4
2022021270,2023-04-08,2,VAN,3,2,CGY,27,9,11,2,49,36,11,13,1,61,21,6,11,1,39,29,10,13,1,53,1,0,33,43,0.571429,0.428571,4,6
2022021271,2023-04-08,2,SEA,7,3,CHI,17,6,9,6,38,21,14,15,2,52,17,6,9,6,38,21,13,15,1,50,1,0,31,29,0.419355,0.580645,8,8
2022021272,2023-04-08,2,LAK,3,4,COL,34,10,16,2,62,16,16,13,4,49,34,10,15,2,61,16,16,13,4,49,0,1,41,23,0.557692,0.442308,16,16
2022021273,2023-04-09,2,PHI,3,5,BOS,26,10,8,3,47,22,11,10,5,48,25,10,8,3,46,22,11,10,5,48,0,1,37,34,0.418182,0.581818,7,13
2022021274,2023-04-09,2,ANA,4,5,COL,13,6,11,4,34,32,8,12,2,54,13,6,11,4,34,29,7,11,2,49,0,1,23,46,0.478261,0.521739,26,6
2022021275,2023-04-10,2,NYR,2,3,BUF,26,11,11,2,50,38,7,6,4,55,25,8,11,1,45,29,6,6,2,43,0,1,28,39,0.5625,0.4375,4,4
2022021276,2023-04-10,2,OTT,3,2,CAR,20,6,5,3,34,17,4,13,1,35,17,5,5,2,29,17,4,11,0,32,1,0,32,29,0.539683,0.460317,12,14
2022021277,2023-04-10,2,WSH,5,2,NYI,19,11,13,5,48,37,24,22,2,85,18,11,13,5,47,36,24,22,2,84,1,0,25,40,0.385714,0.614286,8,2
2022021278,2023-04-10,2,WPG,6,2,SJS,27,22,12,4,65,12,9,8,1,30,27,22,12,4,65,12,9,8,1,30,0,1,33,21,0.518519,0.481481,8,4
2022021279,2023-04-10,2,FLA,1,2,TOR,41,14,22,1,78,23,12,10,2,47,37,11,20,1,69,21,12,10,1,44,0,1,46,25,0.479167,0.520833,2,4
2022021280,2023-04-10,2,DET,1,6,DAL,17,8,11,1,37,15,10,11,5,41,17,8,11,1,37,15,10,11,5,41,0,1,20,22,0.326087,0.673913,8,6
2022021281,2023-04-10,2,CHI,2,4,MIN,37,9,31,2,79,15,7,12,3,37,37,9,30,2,78,15,7,12,3,37,0,1,42,22,0.644068,0.355932,9,21
2022021282,2023-04-10,2,CGY,2,3,NSH,33,8,23,3,67,19,11,2,4,36,27,7,21,2,57,15,9,1,2,27,0,1,44,29,0.518519,0.481481,12,8
2022021283,2023-04-10,2,ARI,1,4,SEA,19,5,5,1,30,22,9,11,2,44,19,5,5,1,30,22,9,11,2,44,1,0,23,37,0.541667,0.458333,15,15
2022021284,2023-04-10,2,LAK,3,0,VAN,24,8,15,3,50,14,2,14,0,30,24,8,15,3,50,14,2,14,0,30,1,0,28,20,0.581395,0.418605,14,12
2022021285,2023-04-11,2,NJD,6,2,BUF,22,9,9,6,46,30,15,19,2,66,22,9,9,6,46,30,15,19,2,66,1,0,30,38,0.509091,0.490909,4,4
2022021286,2023-04-11,2,PIT,2,5,CHI,27,11,19,1,58,18,7,5,5,35,27,11,19,1,58,18,7,5,5,35,0,1,40,27,0.606557,0.393443,4,10
2022021287,2023-04-11,2,PHI,4,3,CBJ,31,10,14,3,58,25,8,12,2,47,29,8,13,2,52,21,6,12,2,41,0,1,39,31,0.472727,0.527273,8,10
2022021288,2023-04-11,2,CAR,4,1,DET,20,13,10,4,47,19,5,5,1,30,20,13,10,4,47,19,5,5,1,30,1,0,28,21,0.45283,0.54717,4,2
2022021289,2023-04-11,2,TBL,3,4,TOR,27,11,12,3,53,16,8,6,2,32,23,10,11,3,47,15,7,6,2,30,0,1,48,24,0.532258,0.467742,24,28
2022021290,2023-04-11,2,BOS,5,2,WSH,36,15,17,3,71,23,11,9,1,44,36,15,17,3,71,23,11,9,1,44,1,0,44,27,0.695652,0.304348,4,4
2022021291,2023-04-11,2,MIN,1,3,WPG,20,11,17,0,48,13,6,11,3,33,19,11,17,0,47,13,6,11,3,33,0,1,34,20,0.5,0.5,27,24
2022021292,2023-04-11,2,COL,1,2,EDM,20,8,11,1,40,31,9,12,1,53,20,7,11,1,39,30,9,12,1,52,1,0,29,40,0.5,0.5,8,6
2022021293,2023-04-11,2,VGK,4,1,SEA,30,7,15,3,55,20,18,15,1,54,30,7,15,3,55,20,18,15,1,54,1,0,37,21,0.541667,0.458333,4,6
2022021294,2023-04-11,2,ANA,2,3,VAN,21,7,8,1,37,28,11,13,1,53,21,7,8,1,37,28,11,13,1,53,0,1,35,36,0.553571,0.446429,8,10
2022021295,2023-04-12,2,NYI,4,2,MTL,27,14,19,3,63,17,10,19,1,47,25,14,19,3,61,17,10,19,1,47,1,0,35,19,0.678571,0.321429,4,8
2022021296,2023-04-12,2,STL,2,5,DAL,13,5,10,1,29,22,4,18,2,46,13,5,9,1,28,22,4,18,2,46,0,1,18,37,0.444444,0.555556,12,6
2022021297,2023-04-12,2,CGY,3,1,SJS,42,12,23,3,80,19,10,15,1,45,42,12,23,3,80,19,10,15,1,45,0,1,49,24,0.485714,0.514286,4,2
2022021298,2023-04-13,2,MTL,4,5,BOS,26,14,11,3,54,14,12,16,5,47,26,14,11,2,53,13,12,15,5,45,1,0,34,21,0.454545,0.545455,19,13
2022021299,2023-04-13,2,FLA,4,6,CAR,26,11,15,4,56,25,24,15,6,70,26,11,15,4,56,24,24,15,6,69,0,1,34,36,0.606557,0.393443,20,6
2022021300,2023-04-13,2,TBL,5,0,DET,23,12,15,4,54,32,6,11,0,49,23,12,14,4,53,32,5,10,0,47,1,0,32,32,0.641509,0.358491,6,6
2022021301,2023-04-13,2,WSH,4,5,NJD,26,12,5,4,47,28,24,19,4,75,22,9,5,4,40,25,23,19,3,70,1,0,31,34,0.47619,0.52381,11,11
2022021302,2023-04-13,2,BUF,4,3,OTT,25,15,10,3,53,26,9,11,2,48,25,14,10,2,51,26,9,11,2,48,1,0,36,33,0.375,0.625,6,8
2022021303,2023-04-13,2,CBJ,3,2,PIT,28,16,10,2,56,33,9,9,0,51,28,16,10,1,55,33,9,8,0,50,0,1,34,36,0.5,0.5,4,8
2022021304,2023-04-13,2,NYR,2,3,TOR,20,14,10,1,45,18,13,15,3,49,20,14,10,1,45,18,13,15,3,49,1,0,24,21,0.413043,0.586957,2,4
2022021305,2023-04-13,2,NSH,4,3,MIN,24,10,20,3,57,20,12,7,3,42,23,10,20,2,55,19,12,7,3,41,1,0,31,24,0.459459,0.540541,2,6
2022021306,2023-04-13,2,CHI,4,5,PHI,34,14,24,3,75,31,10,8,4,53,32,14,22,3,71,30,10,8,3,51,0,1,38,36,0.583333,0.416667,2,2
2022021307,2023-04-13,2,DAL,1,0,STL,28,14,17,1,60,25,7,5,0,37,28,14,17,1,60,25,7,5,0,37,1,0,34,25,0.673469,0.326531,4,4
2022021308,2023-04-13,2,EDM,5,2,SJS,20,8,14,3,45,20,6,9,1,36,20,8,14,3,45,20,6,9,1,36,1,0,36,29,0.545455,0.454545,8,6
2022021309,2023-04-13,2,COL,4,2,WPG,19,6,9,3,37,13,9,12,1,35,18,6,9,3,36,13,9,12,1,35,1,0,25,20,0.560606,0.439394,6,6
2022021310,2023-04-13,2,ANA,3,5,LAK,15,4,9,3,31,19,11,16,3,49,14,4,9,3,30,19,11,16,3,49,1,0,24,36,0.388889,0.611111,50,8
2022021311,2023-04-13,2,ARI,4,5,VAN,19,15,9,4,47,13,8,10,3,34,17,15,9,4,45,10,8,9,1,28,0,1,28,24,0.468085,0.531915,15,13
2022021312,2023-04-13,2,SEA,1,3,VGK,24,20,20,1,65,15,7,14,2,38,24,20,20,1,65,15,6,12,2,35,0,1,31,19,0.460317,0.539683,8,12
2022030111,2023-04-17,3,BOS,3,1,FLA,21,13,14,2,50,29,15,20,1,65,21,13,14,2,50,29,15,20,1,65,1,0,29,32,0.522388,0.477612,4,4
2022030112,2023-04-19,3,BOS,3,6,FLA,26,13,10,1,50,18,11,9,6,44,24,13,8,1,46,17,7,9,5,38,0,1,37,30,0.460526,0.539474,60,32
2022030113,2023-04-21,3,FLA,2,4,BOS,22,11,17,1,51,25,11,13,4,53,22,11,17,1,51,25,11,13,4,53,0,1,31,35,0.612245,0.387755,18,14
2022030114,2023-04-23,3,FLA,2,6,BOS,31,6,21,1,59,18,8,13,4,43,31,6,21,1,59,17,8,12,4,41,0,1,44,31,0.365079,0.634921,35,35
2022030115,2023-04-26,3,BOS,3,4,FLA,37,22,16,1,76,20,5,14,3,42,37,22,16,1,76,20,5,14,3,42,0,1,47,25,0.623377,0.376623,4,10
2022030116,2023-04-28,3,FLA,7,5,BOS,24,9,17,5,55,21,12,16,1,50,24,9,16,5,54,21,12,16,1,50,1,0,33,34,0.472727,0.527273,12,14
2022030117,2023-04-30,3,BOS,3,4,FLA,28,12,9,1,50,21,10,14,3,48,28,12,9,1,50,21,10,14,3,48,0,1,36,31,0.567568,0.432432,8,10
2022030121,2023-04-18,3,TOR,3,7,TBL,22,10,17,1,50,18,5,8,3,34,22,10,17,1,50,18,5,8,3,34,0,1,31,34,0.555556,0.444444,15,8
2022030122,2023-04-20,3,TOR,7,2,TBL,25,6,14,5,50,18,9,14,2,43,25,6,14,5,50,18,9,14,2,43,1,0,37,22,0.5,0.5,23,49
2022030123,2023-04-22,3,TBL,3,4,TOR,31,24,24,3,82,20,8,14,4,46,30,24,24,3,81,19,8,14,4,45,0,1,39,27,0.483871,0.516129,18,18
2022030124,2023-04-24,3,TBL,4,5,TOR,22,14,22,3,61,25,6,23,3,57,22,13,21,3,59,25,6,23,3,57,1,0,31,37,0.5,0.5,10,8
2022030125,2023-04-27,3,TOR,2,4,TBL,23,12,11,2,48,24,11,18,4,57,23,12,11,2,48,24,11,18,4,57,1,0,30,38,0.576271,0.423729,4,4
2022030126,2023-04-29,3,TBL,1,2,TOR,25,16,28,1,70,18,15,16,2,51,25,16,28,1,70,18,15,16,2,51,0,1,32,22,0.578947,0.421053,4,4
2022030131,2023-04-17,3,CAR,2,1,NYI,31,17,14,0,62,20,14,14,1,49,31,17,14,0,62,20,14,14,1,49,1,0,37,26,0.513889,0.486111,8,8
2022030132,2023-04-19,3,CAR,4,3,NYI,25,16,12,3,56,22,14,17,3,56,24,14,12,3,53,22,14,16,3,55,1,0,36,26,0.464286,0.535714,2,12
2022030133,2023-04-21,3,NYI,5,1,CAR,23,11,10,4,48,26,5,14,0,45,23,11,10,4,48,26,5,14,0,45,1,0,37,31,0.492063,0.507937,38,40
2022030134,2023-04-23,3,NYI,2,5,CAR,24,6,21,1,52,22,8,13,3,46,24,6,21,1,52,22,8,13,3,46,0,1,29,29,0.533333,0.466667,24,10
2022030135,2023-04-25,3,CAR,2,3,NYI,27,16,21,2,66,17,13,4,3,37,26,16,21,2,65,15,13,4,2,34,0,1,36,22,0.529412,0.470588,6,8
2022030136,2023-04-28,3,NYI,1,2,CAR,28,13,24,1,66,36,14,21,2,73,28,13,24,1,66,36,14,21,2,73,1,0,34,41,0.567164,0.432836,4,6
2022030141,2023-04-18,3,NJD,1,5,NYR,27,11,20,1,59,13,8,8,3,32,27,11,20,0,58,13,8,8,3,32,0,1,28,23,0.522388,0.477612,6,8
2022030142,2023-04-20,3,NJD,1,5,NYR,20,18,14,0,52,16,12,6,3,37,17,14,14,0,45,16,10,6,3,35,1,0,24,30,0.559322,0.440678,71,65
2022030143,2023-04-22,3,NYR,1,2,NJD,29,8,13,1,51,23,11,19,1,54,29,8,13,1,51,23,11,19,1,54,1,0,36,28,0.596774,0.403226,8,12
2022030144,2023-04-24,3,NYR,1,3,NJD,18,12,12,1,43,18,11,16,3,48,18,11,12,1,42,18,11,15,3,47,0,1,23,23,0.408163,0.591837,4,6
2022030145,2023-04-27,3,NJD,4,0,NYR,28,4,10,2,44,18,9,20,0,47,27,4,10,1,42,18,9,19,0,46,1,0,43,23,0.5,0.5,13,29
2022030146,2023-04-29,3,NYR,5,2,NJD,19,5,9,4,37,27,9,19,1,56,19,5,9,4,37,27,9,19,1,56,0,1,29,36,0.466667,0.533333,16,18
2022030147,2023-05-01,3,NJD,4,0,NYR,17,14,20,3,54,28,12,16,0,56,16,14,20,3,53,27,12,16,0,55,1,0,24,31,0.509804,0.490196,8,6
2022030151,2023-04-18,3,COL,1,3,SEA,28,12,22,1,63,24,12,19,3,58,28,12,22,1,63,24,12,19,3,58,0,1,35,30,0.563636,0.436364,6,4
2022030152,2023-04-20,3,COL,3,2,SEA,33,13,8,3,57,26,7,17,1,51,30,12,8,3,53,24,6,17,1,48,0,1,41,29,0.551724,0.448276,8,8
2022030153,2023-04-22,3,SEA,4,6,COL,23,12,8,3,46,25,12,13,5,55,21,12,8,3,44,25,12,13,4,54,1,0,29,34,0.423729,0.576271,6,12
2022030154,2023-04-24,3,SEA,3,2,COL,31,9,15,1,56,15,10,21,1,47,31,9,14,1,55,15,10,20,1,46,1,0,43,22,0.560606,0.439394,8,12
2022030155,2023-04-26,3,COL,2,3,SEA,21,11,13,2,47,25,12,20,3,60,21,11,13,2,47,25,12,20,3,60,0,1,28,29,0.596491,0.403509,4,4
2022030156,2023-04-28,3,SEA,1,4,COL,17,11,11,1,40,23,9,12,4,48,17,11,11,1,40,22,9,11,4,46,1,0,23,39,0.442308,0.557692,12,8
2022030157,2023-04-30,3,COL,1,2,SEA,32,16,28,0,76,25,13,11,2,51,32,16,28,0,76,25,13,11,2,51,0,1,34,27,0.581818,0.418182,0,2
2022030161,2023-04-17,3,DAL,2,3,MIN,42,25,28,0,95,38,12,20,2,72,37,25,26,0,88,36,12,18,2,68,0,1,53,48,0.564815,0.435185,22,14
2022030162,2023-04-19,3,DAL,7,3,MIN,18,8,15,3,44,13,9,13,2,37,18,8,15,3,44,13,9,13,2,37,1,0,31,26,0.5625,0.4375,40,52
2022030163,2023-04-21,3,MIN,5,1,DAL,15,8,10,4,37,21,12,21,1,55,14,7,10,4,35,19,9,20,1,49,1,0,25,24,0.372881,0.627119,8,12
2022030164,2023-04-23,3,MIN,2,3,DAL,29,11,15,1,56,16,15,14,1,46,29,11,15,1,56,16,15,14,1,46,0,1,34,24,0.490196,0.509804,16,8
2022030165,2023-04-25,3,DAL,4,0,MIN,12,7,9,2,30,20,16,11,0,47,7,7,9,2,25,15,14,11,0,40,1,0,25,27,0.566038,0.433962,14,27
2022030166,2023-04-28,3,MIN,1,4,DAL,19,19,18,1,57,25,9,12,4,50,19,19,18,1,57,25,9,12,4,50,0,1,24,33,0.462963,0.537037,4,4
2022030171,2023-04-18,3,VGK,1,5,WPG,14,10,15,1,40,21,12,11,4,48,14,10,15,1,40,21,12,11,4,48,0,1,17,31,0.537037,0.462963,16,16
2022030172,2023-04-20,3,VGK,5,2,WPG,28,7,14,5,54,27,11,10,1,49,27,7,14,5,53,25,11,10,1,47,0,1,39,33,0.52381,0.47619,10,12
2022030173,2023-04-22,3,WPG,4,5,VGK,22,16,24,3,65,37,11,24,3,75,22,16,24,3,65,37,11,23,3,74,0,1,34,48,0.493827,0.506173,19,17
2022030174,2023-04-24,3,WPG,2,4,VGK,22,16,23,0,61,22,7,13,4,46,22,15,23,0,60,20,7,13,4,44,1,0,26,30,0.571429,0.428571,6,6
2022030175,2023-04-27,3,VGK,4,1,WPG,19,7,16,3,45,29,13,19,1,62,18,7,16,3,44,28,12,19,1,60,1,0,25,30,0.545455,0.454545,4,8
2022030181,2023-04-17,3,EDM,3,4,LAK,34,17,16,2,69,22,10,13,2,47,34,16,16,2,68,20,10,11,1,42,1,0,40,35,0.575342,0.424658,14,8
2022030182,2023-04-19,3,EDM,4,2,LAK,28,7,18,3,56,19,11,19,2,51,28,7,18,3,56,19,11,19,2,51,1,0,37,24,0.561404,0.438596,8,2
2022030183,2023-04-21,3,LAK,3,2,EDM,24,6,13,1,44,33,12,19,0,64,21,4,11,1,37,32,12,19,0,63,1,0,31,40,0.47619,0.52381,12,14
2022030184,2023-04-23,3,LAK,4,5,EDM,34,10,21,3,68,34,18,14,3,69,34,10,21,3,68,34,18,14,3,69,1,0,39,42,0.522388,0.477612,6,4
2022030185,2023-04-25,3,EDM,6,3,LAK,18,7,6,4,35,23,8,16,3,50,18,7,6,4,35,23,8,16,3,50,1,0,27,28,0.555556,0.444444,12,16
2022030186,2023-04-29,3,LAK,4,5,EDM,34,5,18,1,58,20,11,11,4,46,33,5,18,1,57,20,11,11,4,46,0,1,44,26,0.431034,0.568966,4,6
2022030211,2023-05-02,3,TOR,2,4,FLA,25,15,5,2,47,21,14,13,4,52,25,15,5,2,47,21,14,13,4,52,0,1,36,28,0.509434,0.490566,2,10
2022030212,2023-05-04,3,TOR,2,3,FLA,28,17,13,1,59,24,11,6,3,44,28,17,13,1,59,24,11,6,3,44,1,0,37,29,0.685185,0.314815,2,6
2022030213,2023-05-07,3,FLA,3,2,TOR,23,17,22,2,64,22,16,15,2,55,23,17,22,2,64,22,16,15,2,55,0,1,29,24,0.389831,0.610169,0,4
2022030214,2023-05-10,3,FLA,1,2,TOR,19,9,18,0,46,18,10,9,1,38,19,9,18,0,46,18,10,9,1,38,0,1,25,25,0.377778,0.622222,26,16
2022030215,2023-05-12,3,TOR,2,3,FLA,45,12,18,2,77,32,9,21,2,64,45,12,18,2,77,32,9,21,2,64,0,1,52,43,0.617647,0.382353,4,4
2022030221,2023-05-03,3,CAR,5,1,NJD,13,14,12,5,44,16,11,15,1,43,13,14,12,5,44,16,11,15,1,43,1,0,23,18,0.482143,0.517857,4,6
2022030222,2023-05-05,3,CAR,6,1,NJD,26,9,16,5,56,20,12,11,1,44,26,8,16,4,54,19,12,10,1,42,1,0,35,29,0.508197,0.491803,8,6
2022030223,2023-05-07,3,NJD,8,4,CAR,25,13,15,6,59,22,13,11,1,47,25,13,15,6,59,22,13,11,1,47,1,0,34,30,0.563636,0.436364,11,15
2022030224,2023-05-09,3,NJD,1,6,CAR,19,7,8,1,35,18,10,15,6,49,19,7,8,1,35,18,10,15,6,49,1,0,22,29,0.589286,0.410714,6,4
2022030225,2023-05-11,3,CAR,3,2,NJD,33,24,19,2,78,26,16,9,1,52,33,24,19,2,78,26,16,9,1,52,0,1,39,29,0.4,0.6,2,4
2022030231,2023-05-02,3,DAL,4,5,SEA,25,17,18,4,64,33,15,18,5,71,25,17,18,4,64,33,15,18,5,71,1,0,35,44,0.58209,0.41791,6,4
2022030232,2023-05-04,3,DAL,4,2,SEA,26,14,9,3,52,23,14,10,2,49,25,14,8,3,50,22,14,9,2,47,1,0,37,27,0.6875,0.3125,6,10
2022030233,2023-05-07,3,SEA,7,2,DAL,15,13,12,5,45,18,13,18,2,51,15,13,12,5,45,18,13,18,2,51,1,0,25,26,0.432836,0.567164,36,54
2022030234,2023-05-09,3,SEA,3,6,DAL,14,19,15,3,51,14,9,15,4,42,13,19,13,3,48,14,9,13,4,40,0,1,19,25,0.461538,0.538462,14,12
2022030235,2023-05-11,3,DAL,5,2,SEA,15,7,13,5,40,27,6,14,2,49,13,7,13,5,38,26,6,14,2,48,1,0,21,31,0.596491,0.403509,4,4
2022030236,2023-05-13,3,SEA,6,3,DAL,14,9,14,5,42,16,19,19,2,56,14,9,14,5,42,16,19,19,2,56,1,0,29,23,0.478261,0.521739,18,18
2022030237,2023-05-15,3,DAL,2,1,SEA,24,19,14,2,59,22,14,12,1,49,24,19,14,2,59,22,14,12,1,49,1,0,28,23,0.54,0.46,2,2
2022030241,2023-05-03,3,VGK,6,4,EDM,23,9,9,4,45,19,14,20,2,55,23,9,9,4,45,19,14,20,2,55,0,1,34,27,0.483871,0.516129,8,10
2022030242,2023-05-06,3,VGK,1,5,EDM,24,7,11,1,43,16,7,11,1,35,22,6,11,1,40,15,6,11,1,33,0,1,31,36,0.523077,0.476923,70,54
2022030243,2023-05-08,3,EDM,1,5,VGK,25,6,15,1,47,25,7,8,5,45,25,6,15,1,47,23,7,8,4,42,1,0,28,33,0.516129,0.483871,10,6
2022030244,2023-05-10,3,EDM,4,1,VGK,22,7,8,3,40,14,4,11,1,30,21,7,8,3,39,14,4,11,1,30,1,0,33,26,0.5,0.5,47,64
2022030245,2023-05-12,3,VGK,4,3,EDM,15,5,10,2,32,17,8,8,0,33,14,5,10,2,31,17,7,7,0,31,0,1,31,35,0.566667,0.433333,21,14
2022030246,2023-05-14,3,EDM,2,5,VGK,33,13,28,2,76,15,5,14,5,39,32,13,28,2,75,15,5,14,4,38,0,1,40,22,0.5,0.5,4,4
2022030311,2023-05-18,3,CAR,2,3,FLA,55,33,33,0,121,55,26,37,3,121,55,33,33,0,121,55,26,37,3,121,1,0,65,60,0.545455,0.454545,6,12
2022030312,2023-05-20,3,CAR,1,2,FLA,27,13,12,1,53,22,8,14,1,45,27,13,12,1,53,22,8,14,1,45,1,0,38,26,0.5625,0.4375,8,8
2022030313,2023-05-22,3,FLA,1,0,CAR,10,6,10,0,26,32,11,23,0,66,9,6,10,0,25,32,11,22,0,65,1,0,17,32,0.418182,0.581818,6,10
2022030314,2023-05-24,3,FLA,4,3,CAR,17,10,9,2,38,26,8,20,3,57,17,10,9,2,38,26,8,20,3,57,1,0,24,39,0.507463,0.492537,10,10
2022030321,2023-05-19,3,VGK,4,3,DAL,30,10,18,4,62,27,8,17,3,55,30,10,18,4,62,27,8,17,3,55,0,1,37,36,0.57377,0.42623,4,2
2022030322,2023-05-21,3,VGK,3,2,DAL,21,17,10,2,50,24,13,10,1,48,21,17,10,2,50,24,13,10,1,48,0,1,24,28,0.45,0.55,6,4
2022030323,2023-05-23,3,DAL,0,4,VGK,29,9,14,0,52,7,2,11,3,23,29,9,14,0,52,7,2,11,3,23,0,1,34,16,0.607843,0.392157,35,6
2022030324,2023-05-25,3,DAL,3,2,VGK,37,13,15,1,66,37,7,16,2,62,37,13,15,1,66,37,7,16,2,62,0,1,42,39,0.538462,0.461538,2,4
2022030325,2023-05-27,3,VGK,2,4,DAL,23,11,14,2,50,30,12,23,4,69,23,11,14,2,50,30,12,23,4,69,1,0,29,34,0.462963,0.537037,0,2
2022030326,2023-05-29,3,DAL,0,6,VGK,18,6,21,0,45,22,11,10,5,48,18,6,21,0,45,22,11,10,5,48,0,1,23,29,0.456522,0.543478,6,4
2022030411,2023-06-03,3,VGK,5,2,FLA,20,14,10,3,47,27,11,11,1,50,20,14,10,3,47,27,11,11,1,50,0,1,34,35,0.527027,0.472973,18,46
2022030412,2023-06-05,3,VGK,7,2,FLA,16,11,11,5,43,17,22,17,2,58,14,11,11,5,41,17,22,16,2,57,1,0,28,31,0.515152,0.484848,64,84
2022030413,2023-06-08,3,FLA,3,2,VGK,15,15,21,3,54,20,8,12,0,40,15,14,21,3,53,19,7,11,0,37,1,0,23,27,0.476923,0.523077,16,14
2022030414,2023-06-10,3,FLA,2,3,VGK,28,17,29,2,76,28,14,14,3,59,28,17,29,2,76,28,14,14,3,59,0,1,31,31,0.537313,0.462687,28,4
2022030415,2023-06-13,3,VGK,9,3,FLA,21,19,11,8,59,31,14,26,3,74,21,19,11,8,59,31,14,26,3,74,1,0,32,35,0.552239,0.447761,2,2
