gameId,gameDate,gameType,Team Home,Score Home,Score Away,Team Away,Shot Home EV,Miss Home EV,Block Home EV,Goal Home EV,CF EV,Shot Away EV,Miss Away EV,Block Away EV,Goal Away EV,CA EV,Shot Home 5v5,Miss Home 5v5,Block Home 5v5,Goal Home 5V5,CF 5v5,Shot Away 5v5,Miss Away 5v5,Block Away 5v5,Goal Away 5v5,CA 5v5,First Goal Home,First Goal Away,SOG Home,SOG Away,Faceoff Home,Faceoff Away,Pim Home,Pim Away
2020020001,2021-01-13,2,PHI,6,3,PIT,17,8,7,4,36,28,7,11,2,48,18,8,8,4,38,28,7,11,2,48,0,1,27,34,0.58,0.42,6,6
2020020002,2021-01-13,2,T.B,5,1,CHI,19,5,7,3,34,19,4,11,0,34,19,5,7,3,34,19,4,10,0,33,1,0,33,23,0.508772,0.491228,6,8
2020020003,2021-01-13,2,TOR,5,4,MTL,21,15,19,3,58,22,12,14,2,50,18,13,19,2,52,20,11,14,2,47,0,1,34,32,0.539683,0.460317,11,13
2020020004,2021-01-13,2,EDM,3,5,VAN,22,4,9,3,38,26,7,16,5,54,22,4,9,3,38,26,7,15,5,53,0,1,31,35,0.517857,0.482143,4,8
2020020005,2021-01-13,2,COL,1,4,STL,21,5,18,0,44,23,6,11,4,44,21,5,18,0,44,23,5,11,4,43,1,0,27,32,0.54386,0.45614,4,8
2020020006,2021-01-14,2,BUF,4,6,WSH,18,7,9,3,37,17,7,6,5,35,18,7,9,3,37,17,7,6,5,35,0,1,26,28,0.491228,0.508772,9,11
2020020007,2021-01-14,2,N.J,2,3,BOS,18,15,7,2,42,29,6,12,1,48,12,12,6,2,32,23,6,11,0,40,0,1,22,37,0.425926,0.574074,10,10
2020020008,2021-01-14,2,NYR,0,4,NYI,19,5,14,0,38,24,9,7,2,42,19,5,13,0,37,24,8,6,2,40,0,1,24,33,0.411765,0.588235,18,10
2020020009,2021-02-22,2,FLA,3,1,DAL,35,7,13,3,58,21,3,6,1,31,35,7,13,3,58,21,3,6,1,31,0,1,52,25,0.561404,0.438596,7,11
2020020010,2021-01-14,2,DET,0,3,CAR,13,9,9,0,31,34,11,12,2,59,13,9,9,0,31,34,11,12,2,59,0,1,14,43,0.403509,0.596491,11,9
2020020011,2021-01-14,2,NSH,3,1,CBJ,25,13,14,3,55,25,6,19,1,51,25,13,14,3,55,25,6,19,1,51,0,1,35,30,0.460317,0.539683,4,6
2020020012,2021-01-14,2,WPG,4,3,CGY,23,3,13,3,42,18,6,13,2,39,24,3,13,2,42,18,6,11,2,37,0,1,34,26,0.545455,0.454545,8,10
2020020013,2021-01-14,2,EDM,5,2,VAN,33,8,7,3,51,30,11,21,2,64,33,8,6,3,50,30,11,21,2,64,1,0,46,40,0.464286,0.535714,20,18
2020020014,2021-01-14,2,ARI,3,4,S.J,28,11,17,2,58,27,13,10,2,52,27,10,17,2,56,25,12,9,2,48,0,1,37,35,0.546875,0.453125,8,8
2020020015,2021-01-14,2,VGK,5,2,ANA,22,5,12,5,44,18,11,18,2,49,22,5,11,5,43,18,11,18,2,49,1,0,29,22,0.421053,0.578947,2,2
2020020016,2021-01-14,2,L.A,3,4,MIN,26,9,4,2,41,12,6,10,4,32,22,7,4,1,34,12,5,8,3,28,0,1,34,27,0.612903,0.387097,12,8
2020020017,2021-01-15,2,BUF,1,2,WSH,23,8,7,1,39,19,6,8,2,35,23,8,7,1,39,19,6,8,2,35,0,1,31,21,0.530612,0.469388,0,10
2020020018,2021-01-15,2,PHI,5,2,PIT,9,3,9,4,25,22,8,4,1,35,9,3,7,4,23,22,8,4,1,35,1,0,20,33,0.46,0.54,10,12
2020020019,2021-01-15,2,T.B,5,2,CHI,24,7,5,5,41,27,7,6,1,41,24,10,6,5,45,25,7,6,1,39,1,0,37,37,0.5,0.5,8,6
2020020020,2021-05-03,2,FLA,5,4,DAL,33,7,7,4,51,22,4,15,3,44,28,7,7,4,46,22,4,15,3,44,1,0,43,29,0.517241,0.482759,9,23
2020020021,2021-01-15,2,OTT,5,3,TOR,15,11,9,4,39,16,7,14,1,38,15,11,9,4,39,16,7,13,1,37,0,1,24,23,0.448276,0.551724,12,22
2020020022,2021-01-15,2,COL,8,0,STL,18,3,6,3,30,15,4,7,0,26,17,4,5,3,29,13,4,7,0,24,1,0,38,21,0.5,0.5,10,16
2020020023,2021-01-16,2,N.J,2,1,BOS,24,8,10,2,44,25,10,6,0,41,21,8,9,1,39,21,10,5,0,36,1,0,31,28,0.350877,0.649123,11,13
2020020024,2021-01-16,2,NYR,5,0,NYI,17,7,11,4,39,18,7,4,0,29,17,7,10,4,38,17,4,4,0,25,1,0,32,23,0.446429,0.553571,8,26
2020020025,2021-01-16,2,DET,4,2,CAR,14,11,5,4,34,26,8,11,1,46,14,11,5,4,34,26,8,11,1,46,1,0,21,31,0.532258,0.467742,10,4
2020020026,2021-01-16,2,NSH,5,2,CBJ,21,9,14,5,49,34,10,10,2,56,20,9,14,5,48,33,10,10,2,55,0,1,33,44,0.54386,0.45614,4,6
2020020027,2021-01-16,2,OTT,2,3,TOR,13,6,4,2,25,25,10,20,2,57,13,6,4,2,25,25,10,20,2,57,1,0,19,40,0.375,0.625,8,10
2020020028,2021-01-16,2,CGY,3,0,VAN,23,13,8,0,44,25,5,9,0,39,23,13,8,0,44,24,5,9,0,38,1,0,35,32,0.4,0.6,8,12
2020020029,2021-01-16,2,EDM,1,5,MTL,24,9,19,1,53,25,8,11,3,47,24,9,19,1,53,25,8,11,3,47,0,1,35,36,0.603774,0.396226,4,6
2020020030,2021-01-16,2,ARI,5,3,S.J,18,17,9,4,48,24,12,13,1,50,18,16,8,4,46,24,11,13,1,49,0,1,26,34,0.595745,0.404255,12,10
2020020031,2021-01-16,2,VGK,2,1,ANA,27,14,16,2,59,20,7,16,1,44,27,14,16,1,58,20,7,16,1,44,0,1,33,22,0.5,0.5,4,2
2020020032,2021-01-16,2,L.A,3,4,MIN,26,8,5,3,42,32,11,12,4,59,19,7,5,2,33,29,7,9,3,48,0,1,33,44,0.454545,0.545455,12,12
2020020033,2021-05-05,2,T.B,6,2,DAL,12,12,11,5,40,19,5,7,2,33,12,12,11,5,40,19,5,7,2,33,1,0,20,22,0.557692,0.442308,4,8
2020020034,2021-01-17,2,FLA,5,2,CHI,26,5,5,4,40,23,5,13,1,42,25,5,5,3,38,23,5,13,0,41,1,0,36,30,0.533333,0.466667,6,8
2020020035,2021-01-17,2,PIT,4,3,WSH,21,9,7,4,41,20,8,10,2,40,16,8,5,3,32,16,5,9,2,32,1,0,27,23,0.53125,0.46875,8,10
2020020036,2021-01-18,2,NYI,1,0,BOS,9,7,11,1,28,24,12,14,0,50,9,7,9,1,26,24,11,13,0,48,1,0,17,27,0.509091,0.490909,8,12
2020020037,2021-01-18,2,PHI,1,6,BUF,20,14,16,1,51,27,7,11,4,49,20,14,16,1,51,27,7,11,4,49,0,1,22,37,0.435484,0.564516,8,2
2020020038,2021-01-18,2,DET,2,3,CBJ,35,7,10,2,54,23,6,11,3,43,34,7,9,2,52,23,5,11,3,42,1,0,37,29,0.590164,0.409836,22,24
2020020039,2021-01-18,2,STL,5,4,S.J,27,5,8,5,45,17,8,3,2,30,27,5,7,5,44,17,8,3,2,30,0,1,33,26,0.47541,0.52459,6,6
2020020040,2021-01-18,2,NSH,2,4,CAR,27,8,9,1,45,17,7,15,3,42,24,8,9,1,42,15,6,15,3,39,0,1,33,24,0.666667,0.333333,8,10
2020020041,2021-01-18,2,TOR,3,1,WPG,25,14,10,2,51,20,7,8,1,36,25,14,10,2,51,18,7,8,1,34,1,0,38,28,0.645833,0.354167,10,4
2020020042,2021-01-18,2,CGY,5,2,VAN,20,6,9,3,38,15,7,7,1,30,20,6,9,3,38,15,7,7,1,30,0,1,32,27,0.530612,0.469388,8,14
2020020043,2021-01-18,2,EDM,1,3,MTL,17,9,5,0,31,20,5,11,1,37,15,9,5,0,29,20,3,11,1,35,0,1,26,34,0.555556,0.444444,10,14
2020020044,2021-01-18,2,VGK,4,2,ARI,12,8,8,3,31,19,7,16,0,42,11,8,8,3,30,18,6,16,0,40,0,1,28,32,0.486111,0.513889,10,10
2020020045,2021-01-18,2,ANA,1,0,MIN,21,7,7,1,36,25,17,11,0,53,20,7,6,1,34,24,16,10,0,50,1,0,27,34,0.533333,0.466667,12,6
2020020046,2021-01-19,2,NYR,3,4,N.J,33,8,13,1,55,24,7,10,3,44,33,8,13,1,55,24,7,10,3,44,0,1,50,28,0.491228,0.508772,4,12
2020020047,2021-01-19,2,PHI,3,0,BUF,22,9,6,3,40,34,10,15,0,59,22,9,6,3,40,34,10,15,0,59,1,0,30,40,0.516129,0.483871,6,4
2020020048,2021-05-07,2,T.B,2,5,DAL,22,9,8,1,40,26,7,15,5,53,22,9,8,1,40,26,7,15,5,53,0,1,27,31,0.375,0.625,2,8
2020020049,2021-01-19,2,FLA,5,4,CHI,21,11,14,3,49,30,8,10,2,50,19,11,13,2,45,28,8,9,2,47,1,0,30,36,0.454545,0.545455,4,8
2020020050,2021-01-19,2,PIT,5,4,WSH,24,7,13,2,46,19,3,16,4,42,22,7,13,1,43,18,3,16,4,41,0,1,30,26,0.629032,0.370968,4,6
2020020051,2021-01-19,2,DET,3,2,CBJ,22,11,15,2,50,19,8,10,2,39,21,11,15,1,48,19,8,10,2,39,0,1,27,24,0.642857,0.357143,4,2
2020020052,2021-03-02,2,NSH,2,4,CAR,35,11,6,1,53,22,14,10,2,48,35,11,6,1,53,21,14,10,1,46,0,1,38,28,0.516129,0.483871,8,8
2020020053,2021-01-19,2,OTT,3,4,WPG,27,9,4,1,41,20,0,13,3,36,26,9,4,1,40,20,0,12,2,34,1,0,41,28,0.54386,0.45614,10,10
2020020054,2021-01-19,2,L.A,2,3,COL,19,10,7,1,37,16,8,10,1,35,19,10,7,1,37,16,8,10,1,35,0,1,25,24,0.481481,0.518519,12,6
2020020055,2021-01-20,2,STL,1,2,S.J,19,10,7,1,37,24,5,6,1,36,18,10,6,1,35,21,5,5,1,32,1,0,23,38,0.55102,0.44898,14,10
2020020056,2021-01-20,2,TOR,1,3,EDM,15,5,18,1,39,17,7,3,2,29,15,5,18,1,39,17,7,3,2,29,0,1,26,22,0.58,0.42,6,4
2020020057,2021-01-20,2,VAN,6,5,MTL,20,10,13,4,47,31,15,12,5,63,18,8,12,2,40,23,13,12,4,52,1,0,28,36,0.464286,0.535714,2,12
2020020058,2021-01-20,2,VGK,5,2,ARI,13,5,9,4,31,20,9,12,2,43,13,5,9,3,30,20,9,12,2,43,1,0,29,23,0.518519,0.481481,8,14
2020020059,2021-01-20,2,ANA,2,3,MIN,18,20,12,2,52,22,8,15,1,46,18,20,12,2,52,21,8,15,1,45,0,1,24,32,0.552239,0.447761,8,4
2020020060,2021-01-21,2,BOS,5,4,PHI,33,11,15,4,63,23,8,5,2,38,29,10,13,3,55,16,7,4,2,29,0,1,43,26,0.629032,0.370968,10,6
2020020061,2021-01-21,2,NYI,4,1,N.J,27,11,13,2,53,28,6,20,1,55,27,11,13,2,53,28,6,20,1,55,1,0,35,31,0.633333,0.366667,2,6
2020020062,2021-02-17,2,CAR,3,4,FLA,24,18,9,2,53,29,8,8,3,48,21,18,9,2,50,28,8,8,2,46,1,0,35,37,0.597015,0.402985,8,6
2020020063,2021-01-21,2,CBJ,2,3,T.B,22,10,12,1,45,31,11,13,3,58,20,10,12,1,43,30,11,13,2,56,1,0,25,37,0.545455,0.454545,7,13
2020020064,2021-01-21,2,OTT,1,4,WPG,20,3,8,1,32,15,14,12,4,45,20,3,7,0,30,14,12,12,4,42,0,1,29,29,0.44898,0.55102,27,19
2020020065,2021-01-21,2,VAN,3,7,MTL,10,9,2,2,23,22,7,17,4,50,8,7,2,2,19,19,5,16,4,44,0,1,17,42,0.492063,0.507937,26,12
2020020066,2021-01-21,2,L.A,4,2,COL,17,8,9,2,36,20,18,10,1,49,16,8,9,2,35,20,18,10,1,49,0,1,27,26,0.462963,0.537037,8,10
2020020067,2021-01-22,2,WSH,4,3,BUF,27,7,11,4,49,22,20,10,3,55,23,6,11,3,43,19,18,9,3,49,0,1,32,27,0.4,0.6,6,4
2020020068,2021-01-22,2,PIT,4,3,NYR,24,9,8,4,45,29,9,9,3,50,20,8,9,2,39,25,7,8,2,42,1,0,28,34,0.660377,0.339623,8,4
2020020069,2021-01-22,2,CHI,4,1,DET,18,5,6,1,30,21,2,14,1,38,18,5,6,1,30,21,2,14,1,38,1,0,28,31,0.431373,0.568627,10,10
2020020070,2021-01-22,2,TOR,4,2,EDM,21,7,16,2,46,27,6,14,1,48,21,7,16,2,46,27,6,14,1,48,0,1,29,32,0.56,0.44,4,4
2020020071,2021-01-22,2,MIN,4,1,S.J,21,12,10,4,47,21,7,18,1,47,21,12,10,4,47,21,6,16,1,44,1,0,29,29,0.424242,0.575758,8,8
2020020072,2021-01-22,2,DAL,7,0,NSH,14,5,6,1,26,20,13,8,0,41,13,5,6,1,25,19,13,8,0,40,1,0,28,34,0.43662,0.56338,10,16
2020020073,2021-01-22,2,ARI,5,2,VGK,15,7,15,3,40,24,13,11,1,49,15,7,15,3,40,24,13,11,1,49,1,0,26,31,0.408163,0.591837,8,12
2020020074,2021-01-22,2,ANA,2,3,COL,25,6,6,2,39,20,12,17,2,51,25,6,5,2,38,18,12,17,1,48,0,1,38,32,0.461538,0.538462,8,10
2020020075,2021-01-23,2,BOS,6,1,PHI,16,9,9,3,37,13,10,12,1,36,16,9,9,3,37,13,10,12,1,36,1,0,26,17,0.457627,0.542373,4,8
2020020076,2021-03-07,2,CAR,4,2,FLA,20,13,9,2,44,14,10,7,2,33,20,13,9,2,44,12,10,7,2,31,1,0,26,23,0.507246,0.492754,12,12
2020020077,2021-01-23,2,CBJ,5,2,T.B,20,11,8,5,44,29,6,8,1,44,20,11,8,5,44,28,6,8,1,43,0,1,28,32,0.491525,0.508475,6,4
2020020078,2021-01-23,2,STL,4,2,L.A,23,4,2,3,32,17,13,11,1,42,23,4,2,3,32,17,13,11,1,42,1,0,30,23,0.559322,0.440678,10,4
2020020079,2021-01-23,2,WPG,6,3,OTT,28,8,13,4,53,16,7,13,3,39,28,8,13,4,53,16,7,13,3,39,1,0,38,21,0.528302,0.471698,9,11
2020020080,2021-01-23,2,VAN,2,5,MTL,17,11,10,2,40,24,8,16,5,53,17,11,10,2,40,24,8,16,5,53,0,1,25,33,0.606557,0.393443,23,23
2020020081,2021-01-24,2,N.J,2,0,NYI,20,9,9,1,39,22,10,6,0,38,20,9,9,1,39,22,10,6,0,38,1,0,24,28,0.389831,0.610169,4,4
2020020082,2021-01-24,2,WSH,3,4,BUF,25,7,15,1,48,33,13,13,1,60,18,6,14,1,39,27,10,13,0,50,1,0,31,48,0.485714,0.514286,10,6
2020020083,2021-01-24,2,PIT,3,2,NYR,16,15,14,3,48,21,13,10,2,46,16,15,14,3,48,23,14,11,2,50,0,1,19,26,0.491228,0.508772,4,0
2020020084,2021-01-24,2,CHI,6,2,DET,24,5,9,5,43,16,6,11,0,33,24,5,9,5,43,16,6,11,0,33,1,0,35,27,0.5,0.5,10,4
2020020085,2021-01-24,2,STL,3,6,L.A,22,4,12,3,41,22,11,9,5,47,22,4,12,3,41,21,11,9,5,46,1,0,31,35,0.5,0.5,10,6
2020020086,2021-01-24,2,WPG,3,4,EDM,34,13,13,2,62,28,9,13,4,54,34,13,13,2,62,28,9,13,4,54,1,0,38,38,0.490909,0.509091,6,4
2020020087,2021-01-24,2,CGY,2,3,TOR,27,14,12,1,54,24,8,3,2,37,26,13,12,1,52,24,8,3,2,37,0,1,33,32,0.48,0.52,8,8
2020020088,2021-01-24,2,MIN,3,5,S.J,22,15,10,2,49,26,7,16,4,53,21,14,7,1,43,24,7,15,4,50,1,0,29,36,0.428571,0.571429,12,12
2020020089,2021-01-24,2,DAL,3,2,NSH,15,12,19,0,46,11,10,12,1,34,15,12,19,0,46,11,10,12,1,34,1,0,22,17,0.491803,0.508197,8,8
2020020090,2021-01-24,2,ARI,0,1,VGK,14,10,14,0,38,25,21,14,1,61,14,10,14,0,38,25,21,14,1,61,0,1,16,27,0.386364,0.613636,4,4
2020020091,2021-01-24,2,ANA,3,1,COL,9,10,14,3,36,25,10,19,1,55,9,10,14,3,36,25,10,19,1,55,1,0,15,33,0.454545,0.545455,8,6
2020020092,2021-01-25,2,VAN,7,1,OTT,27,9,9,6,51,27,13,10,1,51,21,7,9,6,43,26,11,10,1,48,1,0,35,36,0.636364,0.363636,22,16
2020020093,2021-01-26,2,BOS,3,2,PIT,25,7,6,1,39,22,12,9,2,45,23,7,5,0,35,21,10,6,2,39,1,0,36,30,0.69697,0.30303,12,6
2020020094,2021-01-26,2,BUF,3,2,NYR,14,11,6,1,32,21,5,3,2,31,14,11,6,1,32,21,5,3,2,31,0,1,24,30,0.696429,0.303571,6,8
2020020095,2021-01-26,2,N.J,3,5,PHI,19,9,9,3,40,17,9,3,3,32,19,9,9,3,40,17,9,3,3,32,0,1,26,31,0.483333,0.516667,10,2
2020020096,2021-01-26,2,WSH,3,2,NYI,30,14,19,2,65,29,5,14,2,50,30,14,19,2,65,29,5,14,2,50,1,0,37,34,0.5,0.5,6,7
2020020097,2021-02-22,2,CAR,2,4,T.B,31,13,12,1,57,22,16,12,3,53,31,13,12,1,57,22,16,12,3,53,1,0,36,32,0.5625,0.4375,8,6
2020020098,2021-01-26,2,CBJ,3,4,FLA,12,6,7,3,28,27,18,10,5,60,10,3,6,2,21,20,16,10,3,49,1,0,22,31,0.5,0.5,6,12
2020020099,2021-01-26,2,NSH,3,2,CHI,28,12,14,3,57,17,6,10,1,34,27,10,13,2,52,16,6,9,1,32,0,1,39,20,0.532258,0.467742,4,8
2020020100,2021-01-26,2,WPG,6,4,EDM,18,6,9,5,38,18,9,5,2,34,18,6,9,5,38,18,9,5,2,34,0,1,33,26,0.589286,0.410714,4,10
2020020101,2021-01-26,2,CGY,3,4,TOR,22,15,10,2,49,14,8,9,3,34,22,15,10,2,49,14,8,9,3,34,0,1,26,21,0.553571,0.446429,4,10
2020020102,2021-01-26,2,MIN,1,2,L.A,28,7,15,1,51,11,10,8,2,31,28,7,15,1,51,11,10,8,2,31,0,1,33,21,0.490566,0.509434,6,6
2020020103,2021-01-26,2,DAL,2,1,DET,14,8,11,1,34,15,9,11,1,36,13,8,11,0,32,15,8,11,1,35,0,1,22,21,0.538462,0.461538,6,8
2020020104,2021-01-26,2,COL,7,3,S.J,25,6,11,5,47,16,5,3,3,27,25,6,11,5,47,16,5,4,3,28,0,1,42,30,0.471429,0.528571,20,10
2020020105,2021-01-26,2,ARI,0,1,ANA,28,17,11,0,56,22,5,10,1,38,28,17,11,0,56,22,5,10,1,38,0,1,31,24,0.454545,0.545455,2,6
2020020106,2021-01-26,2,VGK,4,5,STL,33,15,16,4,68,19,7,12,5,43,26,13,14,3,56,14,6,11,3,34,1,0,46,25,0.469697,0.530303,15,17
2020020107,2021-01-27,2,NSH,2,1,CHI,35,14,9,2,60,30,10,12,1,53,31,12,8,1,52,22,7,11,1,41,1,0,42,30,0.595238,0.404762,8,8
2020020108,2021-01-27,2,VAN,5,1,OTT,24,11,12,4,51,29,8,9,0,46,24,11,12,4,51,29,8,9,0,46,1,0,35,43,0.5,0.5,8,6
2020020109,2021-01-28,2,BOS,4,1,PIT,13,5,9,3,30,12,16,7,1,36,13,5,9,3,30,12,16,7,1,36,1,0,20,17,0.627907,0.372093,6,4
2020020110,2021-01-28,2,BUF,2,3,NYR,21,1,9,1,32,26,9,9,3,47,19,1,9,1,30,25,9,7,1,42,0,1,25,39,0.526316,0.473684,8,10
2020020111,2021-01-28,2,N.J,1,3,PHI,27,9,16,1,53,14,8,7,3,32,28,8,16,1,53,14,9,7,3,33,1,0,34,17,0.264151,0.735849,4,8
2020020112,2021-01-28,2,WSH,6,3,NYI,12,11,11,4,38,25,9,16,2,52,12,11,11,4,38,25,9,16,2,52,0,1,23,30,0.446429,0.553571,6,16
2020020113,2021-01-28,2,CAR,1,0,T.B,31,15,10,1,57,28,17,12,0,57,29,15,10,0,54,27,17,12,0,56,0,0,35,32,0.490566,0.509434,6,8
2020020114,2021-01-28,2,CBJ,3,2,FLA,29,18,9,2,58,35,10,11,2,58,24,15,5,1,45,28,10,9,2,49,1,0,31,35,0.45614,0.54386,6,10
2020020115,2021-01-28,2,MTL,4,2,CGY,16,3,14,1,34,17,12,15,1,45,16,3,12,1,32,17,9,13,1,40,1,0,21,25,0.5,0.5,15,13
2020020116,2021-01-28,2,EDM,3,4,TOR,21,12,10,1,44,14,9,9,2,34,21,12,10,1,44,14,9,9,2,34,0,1,29,27,0.529412,0.470588,8,14
2020020117,2021-01-28,2,VAN,4,1,OTT,19,13,8,3,43,28,9,17,1,55,19,13,8,3,43,28,9,17,1,55,1,0,25,37,0.545455,0.454545,17,15
2020020118,2021-01-28,2,MIN,5,3,L.A,16,7,5,5,33,23,7,14,1,45,17,7,5,5,34,22,7,14,1,44,1,0,28,35,0.44898,0.55102,32,15
2020020119,2021-01-28,2,DAL,7,3,DET,19,6,7,6,38,13,6,14,2,35,19,6,7,6,38,13,3,13,2,31,1,0,29,23,0.5,0.5,14,6
2020020120,2021-01-28,2,COL,3,0,S.J,21,16,14,2,53,17,16,15,0,48,21,16,13,2,52,16,16,15,0,47,1,0,38,21,0.551724,0.448276,8,8
2020020121,2021-01-28,2,ARI,3,2,ANA,26,18,13,2,59,8,8,12,1,29,26,18,13,2,59,8,8,12,1,29,0,1,34,16,0.566038,0.433962,6,12
2020020122,2021-03-22,2,VGK,5,1,STL,22,15,13,3,53,14,4,15,1,34,22,15,13,3,53,14,4,15,1,34,1,0,35,16,0.474576,0.525424,4,6
2020020123,2021-01-29,2,CHI,1,2,CBJ,24,8,19,0,51,23,5,10,1,39,24,8,19,0,51,23,5,10,1,39,0,1,32,27,0.574468,0.425532,4,6
2020020124,2021-01-30,2,BUF,4,3,N.J,22,7,11,3,43,23,11,9,2,45,18,6,10,2,36,19,9,7,2,37,1,0,31,34,0.609375,0.390625,10,10
2020020125,2021-01-30,2,NYR,4,5,PIT,21,8,7,2,38,29,10,12,5,56,20,7,7,2,36,26,8,12,4,50,0,1,34,38,0.425926,0.574074,8,10
2020020126,2021-01-30,2,PHI,3,2,NYI,12,10,10,3,35,22,10,12,2,46,10,10,10,2,32,20,10,12,2,44,1,0,17,28,0.5,0.5,8,2
2020020127,2021-01-30,2,WSH,4,3,BOS,18,10,9,3,40,38,10,21,2,71,17,10,9,2,38,36,10,21,2,69,1,0,23,43,0.44898,0.55102,8,2
2020020128,2021-01-30,2,CAR,4,1,DAL,15,12,9,1,37,4,10,9,0,23,17,14,11,1,43,4,10,9,0,23,1,0,26,11,0.530303,0.469697,12,10
2020020129,2021-01-30,2,T.B,4,3,NSH,15,5,4,2,26,17,0,8,1,26,17,5,4,2,28,16,0,8,1,25,0,1,33,26,0.618182,0.381818,30,34
2020020130,2021-01-30,2,DET,2,3,FLA,19,9,8,2,38,18,12,11,1,42,18,9,7,2,36,16,11,11,0,38,0,1,27,26,0.52459,0.47541,6,8
2020020131,2021-01-30,2,MTL,0,2,CGY,29,13,13,0,55,25,4,7,1,37,29,12,13,0,54,25,4,7,1,37,0,1,37,33,0.47541,0.52459,16,14
2020020132,2021-01-30,2,WPG,1,4,VAN,22,13,12,1,48,28,3,9,4,44,22,12,12,1,47,22,2,9,4,37,0,1,24,39,0.45,0.55,10,6
2020020133,2021-01-30,2,EDM,4,3,TOR,24,12,15,3,54,23,6,9,2,40,24,11,15,2,52,22,6,9,2,39,1,0,31,29,0.580645,0.419355,4,4
2020020134,2021-01-30,2,MIN,1,5,COL,14,5,4,1,24,20,9,15,3,47,14,5,4,1,24,19,9,15,3,46,0,1,20,33,0.523077,0.476923,14,4
2020020135,2021-01-30,2,ANA,1,6,STL,21,9,8,1,39,21,6,7,5,39,19,9,8,1,37,21,6,7,5,39,0,1,24,30,0.489796,0.510204,11,13
2020020136,2021-01-31,2,BUF,3,5,N.J,22,16,7,1,46,31,14,9,5,59,22,15,7,1,45,30,14,9,5,58,0,1,33,37,0.580645,0.419355,6,8
2020020137,2021-01-31,2,PHI,4,3,NYI,19,12,10,3,44,20,8,5,2,35,17,10,10,3,40,18,8,4,2,32,1,0,29,36,0.509434,0.490566,12,8
2020020138,2021-01-31,2,CAR,4,3,DAL,26,9,8,3,46,20,9,8,4,41,24,8,8,1,41,17,9,8,3,37,1,0,40,29,0.528571,0.471429,10,10
2020020139,2021-01-31,2,DET,2,3,FLA,22,5,8,2,37,23,8,8,1,40,22,5,7,2,36,23,8,8,1,40,1,0,34,30,0.482143,0.517857,10,8
2020020140,2021-01-31,2,CHI,3,1,CBJ,25,4,13,3,45,26,5,12,1,44,24,4,13,3,44,25,5,10,1,41,1,0,36,33,0.465116,0.534884,6,6
2020020141,2021-01-31,2,EDM,8,5,OTT,15,7,5,4,31,28,12,12,3,55,15,7,5,4,31,28,12,12,3,55,1,0,31,38,0.590909,0.409091,10,10
2020020142,2021-01-31,2,MIN,4,3,COL,23,7,4,4,38,18,13,10,3,44,23,7,4,3,37,18,13,10,3,44,0,1,33,25,0.530303,0.469697,8,6
2020020143,2021-01-31,2,ANA,1,4,STL,23,11,16,0,50,17,6,19,3,45,23,11,16,0,50,17,6,19,3,45,1,0,26,23,0.551724,0.448276,4,4
2020020144,2021-02-01,2,NYR,3,1,PIT,14,6,9,2,31,17,9,14,1,41,13,7,9,2,31,17,8,14,1,40,0,1,24,26,0.291667,0.708333,17,13
2020020145,2021-02-01,2,WSH,3,5,BOS,17,11,6,2,36,25,9,12,5,51,17,11,6,2,36,25,9,12,5,51,1,0,26,33,0.5,0.5,13,13
2020020146,2021-02-01,2,T.B,5,2,NSH,17,11,10,4,42,25,7,13,2,47,17,11,10,4,42,25,7,13,2,47,1,0,28,31,0.442308,0.557692,6,8
2020020147,2021-02-01,2,MTL,6,2,VAN,30,10,7,4,51,22,6,10,2,40,30,10,7,4,51,22,6,10,2,40,1,0,40,29,0.508772,0.491228,6,6
2020020148,2021-02-01,2,WPG,3,4,CGY,25,8,10,2,45,20,20,11,5,56,20,6,8,1,35,17,16,10,3,46,1,0,28,28,0.5,0.5,4,8
2020020149,2021-02-13,2,S.J,1,3,VGK,20,8,8,1,37,15,8,12,0,35,20,7,8,1,36,16,8,11,0,35,0,1,25,26,0.40678,0.59322,14,10
2020020150,2021-02-22,2,NYI,3,2,BUF,19,15,7,2,43,28,9,8,1,46,19,15,7,2,43,28,9,8,1,46,0,1,23,36,0.541667,0.458333,6,4
2020020151,2021-03-21,2,PIT,1,2,N.J,29,8,9,1,47,30,7,11,2,50,27,8,9,1,45,29,7,10,1,47,1,0,36,35,0.481481,0.518519,4,4
2020020152,2021-02-02,2,CBJ,3,6,DAL,20,7,12,2,41,23,9,5,4,41,20,7,12,2,41,23,9,5,4,41,0,1,26,33,0.436364,0.563636,6,6
2020020153,2021-02-02,2,CHI,3,4,CAR,32,4,13,2,51,39,6,22,4,71,26,4,13,2,45,32,6,22,3,63,0,1,33,41,0.441176,0.558824,2,4
2020020154,2021-02-02,2,STL,4,3,ARI,17,6,15,4,42,26,6,12,2,46,17,6,14,3,40,24,6,12,2,44,0,1,29,35,0.559322,0.440678,6,10
2020020155,2021-02-02,2,MTL,5,3,VAN,24,8,12,5,49,30,5,10,2,47,22,8,12,5,47,30,5,10,2,47,1,0,33,39,0.513889,0.486111,6,8
2020020156,2021-02-02,2,WPG,3,2,CGY,23,11,8,2,44,25,9,20,2,56,23,10,8,2,43,25,9,20,2,56,1,0,28,31,0.431373,0.568627,8,4
2020020157,2021-02-02,2,EDM,4,2,OTT,18,7,19,4,48,19,12,14,2,47,18,7,19,4,48,19,12,14,2,47,1,0,25,25,0.47541,0.52459,10,4
2020020158,2021-02-02,2,COL,2,1,MIN,23,9,21,2,55,19,10,9,0,38,24,9,20,2,55,18,8,8,0,34,1,0,31,28,0.583333,0.416667,11,11
2020020159,2021-02-03,2,PHI,3,4,BOS,20,10,11,3,44,26,12,13,1,52,20,10,11,3,44,26,11,13,1,51,0,1,25,35,0.537037,0.462963,8,4
2020020160,2021-02-03,2,T.B,5,1,DET,20,11,9,5,45,13,10,10,1,34,18,11,9,4,42,13,10,10,1,34,1,0,27,16,0.46,0.54,8,8
2020020161,2021-02-02,2,L.A,1,3,ANA,15,2,6,1,24,38,14,11,3,66,15,2,6,1,24,38,14,11,3,66,0,1,21,43,0.454545,0.545455,7,7
2020020162,2021-05-12,2,SJS,0,6,VGK,17,9,10,0,36,31,9,8,6,54,17,9,10,0,36,31,9,8,6,54,0,1,19,44,0.5,0.5,8,2
2020020163,2021-03-04,2,NYI,5,2,BUF,30,8,6,5,49,16,11,10,2,39,30,8,6,5,49,15,9,10,1,35,1,0,45,18,0.5625,0.4375,2,8
2020020164,2021-02-04,2,NYR,4,2,WSH,23,10,7,4,44,25,6,18,2,51,21,10,6,4,41,24,5,16,2,47,1,0,31,33,0.45614,0.54386,17,13
2020020165,2021-02-04,2,FLA,5,6,NSH,29,9,9,3,50,23,9,13,4,49,28,8,7,3,46,23,9,13,3,48,1,0,36,41,0.393443,0.606557,8,8
2020020166,2021-04-20,2,PIT,7,6,N.J,22,6,7,6,41,19,5,7,4,35,22,6,7,6,41,19,5,7,4,35,1,0,32,30,0.546875,0.453125,8,4
2020020167,2021-02-04,2,CBJ,4,3,DAL,18,7,6,4,35,20,17,13,2,52,18,7,6,4,35,20,17,13,2,52,1,0,25,28,0.508772,0.491228,6,6
2020020168,2021-02-04,2,CHI,6,4,CAR,20,8,13,3,44,25,8,20,4,57,20,9,13,3,45,25,9,20,4,58,0,1,35,34,0.376812,0.623188,8,10
2020020169,2021-02-04,2,STL,3,4,ARI,28,8,17,3,56,22,8,8,4,42,28,8,17,3,56,22,8,8,4,42,0,1,43,30,0.615385,0.384615,4,8
2020020170,2021-02-04,2,MTL,2,3,OTT,27,18,9,1,55,17,11,10,2,40,27,18,9,1,55,17,11,10,2,40,1,0,38,22,0.431034,0.568966,15,15
2020020171,2021-02-04,2,TOR,7,3,VAN,23,8,7,6,44,15,6,5,2,28,23,8,7,6,44,15,5,5,2,27,1,0,37,19,0.561404,0.438596,11,15
2020020172,2021-02-04,2,WPG,4,1,CGY,21,10,7,4,42,21,10,11,1,43,19,10,8,4,41,18,9,11,1,39,0,1,27,24,0.568182,0.431818,8,6
2020020173,2021-02-24,2,COL,2,6,MIN,23,12,22,1,58,18,10,6,5,39,23,12,21,1,57,17,9,6,5,37,0,1,32,25,0.508475,0.491525,4,8
2020020174,2021-02-05,2,PHI,1,2,BOS,18,13,11,0,42,17,10,12,2,41,17,13,11,0,41,19,12,13,2,46,1,0,24,23,0.421053,0.578947,11,17
2020020175,2021-02-05,2,T.B,3,1,DET,20,10,4,3,37,23,6,5,1,35,20,10,4,3,37,23,6,5,1,35,0,1,32,28,0.468085,0.531915,4,6
2020020176,2021-02-05,2,FLA,2,1,NSH,25,7,16,2,50,24,14,16,1,55,25,7,16,2,50,24,14,16,1,55,0,1,36,25,0.596774,0.403226,4,6
2020020177,2021-02-05,2,VGK,5,2,L.A,22,6,14,4,46,25,3,16,1,45,20,6,13,4,43,25,3,16,1,45,1,0,36,29,0.538462,0.461538,4,8
2020020178,2021-02-05,2,ANA,4,5,S.J,30,15,12,4,61,24,12,21,5,62,25,15,12,4,56,22,11,20,3,56,0,1,37,30,0.574074,0.425926,6,6
2020020179,2021-03-27,2,BOS,3,2,BUF,26,9,9,3,47,19,9,7,1,36,26,9,9,3,47,19,9,7,1,36,0,1,36,27,0.565217,0.434783,6,10
2020020180,2021-03-04,2,N.J,1,6,NYR,31,16,9,1,57,13,8,3,5,29,31,16,9,1,57,13,8,3,5,29,1,0,36,19,0.642857,0.357143,9,13
2020020181,2021-02-06,2,NYI,4,3,PIT,20,14,11,3,48,28,17,12,3,60,19,12,11,3,45,26,17,12,3,58,1,0,26,31,0.534884,0.465116,2,4
2020020182,2021-04-14,2,STL,3,4,COL,25,9,16,1,51,23,11,17,3,54,25,9,16,1,51,23,11,17,3,54,0,1,34,28,0.655738,0.344262,6,8
2020020183,2021-02-06,2,OTT,1,2,MTL,27,15,15,0,57,24,6,9,1,40,27,15,15,0,57,24,6,9,1,40,0,1,35,32,0.571429,0.428571,6,12
2020020184,2021-02-06,2,TOR,5,1,VAN,21,13,6,4,44,21,7,8,0,36,21,13,6,4,44,21,7,8,0,36,1,0,31,28,0.535714,0.464286,8,8
2020020185,2021-02-06,2,CGY,6,4,EDM,18,8,7,5,38,22,12,14,3,51,18,8,7,5,38,22,10,13,2,47,1,0,28,32,0.492537,0.507463,12,8
2020020186,2021-03-16,2,MIN,3,0,ARI,21,3,5,3,32,24,9,6,0,39,21,3,5,3,32,24,9,6,0,39,1,0,26,31,0.490566,0.509434,16,31
2020020187,2021-02-06,2,ANA,2,1,S.J,23,12,15,3,53,28,10,4,2,44,19,10,14,1,44,24,8,4,1,37,0,1,33,27,0.55,0.45,6,10
2020020188,2021-02-07,2,WSH,4,7,PHI,30,15,9,3,57,14,18,12,7,51,30,15,9,3,57,14,18,12,7,51,1,0,37,23,0.477273,0.522727,8,2
2020020189,2021-02-07,2,FLA,1,4,DET,36,8,10,1,55,34,6,6,4,50,34,8,10,1,53,33,6,6,4,49,0,1,37,39,0.508772,0.491228,9,11
2020020190,2021-02-07,2,CBJ,5,6,CAR,14,7,7,4,32,19,10,11,5,45,14,7,7,4,32,19,10,11,5,45,1,0,22,26,0.442623,0.557377,9,15
2020020191,2021-04-26,2,STL,4,1,COL,16,6,3,3,28,25,14,21,0,60,16,6,3,3,28,25,14,21,0,60,1,0,20,32,0.509804,0.490196,8,4
2020020192,2021-04-14,2,MIN,5,2,ARI,14,8,10,2,34,21,6,12,1,40,14,8,10,2,34,21,6,12,1,40,1,0,22,30,0.574468,0.425532,8,6
2020020193,2021-02-07,2,DAL,1,2,CHI,25,9,13,1,48,25,8,4,1,38,21,8,13,1,43,23,8,4,0,35,0,1,31,35,0.5,0.5,13,11
2020020194,2021-02-07,2,VGK,4,3,L.A,24,8,11,3,46,18,13,8,3,42,24,8,11,3,46,18,13,8,3,42,0,1,33,32,0.418182,0.581818,8,4
2020020195,2021-04-13,2,BOS,3,2,BUF,29,16,15,2,62,18,10,14,2,44,26,14,15,2,57,17,9,14,2,42,0,1,34,23,0.559322,0.440678,16,14
2020020196,2021-02-08,2,NYR,0,2,NYI,26,3,11,0,40,26,10,19,2,57,26,3,11,0,40,26,10,19,2,57,0,1,30,30,0.613636,0.386364,2,6
2020020197,2021-02-08,2,CBJ,3,2,CAR,19,6,11,2,38,22,16,21,2,61,19,6,11,2,38,22,16,21,2,61,1,0,22,24,0.382353,0.617647,2,2
2020020198,2021-02-08,2,NSH,1,4,T.B,15,9,12,0,36,26,6,15,3,50,15,8,12,0,35,26,6,15,3,50,0,1,24,35,0.472727,0.527273,13,15
2020020199,2021-02-08,2,OTT,1,3,EDM,22,5,17,1,45,27,17,9,3,56,21,4,16,1,42,26,16,9,3,54,1,0,28,35,0.481481,0.518519,18,14
2020020200,2021-02-08,2,TOR,3,1,VAN,14,11,8,3,36,27,10,9,0,46,14,11,8,3,36,27,10,9,0,46,1,0,19,32,0.5,0.5,8,4
2020020201,2021-03-18,2,N.J,3,2,PIT,32,10,19,2,63,38,14,11,1,64,32,10,19,2,63,38,14,11,1,64,1,0,35,42,0.469697,0.530303,4,2
2020020202,2021-04-13,2,WSH,6,1,PHI,21,4,9,3,37,25,5,17,1,48,21,4,9,3,37,25,5,17,1,48,1,0,32,30,0.575758,0.424242,4,6
2020020203,2021-02-09,2,FLA,2,1,DET,19,9,7,1,36,27,6,6,1,40,19,9,7,1,36,27,6,6,1,40,0,1,22,32,0.452381,0.547619,6,2
2020020204,2021-02-09,2,NSH,1,6,T.B,26,12,13,1,52,19,9,6,3,37,25,11,13,1,50,18,9,6,3,36,1,0,33,30,0.509091,0.490909,22,10
2020020205,2021-02-09,2,OTT,2,3,EDM,39,13,9,2,63,17,9,6,3,35,39,13,9,2,63,17,9,6,3,35,1,0,42,22,0.5625,0.4375,2,4
2020020206,2021-02-09,2,CGY,3,2,WPG,24,12,10,2,48,22,2,7,1,32,24,12,10,2,48,22,2,7,1,32,0,1,29,27,0.555556,0.444444,4,4
2020020207,2021-05-01,2,MIN,4,3,STL,31,8,7,4,50,25,7,5,3,40,31,8,7,3,49,24,6,5,3,38,0,1,38,31,0.542373,0.457627,2,2
2020020208,2021-02-09,2,DAL,1,2,CHI,28,15,19,1,63,24,8,12,1,45,26,15,19,1,61,23,8,12,0,43,1,0,35,29,0.604167,0.395833,8,4
2020020209,2021-03-31,2,COL,9,3,ARI,25,10,13,7,55,22,5,4,2,33,25,10,12,7,54,16,5,3,2,26,1,0,38,31,0.551724,0.448276,24,12
2020020210,2021-02-09,2,VGK,5,4,ANA,20,9,11,5,45,18,8,19,3,48,20,9,11,5,45,18,8,19,3,48,1,0,31,23,0.403846,0.596154,9,7
2020020211,2021-02-09,2,L.A,3,4,S.J,21,10,7,2,40,29,15,13,4,61,18,7,6,2,33,21,14,13,3,51,0,1,27,40,0.5,0.5,4,8
2020020212,2021-02-10,2,NYR,2,3,BOS,25,7,8,2,42,25,13,17,2,57,25,7,8,2,42,25,13,17,1,56,1,0,35,32,0.309524,0.690476,11,11
2020020213,2021-02-10,2,MTL,2,4,TOR,29,5,17,2,53,16,9,8,4,37,28,5,17,2,52,14,9,8,2,33,1,0,35,24,0.470588,0.529412,8,8
2020020214,2021-03-15,2,BUF,0,6,WSH,22,12,14,0,48,20,9,8,6,43,22,12,14,0,48,20,9,8,6,43,0,1,23,30,0.44186,0.55814,4,2
2020020215,2021-02-11,2,NYI,3,4,PIT,28,9,14,2,53,31,3,20,4,58,20,8,14,2,44,28,2,18,3,51,1,0,29,35,0.561404,0.438596,2,2
2020020216,2021-04-25,2,PHI,4,3,N.J,32,12,19,6,69,29,10,9,5,53,28,12,19,3,62,20,9,8,3,40,0,1,36,32,0.566667,0.433333,6,2
2020020217,2021-02-11,2,FLA,5,2,T.B,23,11,11,4,49,16,7,9,0,32,21,10,10,4,45,15,7,9,0,31,1,0,29,21,0.6,0.4,13,13
2020020218,2021-02-11,2,CHI,5,6,CBJ,16,3,9,4,32,35,9,12,3,59,16,3,9,4,32,35,9,12,3,59,0,1,26,43,0.527273,0.472727,6,4
2020020219,2021-02-11,2,NSH,3,2,DET,16,17,10,2,45,21,7,14,2,44,16,17,10,2,45,21,7,14,2,44,1,0,23,26,0.538462,0.461538,8,8
2020020220,2021-02-11,2,MTL,0,3,EDM,35,15,13,0,63,22,12,12,2,48,34,15,12,0,61,22,12,12,2,48,0,1,38,31,0.45283,0.54717,8,6
2020020221,2021-02-11,2,WPG,5,1,OTT,19,9,9,4,41,38,15,11,1,65,19,9,8,4,40,38,15,11,1,65,1,0,26,42,0.479167,0.520833,4,4
2020020222,2021-02-11,2,VAN,1,3,CGY,24,5,5,1,35,18,2,4,3,27,23,5,5,1,34,18,2,4,3,27,0,1,34,26,0.428571,0.571429,8,10
2020020223,2021-03-25,2,MIN,2,0,STL,6,7,7,2,22,32,11,11,0,54,6,7,7,2,22,32,11,11,0,54,1,0,11,37,0.433962,0.566038,16,16
2020020224,2021-02-11,2,DAL,3,5,CAR,26,7,15,2,50,20,11,11,4,46,24,6,15,2,47,20,11,11,4,46,0,1,37,32,0.465753,0.534247,6,10
2020020225,2021-04-12,2,COL,4,2,ARI,14,9,14,3,40,31,12,9,1,53,14,9,14,3,40,31,12,9,1,53,1,0,20,37,0.507937,0.492063,12,12
2020020226,2021-02-11,2,VGK,0,1,ANA,17,11,24,0,52,24,10,9,1,44,17,11,24,0,52,24,10,9,1,44,0,1,21,28,0.444444,0.555556,14,4
2020020227,2021-02-11,2,L.A,6,2,S.J,21,9,5,3,38,25,19,9,1,54,21,9,5,3,38,24,18,9,1,52,1,0,31,31,0.395833,0.604167,6,14
2020020228,2021-02-12,2,NYR,0,1,BOS,15,10,10,0,35,20,13,8,1,42,17,10,11,0,38,19,13,8,1,41,0,1,21,30,0.45614,0.54386,22,36
2020020229,2021-04-09,2,BUF,3,4,WSH,28,9,14,3,54,25,11,12,4,52,27,8,14,3,52,24,11,12,3,50,0,1,33,33,0.603448,0.396552,2,6
2020020230,2021-02-13,2,NYI,4,2,BOS,32,11,12,2,57,25,16,13,2,56,32,11,12,2,57,25,16,13,2,56,0,1,42,30,0.365079,0.634921,4,2
2020020231,2021-05-10,2,PHI,4,2,N.J,20,15,13,3,51,22,10,11,2,45,20,15,13,3,51,22,10,11,2,45,0,1,31,25,0.522727,0.477273,4,8
2020020232,2021-02-13,2,FLA,1,6,T.B,22,12,10,1,45,19,4,7,5,35,22,11,8,1,42,17,4,6,4,31,0,1,34,28,0.482143,0.517857,17,19
2020020233,2021-02-13,2,CHI,3,2,CBJ,25,1,16,3,45,28,4,7,2,41,25,1,16,2,44,28,4,7,2,41,0,1,31,31,0.647059,0.352941,7,9
2020020234,2021-02-13,2,NSH,2,4,DET,21,14,12,2,49,21,7,9,4,41,21,14,12,2,49,20,7,9,4,40,0,1,23,30,0.415094,0.584906,8,4
2020020235,2021-02-13,2,TOR,1,2,MTL,20,14,4,1,39,23,12,21,2,58,20,14,4,1,39,23,12,21,2,58,1,0,22,25,0.514286,0.485714,0,2
2020020236,2021-02-13,2,WPG,1,2,OTT,28,14,23,1,66,26,10,8,2,46,28,14,23,1,66,26,10,8,2,46,1,0,31,29,0.5,0.5,2,2
2020020237,2021-02-13,2,VAN,3,1,CGY,38,11,18,3,70,17,9,11,1,38,38,11,18,3,70,17,9,11,1,38,1,0,46,19,0.546875,0.453125,6,2
2020020238,2021-02-13,2,DAL,3,4,CAR,22,15,18,2,57,14,14,11,2,41,22,15,16,2,55,12,12,11,2,37,1,0,29,21,0.476923,0.523077,8,6
2020020239,2021-02-13,2,ARI,4,5,STL,29,14,5,4,52,26,9,19,5,59,27,14,5,4,50,24,9,19,4,56,1,0,36,35,0.483333,0.516667,4,4
2020020240,2021-04-23,2,L.A,2,4,MIN,31,9,12,2,54,18,11,12,3,44,31,9,12,2,54,18,11,12,3,44,0,1,42,24,0.603774,0.396226,4,6
2020020241,2021-04-06,2,S.J,1,5,ANA,30,5,9,0,44,29,7,14,4,54,30,5,9,0,44,29,7,14,4,54,0,1,35,34,0.491228,0.508772,7,13
2020020242,2021-02-14,2,PIT,6,3,WSH,26,6,6,5,43,22,5,13,2,42,27,6,6,5,44,22,5,14,2,43,0,1,38,31,0.616667,0.383333,8,4
2020020243,2021-02-14,2,VGK,1,0,COL,19,9,13,1,42,30,11,15,0,56,19,9,13,1,42,30,11,15,0,56,1,0,24,30,0.442308,0.557692,2,6
2020020244,2021-03-07,2,BOS,0,1,N.J,34,10,10,0,54,21,9,9,1,40,34,10,10,0,54,21,9,9,1,40,0,1,40,25,0.54,0.46,6,4
2020020245,2021-02-15,2,BUF,1,3,NYI,19,8,11,0,38,23,13,10,2,48,19,8,11,0,38,23,13,10,2,48,0,1,21,29,0.461538,0.538462,4,4
2020020246,2021-02-15,2,DET,2,3,CHI,25,18,7,2,52,16,11,9,3,39,24,17,7,2,50,13,9,9,2,33,0,1,29,24,0.555556,0.444444,6,4
2020020247,2021-02-15,2,TOR,5,6,OTT,28,14,9,4,55,23,14,16,5,58,26,14,8,4,52,22,13,15,4,54,1,0,38,31,0.492063,0.507937,11,9
2020020248,2021-02-15,2,EDM,5,6,WPG,35,12,13,4,64,16,6,12,5,39,35,12,13,4,64,16,6,12,5,39,0,1,45,24,0.5,0.5,9,9
2020020249,2021-02-15,2,VAN,3,4,CGY,23,12,10,0,45,18,7,14,3,42,23,12,10,0,45,18,7,14,3,42,1,0,33,27,0.610169,0.389831,10,14
2020020250,2021-03-07,2,DAL,3,4,NSH,30,9,13,3,55,14,6,11,3,34,27,8,12,2,49,13,6,7,1,27,0,1,38,20,0.5,0.5,17,13
2020020251,2021-02-15,2,ARI,1,0,STL,14,6,8,1,29,19,12,14,0,45,14,6,8,1,29,19,12,14,0,45,1,0,19,24,0.489362,0.510638,4,8
2020020252,2021-02-15,2,S.J,3,2,ANA,22,9,11,2,44,25,17,15,2,59,22,9,11,2,44,25,17,15,2,59,0,1,29,28,0.55,0.45,2,4
2020020253,2021-02-16,2,BUF,0,3,NYI,18,13,18,0,49,17,9,11,3,40,18,13,18,0,49,17,9,11,3,40,0,1,20,24,0.478261,0.521739,4,4
2020020254,2021-04-22,2,NYR,2,3,PHI,27,11,10,2,50,24,7,13,1,45,27,11,10,2,50,22,7,13,1,43,1,0,35,36,0.485294,0.514706,12,6
2020020255,2021-02-15,2,CAR,7,3,CBJ,25,13,10,5,53,32,9,9,3,53,25,13,10,5,53,32,9,9,3,53,0,1,34,40,0.571429,0.428571,6,4
2020020256,2021-02-15,2,T.B,4,6,FLA,25,13,9,4,51,10,7,7,6,30,25,13,9,4,51,10,5,7,5,27,1,0,31,21,0.546875,0.453125,16,18
2020020257,2021-02-16,2,PIT,1,3,WSH,18,7,9,1,35,22,5,5,3,35,18,7,9,1,35,23,5,6,3,37,0,1,27,42,0.5,0.5,10,6
2020020258,2021-03-21,2,DAL,3,4,NSH,26,16,12,4,58,20,15,7,4,46,22,12,11,3,48,16,14,6,2,38,1,0,30,22,0.493151,0.506849,4,4
2020020259,2021-02-16,2,VGK,2,3,COL,24,13,20,1,58,21,9,18,3,51,24,13,20,1,58,21,9,18,3,51,0,1,29,25,0.509434,0.490566,11,9
2020020260,2021-02-16,2,L.A,4,0,MIN,22,12,10,3,47,25,7,11,0,43,22,12,10,3,47,25,7,11,0,43,1,0,29,28,0.55,0.45,6,6
2020020261,2021-02-17,2,DET,0,2,CHI,19,12,7,0,38,22,7,8,1,38,19,12,7,0,38,21,7,5,1,34,0,1,29,26,0.680851,0.319149,8,8
2020020262,2021-02-17,2,TOR,2,1,OTT,22,6,3,2,33,25,12,13,1,51,22,6,3,2,33,25,12,13,1,51,1,0,28,28,0.518519,0.481481,6,6
2020020263,2021-02-17,2,CGY,1,5,VAN,31,17,12,1,61,25,6,7,5,43,31,17,12,1,61,24,6,7,5,42,0,1,36,33,0.354167,0.645833,2,4
2020020264,2021-02-17,2,EDM,3,2,WPG,12,4,8,2,26,23,7,17,1,48,12,4,8,2,26,23,7,17,0,47,1,0,30,35,0.551724,0.448276,20,12
2020020265,2021-02-18,2,BOS,2,3,N.J,21,8,13,0,42,21,5,13,2,41,19,8,12,0,39,20,4,12,1,37,0,1,27,26,0.607143,0.392857,12,10
2020020266,2021-02-18,2,PHI,2,3,NYR,17,7,20,3,47,22,4,12,3,41,14,6,20,2,42,21,4,12,1,38,1,0,22,33,0.451613,0.548387,10,10
2020020267,2021-02-18,2,PIT,4,1,NYI,22,7,13,4,46,25,5,13,0,43,21,7,13,4,45,25,5,13,0,43,1,0,37,32,0.518519,0.481481,21,33
2020020268,2021-02-18,2,CBJ,3,0,NSH,19,11,6,3,39,32,12,15,0,59,19,11,6,3,39,32,12,15,0,59,1,0,22,32,0.423077,0.576923,2,0
2020020269,2021-02-18,2,STL,3,2,S.J,36,6,15,1,58,29,9,4,2,44,29,6,15,1,51,28,9,4,2,43,1,0,45,32,0.576923,0.423077,2,8
2020020270,2021-02-18,2,TOR,7,3,OTT,18,6,6,5,35,28,18,11,3,60,18,6,6,5,35,28,18,11,3,60,1,0,31,37,0.537037,0.462963,4,6
2020020271,2021-03-02,2,DAL,0,2,T.B,24,13,13,0,50,11,15,10,1,37,24,13,13,0,50,11,15,10,1,37,0,1,28,19,0.413043,0.586957,15,11
2020020272,2021-02-18,2,ARI,2,3,L.A,17,6,5,4,32,23,8,4,5,40,13,4,5,2,24,21,8,4,2,35,0,1,22,29,0.5,0.5,6,6
2020020273,2021-02-18,2,ANA,1,3,MIN,13,14,11,1,39,18,9,8,3,38,12,14,11,1,38,18,9,8,3,38,0,1,17,27,0.510204,0.489796,12,6
2020020274,2021-02-19,2,CAR,5,3,CHI,22,18,11,3,54,23,12,6,2,43,22,18,10,3,53,23,12,6,2,43,1,0,38,29,0.508772,0.491228,8,8
2020020275,2021-02-19,2,DET,2,7,FLA,24,9,4,2,39,29,4,9,6,48,24,9,4,2,39,29,4,9,6,48,0,1,32,39,0.569231,0.430769,4,8
2020020276,2021-02-19,2,CGY,1,2,EDM,17,12,12,1,42,21,9,7,2,39,17,12,12,1,42,21,8,7,2,38,0,1,21,25,0.540541,0.459459,4,6
2020020277,2021-02-19,2,VAN,0,2,WPG,24,15,14,0,53,22,7,6,2,37,23,15,13,0,51,22,7,6,2,37,0,1,29,31,0.468085,0.531915,16,16
2020020278,2021-02-20,2,N.J,2,3,BUF,22,6,14,1,43,25,11,3,2,41,22,6,14,1,43,25,11,3,2,41,0,1,27,29,0.428571,0.571429,2,6
2020020279,2021-02-20,2,WSH,1,4,NYR,21,9,9,1,40,17,6,10,2,35,21,9,9,1,40,17,6,10,2,35,0,1,27,24,0.428571,0.571429,10,8
2020020280,2021-05-06,2,CAR,1,2,CHI,34,16,16,0,66,24,12,13,2,51,33,15,16,0,64,24,12,13,1,50,1,0,37,27,0.59322,0.40678,2,2
2020020281,2021-02-20,2,PIT,3,2,NYI,14,7,16,2,39,31,7,14,2,54,14,7,16,2,39,31,7,14,2,54,1,0,18,35,0.396226,0.603774,2,2
2020020282,2021-02-20,2,CBJ,2,4,NSH,19,5,6,1,31,34,15,13,3,65,19,5,6,1,31,34,15,13,3,65,0,1,23,45,0.390625,0.609375,13,7
2020020283,2021-02-20,2,STL,4,5,S.J,27,8,15,4,54,22,8,13,5,48,27,8,14,4,53,22,8,13,5,48,0,1,32,27,0.527273,0.472727,2,8
2020020284,2021-02-20,2,MTL,3,5,TOR,27,7,11,3,48,21,5,10,2,38,27,7,11,3,48,20,5,10,2,37,0,1,33,27,0.482759,0.517241,10,4
2020020285,2021-02-20,2,EDM,7,1,CGY,11,7,9,4,31,31,11,9,0,51,11,7,9,4,31,31,11,9,0,51,1,0,24,44,0.41791,0.58209,15,15
2020020286,2021-03-16,2,DAL,3,4,T.B,20,12,9,3,44,29,10,12,4,55,17,10,9,2,38,26,9,10,2,47,0,1,27,36,0.521739,0.478261,4,6
2020020287,2021-02-20,2,COL,3,2,VGK,26,12,10,3,51,23,10,11,2,46,25,11,8,2,46,21,9,10,2,42,1,0,39,29,0.506494,0.493506,10,12
2020020288,2021-02-20,2,ARI,2,4,L.A,16,11,18,0,45,18,3,9,2,32,16,11,18,0,45,18,3,9,2,32,0,1,24,23,0.357143,0.642857,6,8
2020020289,2021-02-20,2,ANA,1,5,MIN,23,17,10,1,51,21,7,10,4,42,23,17,10,1,51,21,7,10,4,42,0,1,27,29,0.393443,0.606557,6,8
2020020290,2021-02-21,2,BOS,7,3,PHI,24,16,7,6,53,14,15,14,2,45,24,16,7,6,53,14,15,14,2,45,1,0,35,19,0.518519,0.481481,6,6
2020020291,2021-03-20,2,WSH,1,3,NYR,23,12,20,1,56,18,5,5,3,31,23,12,20,1,56,18,5,5,3,31,0,1,29,25,0.571429,0.428571,6,8
2020020292,2021-02-20,2,DET,2,1,FLA,25,10,9,2,46,30,10,15,0,55,25,10,9,2,46,30,10,15,0,55,0,1,27,39,0.545455,0.454545,6,4
2020020293,2021-02-21,2,OTT,3,2,MTL,25,6,10,3,44,27,10,15,2,54,19,4,8,2,33,27,8,15,2,52,0,1,39,32,0.548387,0.451613,8,10
2020020294,2021-02-21,2,VAN,3,4,WPG,25,11,14,2,52,23,4,8,3,38,25,10,14,2,51,23,4,8,2,37,1,0,34,31,0.576271,0.423729,11,13
2020020295,2021-02-23,2,N.J,1,4,BUF,37,9,13,1,60,30,8,9,3,50,37,9,13,1,60,30,8,9,3,50,0,1,42,37,0.5,0.5,4,4
2020020296,2021-02-24,2,T.B,3,0,CAR,23,3,5,2,33,23,6,12,0,41,23,3,5,2,33,23,6,12,0,41,1,0,28,25,0.357143,0.642857,4,2
2020020297,2021-02-22,2,STL,0,3,L.A,29,4,10,0,43,21,10,10,2,43,29,4,10,0,43,21,10,10,2,43,0,1,31,31,0.595745,0.404255,4,2
2020020298,2021-02-22,2,TOR,0,3,CGY,23,16,8,0,47,19,6,6,1,32,23,16,8,0,47,19,6,6,1,32,0,1,34,33,0.392857,0.607143,10,14
2020020299,2021-02-22,2,COL,0,3,VGK,29,5,17,0,51,21,6,9,2,38,28,5,17,0,50,21,5,9,2,37,0,1,34,28,0.55814,0.44186,8,4
2020020300,2021-02-22,2,ARI,4,3,ANA,18,6,6,2,32,16,9,10,2,37,18,6,6,2,32,15,9,10,2,36,0,1,25,28,0.46875,0.53125,24,22
2020020301,2021-03-02,2,N.J,1,2,NYI,21,10,12,1,44,16,14,7,2,39,21,10,12,1,44,16,14,7,2,39,0,1,29,20,0.553846,0.446154,2,8
2020020302,2021-02-23,2,WSH,2,3,PIT,20,11,13,2,46,30,10,16,2,58,20,10,13,2,45,30,10,16,1,57,0,1,22,37,0.444444,0.555556,4,4
2020020303,2021-02-24,2,FLA,0,3,DAL,34,7,10,0,51,19,6,6,3,34,32,7,10,0,49,19,6,6,3,34,0,1,43,26,0.492537,0.507463,10,8
2020020304,2021-02-23,2,CBJ,5,6,CHI,23,8,7,2,40,24,8,13,4,49,15,4,7,2,28,22,5,13,3,43,0,1,30,34,0.460317,0.539683,10,10
2020020305,2021-02-23,2,DET,0,2,NSH,24,7,15,0,46,26,9,13,0,48,24,7,15,0,46,26,9,13,0,48,0,1,24,33,0.460317,0.539683,8,2
2020020306,2021-02-23,2,OTT,5,4,MTL,24,16,13,4,57,31,17,12,4,64,21,14,13,2,50,27,16,10,4,57,1,0,39,36,0.492063,0.507937,11,13
2020020307,2021-02-23,2,VAN,3,4,EDM,24,9,14,3,50,23,14,13,3,53,24,9,14,3,50,23,14,13,3,53,1,0,33,29,0.578125,0.421875,8,4
2020020308,2021-02-24,2,PHI,4,3,NYR,20,10,13,2,45,16,10,9,1,36,19,10,13,2,44,16,10,9,1,36,1,0,39,27,0.636364,0.363636,10,16
2020020309,2021-02-24,2,STL,1,2,L.A,28,6,4,1,39,18,13,10,2,43,26,6,4,1,37,18,13,10,2,43,0,1,36,20,0.592593,0.407407,2,8
2020020310,2021-02-24,2,TOR,2,1,CGY,33,14,14,2,63,18,8,10,1,37,31,13,12,1,57,17,8,10,1,36,0,1,39,22,0.612245,0.387755,6,10
2020020311,2021-02-24,2,ARI,4,3,ANA,23,9,14,5,51,27,13,14,3,57,20,9,12,3,44,22,11,14,2,49,0,1,28,35,0.571429,0.428571,6,6
2020020312,2021-02-25,2,NYI,7,2,BOS,25,6,11,6,48,33,8,6,2,49,25,6,11,6,48,33,8,6,2,49,0,1,37,36,0.469388,0.530612,4,14
2020020313,2021-02-25,2,WSH,5,2,PIT,26,11,16,4,57,20,13,3,1,37,26,11,16,4,57,20,13,3,1,37,1,0,35,28,0.614035,0.385965,8,6
2020020314,2021-02-25,2,T.B,3,1,CAR,17,6,7,3,33,23,7,8,1,39,15,6,6,3,30,22,7,7,1,37,0,1,22,32,0.446154,0.553846,12,12
2020020315,2021-02-25,2,FLA,3,2,DAL,32,11,7,3,53,32,2,10,1,45,32,11,7,3,53,32,2,10,1,45,0,1,35,39,0.442623,0.557377,4,2
2020020316,2021-02-25,2,CBJ,0,2,CHI,25,14,12,0,51,22,8,13,2,45,25,14,12,0,51,22,8,13,2,45,0,1,26,27,0.666667,0.333333,2,4
2020020317,2021-02-25,2,DET,5,2,NSH,25,9,12,5,51,33,10,6,1,50,22,8,11,5,46,33,9,6,1,49,1,0,32,39,0.578947,0.421053,8,8
2020020318,2021-02-25,2,OTT,6,1,CGY,25,12,12,6,55,29,12,18,1,60,25,12,12,6,55,29,12,18,1,60,1,0,31,30,0.471698,0.528302,0,0
2020020319,2021-02-25,2,WPG,6,3,MTL,17,15,7,5,44,18,15,8,2,43,17,15,7,5,44,18,15,8,2,43,0,1,30,21,0.596154,0.403846,9,13
2020020320,2021-02-25,2,VAN,0,3,EDM,25,11,13,0,49,19,5,12,1,37,25,11,13,0,49,19,5,12,1,37,0,1,32,34,0.431373,0.568627,10,8
2020020321,2021-02-26,2,ARI,2,3,COL,15,10,12,2,39,20,21,8,2,51,14,10,12,2,38,20,21,8,2,51,0,1,18,29,0.413793,0.586207,13,11
2020020322,2021-02-27,2,BUF,0,3,PHI,21,12,7,0,40,28,7,9,3,47,21,12,7,0,40,28,7,9,3,47,0,1,23,39,0.377049,0.622951,6,6
2020020323,2021-02-26,2,NYR,6,2,BOS,23,15,9,5,52,25,10,11,2,48,23,15,9,4,51,23,10,11,2,46,1,0,34,33,0.507937,0.492063,8,10
2020020324,2021-02-26,2,MIN,3,1,L.A,21,18,8,3,50,23,7,15,1,46,21,18,8,3,50,23,7,15,1,46,1,0,30,28,0.436364,0.563636,6,6
2020020325,2021-04-24,2,ANA,1,5,VGK,16,17,14,1,48,20,10,5,5,40,15,17,14,1,47,20,10,5,5,40,0,1,24,31,0.596774,0.403226,6,4
2020020326,2021-03-08,2,S.J,3,2,STL,14,7,15,2,38,21,8,15,1,45,14,7,15,0,36,21,8,15,1,45,0,1,20,26,0.428571,0.571429,13,9
2020020327,2021-02-27,2,N.J,2,5,WSH,21,10,13,1,45,19,10,10,5,44,21,10,13,1,45,19,10,10,5,44,0,1,24,24,0.491525,0.508475,4,6
2020020328,2021-02-27,2,NYI,3,4,PIT,22,10,18,2,52,21,16,11,3,51,20,10,18,2,50,19,16,11,2,48,1,0,27,31,0.537037,0.462963,10,2
2020020329,2021-02-27,2,T.B,5,0,DAL,12,5,6,2,25,14,7,9,0,30,11,5,6,2,24,12,6,9,0,27,1,0,21,20,0.452381,0.547619,19,11
2020020330,2021-02-27,2,FLA,3,4,CAR,23,9,7,4,43,22,7,6,4,39,20,9,7,2,38,18,5,6,1,30,0,1,31,33,0.472222,0.527778,6,8
2020020331,2021-02-27,2,CHI,3,5,DET,33,13,20,3,69,25,7,7,4,43,33,13,20,3,69,25,7,7,4,43,0,1,36,32,0.411765,0.588235,2,2
2020020332,2021-02-27,2,NSH,2,1,CBJ,27,8,15,2,52,23,4,9,1,37,27,8,15,2,52,23,4,9,1,37,0,1,33,30,0.509091,0.490909,6,8
2020020333,2021-02-27,2,OTT,3,6,CGY,25,8,10,0,43,27,8,17,4,56,25,8,10,0,43,27,8,17,4,56,0,1,34,38,0.486486,0.513514,15,17
2020020334,2021-02-27,2,WPG,2,1,MTL,14,8,6,1,29,37,17,15,1,70,11,6,6,0,23,36,17,14,1,68,1,0,21,41,0.529412,0.470588,4,6
2020020335,2021-02-27,2,EDM,0,4,TOR,30,16,12,0,58,25,5,5,3,38,30,16,12,0,58,25,5,5,3,38,0,1,30,29,0.480769,0.519231,2,0
2020020336,2021-02-27,2,MIN,4,3,L.A,25,7,12,4,48,23,11,16,1,51,23,7,12,3,45,22,10,16,1,49,1,0,42,28,0.442308,0.557692,8,6
2020020337,2021-02-27,2,ARI,2,6,COL,22,8,5,2,37,31,10,12,5,58,22,8,5,2,37,31,10,12,5,58,0,1,25,41,0.433962,0.566038,6,4
2020020338,2021-02-27,2,ANA,2,3,VGK,28,15,13,2,58,21,14,22,3,60,21,14,13,2,50,18,11,22,2,53,1,0,30,27,0.576271,0.423729,6,4
2020020339,2021-02-27,2,S.J,6,7,STL,27,11,11,4,53,21,4,11,6,42,25,11,11,4,51,21,4,11,6,42,1,0,40,31,0.327869,0.672131,6,14
2020020340,2021-02-28,2,BUF,0,3,PHI,20,9,6,0,35,28,9,4,3,44,20,9,6,0,35,28,9,4,3,44,0,1,28,38,0.404762,0.595238,4,6
2020020341,2021-02-28,2,NYI,2,0,PIT,22,8,9,0,39,13,11,9,0,33,22,8,9,0,39,13,11,9,0,33,1,0,30,20,0.555556,0.444444,4,10
2020020342,2021-02-28,2,NYR,1,4,BOS,17,9,13,1,40,32,10,12,3,57,17,9,12,1,39,32,9,11,2,54,0,1,21,36,0.45098,0.54902,21,15
2020020343,2021-02-28,2,CHI,7,2,DET,22,7,12,6,47,43,8,13,1,65,20,6,11,6,43,39,8,13,1,61,1,0,32,46,0.5,0.5,6,6
2020020344,2021-02-28,2,NSH,3,1,CBJ,24,17,8,1,50,26,9,7,1,43,24,17,8,1,50,26,9,7,1,43,0,1,29,29,0.54,0.46,16,12
2020020345,2021-03-01,2,WPG,0,4,VAN,26,11,14,0,51,14,9,5,3,31,26,11,14,0,51,14,9,5,3,31,0,1,27,19,0.537037,0.462963,4,2
2020020346,2021-02-28,2,N.J,2,3,WSH,16,14,12,2,44,18,8,5,3,34,16,14,12,2,44,18,8,5,3,34,1,0,21,23,0.327273,0.672727,11,11
2020020347,2021-04-29,2,T.B,3,0,DAL,21,7,7,2,37,20,7,14,0,41,21,7,7,2,37,20,7,14,0,41,1,0,28,20,0.382979,0.617021,4,2
2020020348,2021-03-01,2,FLA,2,3,CAR,37,5,8,2,52,18,11,9,2,40,36,5,7,2,50,18,11,9,1,39,0,1,46,31,0.490909,0.509091,8,8
2020020349,2021-03-01,2,OTT,5,1,CGY,26,19,12,5,62,26,4,18,0,48,25,18,12,5,60,24,4,17,0,45,1,0,36,28,0.448276,0.551724,8,4
2020020350,2021-03-01,2,EDM,0,3,TOR,28,9,12,0,49,14,6,7,2,29,27,9,12,0,48,11,6,7,2,26,0,1,31,23,0.577778,0.422222,38,23
2020020351,2021-03-01,2,VGK,5,4,MIN,27,16,18,3,64,25,6,11,4,46,27,16,17,2,62,25,6,11,4,46,1,0,39,30,0.603448,0.396552,0,6
2020020352,2021-03-01,2,ANA,4,5,STL,18,10,8,3,39,23,9,10,3,45,18,10,8,3,39,23,9,10,3,45,1,0,33,35,0.484848,0.515152,6,8
2020020353,2021-03-01,2,S.J,6,2,COL,17,7,7,5,36,21,15,12,1,49,17,7,7,4,35,18,15,11,1,45,0,1,27,35,0.411765,0.588235,10,8
2020020354,2021-03-02,2,NYR,3,2,BUF,14,8,8,3,33,19,20,16,2,57,14,8,8,3,33,19,20,16,2,57,1,0,19,24,0.409091,0.590909,7,9
2020020355,2021-03-02,2,PIT,5,2,PHI,16,5,12,4,37,26,6,17,2,51,15,4,11,4,34,27,6,17,2,52,0,1,27,42,0.37931,0.62069,10,6
2020020356,2021-03-02,2,CBJ,4,1,DET,24,8,11,2,45,12,7,9,0,28,23,7,10,2,42,11,7,8,0,26,1,0,36,20,0.431034,0.568966,6,10
2020020357,2021-03-02,2,MTL,3,1,OTT,21,9,21,1,52,20,7,8,1,36,21,9,21,1,52,20,7,8,1,36,1,0,33,27,0.444444,0.555556,6,6
2020020358,2021-03-02,2,WPG,5,2,VAN,32,9,14,4,59,25,11,13,1,50,32,9,14,4,59,25,11,13,1,50,1,0,39,33,0.423077,0.576923,4,6
2020020359,2021-03-03,2,BOS,1,2,WSH,21,12,10,1,44,25,18,7,2,52,13,12,10,1,36,17,16,7,1,41,1,0,19,28,0.517241,0.482759,6,6
2020020360,2021-03-03,2,EDM,1,6,TOR,23,13,20,1,57,16,9,6,4,35,23,13,20,1,57,16,9,6,4,35,0,1,27,32,0.425926,0.574074,10,0
2020020361,2021-03-03,2,VGK,5,1,MIN,19,10,15,5,49,28,4,12,1,45,19,10,15,5,49,28,4,12,1,45,1,0,28,37,0.542373,0.457627,8,6
2020020362,2021-03-03,2,ANA,2,3,STL,23,13,11,2,49,18,8,12,0,38,23,13,11,2,49,18,8,12,0,38,0,1,29,21,0.491803,0.508197,6,6
2020020363,2021-03-03,2,S.J,0,4,COL,22,9,8,0,39,23,14,15,3,55,22,9,8,0,39,23,14,15,3,55,0,1,26,38,0.396226,0.603774,14,6
2020020364,2021-02-16,2,NYR,2,5,N.J,35,11,17,2,65,32,12,15,4,63,35,11,17,2,65,32,12,15,4,63,0,1,39,37,0.493151,0.506849,9,5
2020020365,2021-03-04,2,CAR,5,2,DET,21,11,14,4,50,23,12,10,1,46,21,11,14,4,50,23,12,10,1,46,0,1,32,35,0.573333,0.426667,8,4
2020020366,2021-03-04,2,PIT,3,4,PHI,25,4,7,3,39,24,10,6,3,43,25,4,7,3,39,24,9,6,3,42,1,0,29,35,0.5,0.5,4,4
2020020367,2021-03-04,2,CHI,2,3,T.B,32,10,28,1,71,30,4,19,2,55,29,9,28,1,67,26,3,17,1,47,1,0,37,34,0.4,0.6,2,4
2020020368,2021-03-04,2,NSH,4,5,FLA,27,16,11,4,58,28,8,9,3,48,27,16,11,4,58,28,8,9,3,48,0,1,35,38,0.641791,0.358209,8,4
2020020369,2021-03-04,2,MTL,3,4,WPG,30,11,19,2,62,21,9,13,4,47,26,11,19,2,58,17,9,13,3,42,0,1,36,27,0.588235,0.411765,4,2
2020020370,2021-03-04,2,CGY,7,3,OTT,20,5,8,7,40,23,9,8,2,42,18,5,8,7,38,23,9,8,2,42,1,0,29,32,0.473684,0.526316,12,2
2020020371,2021-03-04,2,VAN,3,1,TOR,25,7,12,2,46,25,8,15,1,49,25,7,12,2,46,25,8,15,1,49,1,0,28,32,0.54,0.46,4,2
2020020372,2021-03-04,2,DAL,2,3,CBJ,18,13,19,2,52,16,10,11,3,40,18,13,19,2,52,16,10,11,3,40,0,1,24,22,0.553191,0.446809,4,4
2020020373,2021-03-05,2,BOS,5,1,WSH,16,9,6,5,36,22,3,7,1,33,16,9,6,5,36,22,3,7,1,33,1,0,25,32,0.527273,0.472727,26,14
2020020374,2021-03-06,2,N.J,3,6,NYR,22,15,9,3,49,17,2,5,5,29,22,15,9,3,49,17,2,5,5,29,0,1,27,28,0.542373,0.457627,10,2
2020020375,2021-03-06,2,NYI,5,2,BUF,24,10,10,5,49,19,14,13,2,48,24,10,10,5,49,18,14,13,2,47,0,1,29,22,0.488372,0.511628,2,0
2020020376,2021-03-05,2,CHI,4,3,T.B,18,5,14,2,39,28,13,19,2,62,14,5,14,2,35,25,12,18,2,57,0,1,27,42,0.557377,0.442623,12,10
2020020377,2021-03-05,2,COL,3,2,ANA,30,15,13,3,61,23,5,9,2,39,29,15,12,2,58,22,4,9,2,37,0,1,34,28,0.454545,0.545455,4,6
2020020378,2021-03-05,2,ARI,1,5,MIN,20,10,12,1,43,13,16,4,5,38,18,10,12,1,41,13,16,4,5,38,0,1,25,27,0.57971,0.42029,8,6
2020020379,2021-03-05,2,L.A,2,3,STL,21,4,8,1,34,15,9,12,2,38,22,4,8,1,35,15,9,11,1,36,0,1,30,22,0.456522,0.543478,6,8
2020020380,2021-03-05,2,S.J,4,5,VGK,20,5,11,3,39,14,4,17,5,40,19,5,11,3,38,14,4,16,4,38,0,1,29,27,0.428571,0.571429,13,15
2020020381,2021-03-06,2,NSH,2,6,FLA,26,13,16,1,56,13,8,9,5,35,26,13,16,1,56,13,8,9,5,35,1,0,30,32,0.53125,0.46875,13,9
2020020382,2021-03-06,2,MTL,7,1,WPG,20,9,12,7,48,25,11,13,0,49,20,9,12,7,48,25,11,13,0,49,1,0,28,29,0.571429,0.428571,4,2
2020020383,2021-03-06,2,EDM,3,2,CGY,25,6,15,3,49,28,7,6,1,42,25,6,15,3,49,28,7,6,1,42,0,1,33,36,0.557692,0.442308,16,14
2020020384,2021-03-06,2,VAN,4,2,TOR,23,10,13,2,48,36,12,21,2,71,23,10,13,2,48,36,12,21,2,71,1,0,31,39,0.561404,0.438596,2,4
2020020385,2021-03-06,2,DAL,5,0,CBJ,15,7,13,3,38,20,8,7,0,35,15,7,13,3,38,21,8,6,0,35,1,0,26,21,0.577778,0.422222,16,20
2020020386,2021-03-06,2,COL,4,5,ANA,23,6,18,3,50,20,3,18,3,44,23,6,18,3,50,20,3,18,3,44,0,1,33,27,0.507042,0.492958,4,6
2020020387,2021-03-06,2,ARI,5,2,MIN,20,7,18,4,49,30,11,8,2,51,20,7,18,4,49,29,11,8,2,50,0,1,31,34,0.565217,0.434783,9,13
2020020388,2021-03-06,2,L.A,4,3,STL,25,9,16,3,53,21,5,2,2,30,22,9,15,2,48,20,5,2,2,29,0,1,34,25,0.469388,0.530612,4,6
2020020389,2021-03-06,2,S.J,0,4,VGK,22,13,12,0,47,26,12,16,4,58,22,13,12,0,47,26,12,16,4,58,0,1,24,32,0.468085,0.531915,4,2
2020020390,2021-04-05,2,BOS,2,3,PHI,23,13,9,1,46,26,9,9,2,46,22,13,8,1,44,23,9,8,1,41,0,1,29,32,0.56338,0.43662,6,4
2020020391,2021-03-07,2,NYI,5,2,BUF,25,5,10,5,45,23,11,9,2,45,25,5,9,5,44,23,11,9,2,45,1,0,30,26,0.566038,0.433962,2,4
2020020392,2021-02-21,2,WSH,4,3,N.J,34,14,9,1,58,19,19,13,2,53,34,14,9,1,58,19,19,13,2,53,0,1,41,26,0.540984,0.459016,6,8
2020020393,2021-03-07,2,PIT,5,1,NYR,13,4,9,5,31,22,3,9,1,35,13,4,9,5,31,22,3,9,1,35,0,1,24,24,0.54902,0.45098,2,6
2020020394,2021-03-07,2,CHI,3,6,T.B,17,6,11,2,36,27,7,8,2,44,17,4,11,2,34,26,7,8,2,43,1,0,25,39,0.542373,0.457627,18,10
2020020395,2021-03-07,2,CGY,3,4,OTT,20,13,18,2,53,13,4,9,3,29,17,11,15,2,45,12,4,9,2,27,0,1,34,22,0.603175,0.396825,11,25
2020020396,2021-03-08,2,EDM,3,2,OTT,30,12,15,2,59,25,13,19,2,59,30,12,15,2,59,25,13,19,2,59,0,1,37,28,0.596154,0.403846,11,23
2020020397,2021-03-08,2,VAN,2,1,MTL,26,11,9,2,48,29,13,22,0,64,22,9,9,1,41,25,13,22,0,60,0,1,29,30,0.578947,0.421053,4,6
2020020398,2021-03-08,2,MIN,2,0,VGK,19,3,13,2,37,22,4,11,0,37,19,2,13,2,36,21,4,9,0,34,1,0,21,26,0.42623,0.57377,6,4
2020020399,2021-03-08,2,COL,2,3,ARI,29,10,14,1,54,10,5,10,2,27,28,9,14,0,51,10,5,10,2,27,0,1,35,14,0.559322,0.440678,4,8
2020020400,2021-03-08,2,ANA,6,5,L.A,15,10,10,5,40,21,8,13,3,45,14,9,10,4,37,20,8,13,3,44,1,0,25,26,0.46,0.54,8,2
2020020401,2021-03-09,2,NYI,2,1,BOS,24,8,16,2,50,30,12,11,1,54,21,7,16,0,44,23,11,11,0,45,0,1,27,33,0.465116,0.534884,6,6
2020020402,2021-03-09,2,PHI,5,4,BUF,26,14,20,5,65,17,6,7,4,34,23,13,19,3,58,13,6,6,4,29,1,0,33,20,0.566038,0.433962,4,8
2020020403,2021-03-09,2,WSH,5,4,N.J,23,10,15,4,52,23,3,9,4,39,22,10,14,2,48,23,3,9,4,39,1,0,30,31,0.471429,0.528571,8,6
2020020404,2021-03-09,2,CAR,3,2,NSH,25,7,17,1,50,15,15,13,2,45,25,6,17,0,48,14,12,12,2,40,0,1,35,23,0.609756,0.390244,10,12
2020020405,2021-03-09,2,PIT,4,2,NYR,18,8,10,3,39,29,6,22,1,58,18,8,10,3,39,29,6,22,1,58,0,1,27,35,0.453125,0.546875,6,2
2020020406,2021-03-09,2,CBJ,2,4,FLA,26,13,8,2,49,26,9,13,2,50,26,13,8,2,49,26,9,13,2,50,0,1,40,33,0.403846,0.596154,8,6
2020020407,2021-03-09,2,DET,3,4,T.B,18,7,10,2,37,18,9,7,3,37,17,6,10,2,35,18,9,7,2,36,1,0,23,29,0.5,0.5,11,11
2020020408,2021-03-09,2,TOR,3,4,WPG,35,13,13,2,63,18,11,2,3,34,35,13,13,2,63,17,11,2,3,33,1,0,39,23,0.590909,0.409091,4,4
2020020409,2021-03-09,2,DAL,6,1,CHI,25,8,10,5,48,18,4,9,1,32,25,8,10,5,48,18,4,9,1,32,1,0,37,22,0.614035,0.385965,9,11
2020020410,2021-03-10,2,EDM,7,1,OTT,24,8,7,5,44,20,6,15,1,42,24,8,7,5,44,20,6,15,1,42,1,0,36,22,0.566667,0.433333,2,8
2020020411,2021-03-10,2,VAN,1,5,MTL,19,7,8,0,34,33,10,17,4,64,19,7,8,0,34,33,10,17,4,64,0,1,24,45,0.575758,0.424242,15,11
2020020412,2021-03-10,2,MIN,4,3,VGK,21,9,8,3,41,22,13,19,3,57,21,8,8,3,40,22,12,18,2,54,1,0,31,27,0.508475,0.491525,6,6
2020020413,2021-03-10,2,COL,2,1,ARI,39,13,14,2,68,8,11,15,1,35,37,12,14,1,64,8,11,14,1,34,1,0,46,14,0.478261,0.521739,4,10
2020020414,2021-03-10,2,ANA,1,5,L.A,25,5,13,1,44,27,9,4,3,43,25,5,13,1,44,27,9,4,3,43,0,1,34,37,0.568627,0.431373,8,8
2020020415,2021-03-11,2,BOS,4,0,NYR,21,7,5,2,35,21,18,12,0,51,21,7,5,2,35,21,18,12,0,51,1,0,27,27,0.54717,0.45283,8,4
2020020416,2021-03-11,2,BUF,2,5,PIT,20,10,6,2,38,21,9,9,4,43,20,10,6,2,38,21,9,9,4,43,0,1,23,27,0.6,0.4,19,9
2020020417,2021-03-11,2,NYI,5,3,N.J,22,13,10,5,50,18,4,16,3,41,22,13,9,5,49,18,4,16,3,41,1,0,33,22,0.534884,0.465116,2,10
2020020418,2021-03-11,2,PHI,3,5,WSH,27,8,8,2,45,13,4,7,5,29,24,7,8,1,40,11,2,6,5,24,0,1,33,22,0.55,0.45,13,13
2020020419,2021-03-11,2,CAR,5,1,NSH,17,10,7,2,36,30,12,13,1,56,17,10,7,2,36,30,12,13,1,56,1,0,26,33,0.642857,0.357143,2,6
2020020420,2021-03-11,2,CBJ,4,5,FLA,19,6,11,3,39,23,9,11,4,47,19,6,11,3,39,20,7,11,3,41,1,0,32,32,0.34,0.66,6,6
2020020421,2021-03-11,2,DET,6,4,T.B,11,2,4,6,23,30,12,15,3,60,11,2,5,6,24,29,12,15,3,59,1,0,23,44,0.394366,0.605634,17,13
2020020422,2021-03-11,2,TOR,4,3,WPG,30,17,16,4,67,23,8,5,3,39,29,17,16,3,65,22,8,5,3,38,0,1,38,27,0.557377,0.442623,4,2
2020020423,2021-03-11,2,CGY,2,1,MTL,21,14,9,2,46,14,6,8,1,29,21,14,9,2,46,14,6,8,1,29,1,0,29,18,0.509091,0.490909,9,11
2020020424,2021-03-11,2,DAL,2,4,CHI,23,6,16,2,47,7,8,7,2,24,23,6,16,2,47,7,8,7,2,24,0,1,30,16,0.539683,0.460317,10,10
2020020425,2021-03-12,2,STL,4,5,VGK,16,4,11,2,33,30,13,14,4,61,16,3,11,2,32,29,12,14,4,59,0,1,23,40,0.492308,0.507692,8,6
2020020426,2021-03-12,2,EDM,6,2,OTT,26,14,7,5,52,23,13,16,1,53,26,14,7,5,52,23,13,16,1,53,1,0,37,25,0.555556,0.444444,4,8
2020020427,2021-03-12,2,MIN,4,0,ARI,18,7,14,4,43,20,11,11,0,42,15,6,14,4,39,20,11,11,0,42,1,0,32,25,0.345455,0.654545,8,8
2020020428,2021-03-12,2,COL,2,0,L.A,35,9,22,2,68,13,6,6,0,25,33,9,22,2,66,13,6,6,0,25,1,0,46,18,0.492063,0.507937,11,9
2020020429,2021-03-12,2,ANA,0,6,S.J,33,14,12,0,59,21,9,8,4,42,33,14,12,0,59,21,9,8,4,42,0,1,34,27,0.527273,0.472727,9,7
2020020430,2021-03-13,2,BOS,0,4,NYR,12,4,10,0,26,17,6,12,4,39,10,4,10,0,24,17,6,11,4,38,0,1,18,33,0.576271,0.423729,20,20
2020020431,2021-03-13,2,BUF,0,3,PIT,23,12,9,0,44,27,9,8,2,46,23,12,9,0,44,27,9,8,2,46,0,1,24,34,0.490566,0.509434,4,4
2020020432,2021-03-13,2,N.J,2,3,NYI,18,15,11,2,46,17,3,7,3,30,18,15,11,2,46,17,3,7,3,30,1,0,28,29,0.54,0.46,8,6
2020020433,2021-03-13,2,PHI,4,5,WSH,25,13,18,3,59,15,9,9,4,37,25,13,18,3,59,14,9,9,4,36,0,1,32,23,0.543478,0.456522,4,6
2020020434,2021-03-13,2,T.B,6,3,NSH,19,5,10,5,39,27,13,5,2,47,19,5,10,5,39,27,13,5,2,47,1,0,28,31,0.5,0.5,4,2
2020020435,2021-03-13,2,FLA,4,2,CHI,26,7,9,4,46,22,7,4,2,35,26,7,9,4,46,22,7,4,2,35,0,1,35,32,0.666667,0.333333,8,4
2020020436,2021-03-13,2,CBJ,4,3,DAL,22,13,12,4,51,27,15,21,3,66,18,12,12,3,45,26,14,21,3,64,1,0,26,30,0.588235,0.411765,0,0
2020020437,2021-03-13,2,STL,1,5,VGK,25,3,12,1,41,20,14,15,5,54,25,3,10,1,39,19,14,15,5,53,0,1,35,26,0.490909,0.509091,9,13
2020020438,2021-03-13,2,TOR,2,5,WPG,15,8,10,1,34,21,10,11,3,45,15,8,10,1,34,21,10,10,3,44,0,1,22,32,0.54386,0.45614,10,6
2020020439,2021-03-13,2,CGY,3,1,MTL,29,11,13,2,55,20,14,6,1,41,29,11,13,2,55,20,14,5,0,39,1,0,36,25,0.5,0.5,4,6
2020020440,2021-03-13,2,VAN,2,1,EDM,20,10,14,1,45,25,8,21,0,54,20,10,14,1,45,25,8,21,0,54,1,0,28,35,0.596491,0.403509,8,4
2020020441,2021-03-13,2,ANA,1,3,S.J,20,12,12,1,45,22,10,11,3,46,20,12,12,1,45,22,10,11,3,46,0,1,27,33,0.45,0.55,8,6
2020020442,2021-03-14,2,DET,1,2,CAR,19,6,10,1,36,27,4,10,1,42,19,6,10,1,36,27,4,10,1,42,0,1,26,32,0.436364,0.563636,2,4
2020020443,2021-03-14,2,OTT,4,3,TOR,20,15,9,3,47,31,17,17,3,68,20,15,9,3,47,31,17,17,3,68,1,0,31,36,0.5,0.5,7,21
2020020444,2021-03-14,2,MIN,4,1,ARI,27,13,13,3,56,19,11,13,1,44,27,13,13,3,56,19,11,13,1,44,0,1,34,22,0.526316,0.473684,6,6
2020020445,2021-03-14,2,COL,4,1,L.A,28,7,11,4,50,21,10,13,1,45,27,7,11,4,49,21,10,13,1,45,1,0,41,28,0.538462,0.461538,10,2
2020020446,2021-03-15,2,NYR,4,5,PHI,16,11,13,4,44,19,7,3,3,32,15,10,12,4,41,19,7,2,2,30,0,1,24,30,0.409091,0.590909,12,8
2020020447,2021-04-27,2,WSH,1,0,NYI,31,15,15,1,62,15,8,9,0,32,31,15,15,1,62,15,7,9,0,31,1,0,33,18,0.604167,0.395833,13,11
2020020448,2021-03-15,2,T.B,1,4,NSH,35,7,12,1,55,20,2,6,2,30,34,7,12,1,54,20,2,6,2,30,0,1,39,26,0.509091,0.490909,14,16
2020020449,2021-03-15,2,FLA,6,3,CHI,23,5,9,3,40,21,4,8,3,36,22,5,9,3,39,20,4,8,3,35,0,1,36,29,0.615385,0.384615,10,8
2020020450,2021-03-15,2,PIT,4,1,BOS,17,5,15,3,40,34,10,9,0,53,16,5,14,3,38,34,10,9,0,53,0,1,26,43,0.425926,0.574074,8,8
2020020451,2021-03-14,2,CBJ,1,2,DAL,29,13,13,1,56,32,8,19,2,61,23,10,12,1,46,28,5,15,1,49,0,1,30,35,0.619048,0.380952,2,2
2020020452,2021-03-15,2,OTT,2,3,VAN,41,14,13,2,70,24,9,12,3,48,41,13,13,2,69,24,9,11,2,46,0,1,46,28,0.5,0.5,2,8
2020020453,2021-03-15,2,WPG,2,4,MTL,30,15,12,0,57,22,13,13,3,51,30,15,12,0,57,21,13,13,3,50,0,1,36,31,0.522388,0.477612,8,10
2020020454,2021-03-15,2,CGY,4,3,EDM,21,9,8,4,42,23,13,6,3,45,21,9,8,4,42,23,13,6,3,45,1,0,27,31,0.382979,0.617021,7,11
2020020455,2021-03-15,2,VGK,2,1,S.J,30,8,22,1,61,22,11,16,1,50,30,8,22,1,61,22,11,16,1,50,1,0,36,24,0.483333,0.516667,2,6
2020020456,2021-05-10,2,LAK,1,2,STL,23,9,15,1,48,16,7,14,2,39,23,9,15,1,48,16,7,14,1,38,0,1,27,19,0.354839,0.645161,6,6
2020020457,2021-03-16,2,N.J,3,2,BUF,22,12,6,2,42,30,7,4,2,43,22,12,4,2,40,29,7,4,2,42,1,0,27,35,0.389831,0.610169,6,8
2020020458,2021-03-16,2,WSH,3,1,NYI,18,13,7,1,39,20,15,16,0,51,18,13,7,1,39,20,15,16,0,51,1,0,22,22,0.390244,0.609756,4,8
2020020459,2021-03-16,2,PIT,1,2,BOS,27,4,7,1,39,25,11,13,1,50,25,4,7,1,37,25,11,13,1,50,0,1,35,33,0.418182,0.581818,21,8
2020020460,2021-03-16,2,DET,4,2,CAR,15,6,4,2,27,27,10,11,1,49,15,6,4,2,27,27,10,11,1,49,0,1,28,37,0.457627,0.542373,6,12
2020020461,2021-03-20,2,ANA,1,5,ARI,22,5,12,1,40,23,12,10,4,49,22,5,12,1,40,19,12,9,4,44,0,1,28,28,0.516667,0.483333,4,4
2020020462,2021-03-17,2,NYR,9,0,PHI,16,4,11,7,38,22,12,10,0,44,16,4,11,7,38,22,12,10,0,44,1,0,29,26,0.533333,0.466667,4,8
2020020463,2021-03-17,2,OTT,2,3,VAN,31,21,19,2,73,27,12,7,3,49,24,20,19,2,65,24,10,5,2,41,0,1,32,29,0.396226,0.603774,4,4
2020020464,2021-03-17,2,WPG,4,3,MTL,22,4,10,4,40,29,12,22,3,66,22,4,10,3,39,28,12,22,3,65,1,0,30,36,0.54,0.46,4,4
2020020465,2021-03-17,2,CGY,3,7,EDM,24,8,12,2,46,18,6,4,4,32,24,8,12,2,46,18,6,4,4,32,0,1,33,30,0.446429,0.553571,8,6
2020020466,2021-03-17,2,VGK,5,4,S.J,20,9,13,3,45,25,4,7,3,39,19,9,13,3,44,25,4,7,3,39,1,0,37,33,0.553571,0.446429,16,20
2020020467,2021-03-17,2,L.A,4,1,STL,17,13,5,3,38,19,16,9,1,45,17,13,5,3,38,19,16,9,1,45,1,0,24,20,0.589286,0.410714,7,9
2020020468,2021-03-18,2,BUF,1,4,BOS,20,14,7,0,41,26,8,5,2,41,20,14,7,0,41,26,8,5,2,41,0,1,24,37,0.409836,0.590164,10,2
2020020469,2021-03-18,2,NYI,3,4,PHI,14,7,10,3,34,21,8,14,4,47,14,7,10,3,34,21,8,14,4,47,0,1,25,31,0.587302,0.412698,6,4
2020020470,2021-03-18,2,CAR,2,3,CBJ,23,14,15,1,53,21,8,13,3,45,19,14,15,1,49,20,8,12,2,42,0,1,27,28,0.52381,0.47619,2,6
2020020471,2021-03-18,2,T.B,4,2,CHI,18,7,8,3,36,16,6,6,0,28,18,7,8,3,36,16,6,6,0,28,0,1,23,21,0.571429,0.428571,8,4
2020020472,2021-03-18,2,FLA,1,2,NSH,35,14,11,1,61,22,6,8,2,38,35,14,11,1,61,21,6,8,2,37,1,0,41,27,0.5,0.5,6,6
2020020473,2021-03-18,2,DET,3,2,DAL,13,12,8,3,36,31,6,6,2,45,12,11,8,2,33,31,6,6,2,45,1,0,21,40,0.490196,0.509804,8,4
2020020474,2021-03-18,2,EDM,2,1,WPG,18,8,11,2,39,23,11,11,1,46,18,8,11,2,39,23,11,11,1,46,1,0,21,25,0.568966,0.431034,2,2
2020020475,2021-03-18,2,COL,5,1,MIN,36,12,11,4,63,16,8,6,0,30,36,12,11,4,63,15,8,6,0,29,1,0,55,20,0.553846,0.446154,10,6
2020020476,2021-03-18,2,ANA,3,2,ARI,25,12,15,2,54,20,8,4,2,34,25,12,15,2,54,20,8,4,2,34,0,1,31,25,0.6,0.4,8,6
2020020477,2021-03-20,2,N.J,1,3,PIT,23,9,10,1,43,26,5,1,2,34,23,9,9,1,42,26,5,1,2,34,1,0,25,29,0.428571,0.571429,6,10
2020020478,2021-03-19,2,WSH,2,1,NYR,16,14,15,2,47,29,13,9,0,51,16,14,14,2,46,29,13,9,0,51,0,1,18,33,0.571429,0.428571,8,4
2020020479,2021-03-19,2,MTL,2,3,VAN,25,13,16,0,54,23,8,9,3,43,25,12,15,0,52,23,8,9,2,42,1,0,31,28,0.660714,0.339286,4,8
2020020480,2021-03-19,2,TOR,3,4,CGY,20,10,22,3,55,10,10,7,3,30,20,10,22,3,55,10,10,7,3,30,0,1,27,18,0.509804,0.490196,11,11
2020020481,2021-03-19,2,L.A,2,4,VGK,20,12,12,2,46,26,13,10,4,53,20,12,12,2,46,26,13,10,4,53,0,1,25,33,0.566038,0.433962,4,2
2020020482,2021-03-19,2,S.J,1,2,STL,27,20,14,2,63,29,15,16,2,62,25,19,14,1,59,28,15,15,0,58,1,0,31,34,0.382353,0.617647,14,4
2020020483,2021-04-20,2,BUF,0,2,BOS,26,6,10,0,42,32,9,15,2,58,25,6,10,0,41,30,9,15,2,56,0,1,32,41,0.388889,0.611111,8,12
2020020484,2021-03-20,2,NYI,6,1,PHI,21,8,13,5,47,19,6,10,1,36,21,8,13,5,47,19,6,10,1,36,1,0,28,24,0.604651,0.395349,11,9
2020020485,2021-03-20,2,CAR,2,3,CBJ,32,9,18,3,62,25,7,14,4,50,30,7,18,2,57,23,6,14,2,45,1,0,37,31,0.533333,0.466667,4,4
2020020486,2021-03-20,2,T.B,4,1,CHI,22,6,3,3,34,22,4,13,1,40,22,5,3,2,32,22,4,13,1,40,1,0,29,31,0.509091,0.490909,10,8
2020020487,2021-03-20,2,FLA,2,0,NSH,30,5,13,2,50,18,10,10,0,38,28,4,12,2,46,18,10,10,0,38,1,0,49,21,0.480769,0.519231,8,12
2020020488,2021-03-20,2,DET,0,3,DAL,15,10,10,0,35,25,11,15,2,53,15,10,10,0,35,25,11,15,2,53,0,1,21,33,0.403846,0.596154,6,4
2020020489,2021-03-20,2,MTL,5,4,VAN,37,18,21,5,81,16,7,14,4,41,31,15,21,3,70,10,6,14,3,33,1,0,40,18,0.528302,0.471698,2,2
2020020490,2021-03-20,2,TOR,2,0,CGY,22,13,10,2,47,25,8,14,0,47,22,13,10,2,47,24,8,14,0,46,1,0,33,31,0.457627,0.542373,6,8
2020020491,2021-03-20,2,EDM,4,2,WPG,26,8,20,4,58,24,7,8,1,40,26,8,20,4,58,24,7,8,1,40,0,1,37,31,0.511111,0.488889,6,16
2020020492,2021-03-20,2,COL,6,0,MIN,33,8,12,5,58,19,9,8,0,36,33,8,12,5,58,19,9,8,0,36,1,0,42,31,0.557377,0.442623,8,14
2020020493,2021-03-20,2,S.J,2,5,STL,27,10,13,2,52,15,8,8,4,35,27,10,13,2,52,15,8,8,4,35,1,0,31,21,0.592593,0.407407,6,2
2020020494,2021-04-09,2,N.J,4,6,PIT,23,14,9,4,50,17,7,9,4,37,23,14,9,4,50,17,7,9,4,37,1,0,30,27,0.508475,0.491525,8,2
2020020495,2021-03-21,2,L.A,3,1,VGK,25,5,10,2,42,30,11,16,1,58,25,5,10,2,42,30,11,16,1,58,1,0,31,42,0.584906,0.415094,13,9
2020020496,2021-03-22,2,NYR,5,3,BUF,29,9,15,3,56,13,8,13,3,37,27,9,14,3,53,13,8,13,3,37,0,1,40,19,0.444444,0.555556,6,8
2020020497,2021-03-22,2,CBJ,0,3,CAR,17,10,10,0,37,22,7,9,3,41,17,10,10,0,37,22,7,9,3,41,0,1,19,28,0.510638,0.489362,4,6
2020020498,2021-03-30,2,MTL,4,0,EDM,25,6,14,4,49,14,5,7,0,26,25,6,14,4,49,14,5,7,0,26,1,0,32,17,0.490566,0.509434,11,13
2020020499,2021-03-22,2,OTT,2,1,CGY,19,6,11,2,38,32,11,15,1,59,19,6,11,2,38,32,11,15,1,59,1,0,23,36,0.367347,0.632653,2,4
2020020500,2021-03-22,2,VAN,0,4,WPG,22,17,15,0,54,24,14,17,4,59,22,17,15,0,54,24,14,17,4,59,0,1,22,29,0.464286,0.535714,2,2
2020020501,2021-03-22,2,MIN,2,1,ANA,18,11,8,1,38,21,10,17,1,49,18,11,8,1,38,21,10,17,1,49,0,1,23,25,0.472727,0.527273,6,6
2020020502,2021-03-22,2,ARI,1,5,COL,24,7,10,0,41,26,16,19,5,66,24,7,10,0,41,26,16,19,5,66,0,1,25,35,0.446809,0.553191,6,4
2020020503,2021-03-22,2,S.J,2,1,L.A,16,11,11,2,40,34,8,12,1,55,15,11,11,2,39,34,8,12,1,55,1,0,23,42,0.571429,0.428571,15,9
2020020504,2021-03-23,2,PHI,3,4,N.J,21,6,13,2,42,20,7,12,3,42,21,6,13,2,42,20,7,12,3,42,0,1,33,32,0.567164,0.432836,8,6
2020020505,2021-03-23,2,CHI,3,2,FLA,26,7,16,2,51,28,6,17,1,52,26,7,16,2,51,28,6,17,1,52,1,0,32,35,0.5,0.5,4,6
2020020506,2021-03-23,2,NSH,2,0,DET,31,11,8,1,51,25,7,13,0,45,31,9,8,1,49,23,7,13,0,43,1,0,34,31,0.509434,0.490566,8,6
2020020507,2021-03-23,2,DAL,1,2,T.B,13,13,13,0,39,21,13,15,1,50,12,12,12,0,36,19,13,15,1,48,1,0,17,26,0.476923,0.523077,6,8
2020020508,2021-03-23,2,ARI,5,4,COL,22,9,10,7,48,28,6,17,4,55,19,9,9,4,41,25,5,15,3,48,1,0,32,39,0.520833,0.479167,8,8
2020020509,2021-03-24,2,PIT,5,2,BUF,28,6,12,4,50,24,7,4,2,37,27,6,12,3,48,24,7,4,1,36,1,0,42,28,0.53125,0.46875,6,10
2020020510,2021-05-10,2,MTL,3,4,EDM,24,11,15,3,53,29,5,12,4,50,24,11,14,3,52,28,4,12,3,47,1,0,28,35,0.365385,0.634615,2,4
2020020511,2021-03-24,2,OTT,3,1,CGY,23,12,7,3,45,22,16,18,1,57,23,12,7,2,44,22,16,17,1,56,0,1,31,29,0.605263,0.394737,6,6
2020020512,2021-03-24,2,VAN,1,5,WPG,31,11,17,1,60,22,5,8,3,38,31,11,17,1,60,21,5,8,3,37,0,1,39,36,0.537313,0.462687,11,9
2020020513,2021-03-24,2,MIN,3,2,ANA,19,7,9,2,37,26,14,13,2,55,19,7,9,2,37,26,14,13,2,55,1,0,26,30,0.355932,0.644068,12,26
2020020514,2021-03-24,2,S.J,4,2,L.A,17,12,10,4,43,36,11,14,2,63,17,12,10,4,43,35,11,13,2,61,1,0,28,44,0.482759,0.517241,4,6
2020020515,2021-03-25,2,BOS,3,4,NYI,25,10,10,2,47,18,5,8,4,35,25,10,10,2,47,17,5,8,3,33,1,0,32,27,0.555556,0.444444,2,8
2020020516,2021-03-25,2,PHI,3,8,NYR,32,2,15,1,50,11,6,7,4,28,29,2,14,1,46,11,6,7,4,28,0,1,44,22,0.5,0.5,42,28
2020020517,2021-03-25,2,WSH,4,3,N.J,15,16,10,4,45,18,13,14,2,47,15,16,10,4,45,18,13,14,2,47,0,1,22,24,0.466667,0.533333,6,4
2020020518,2021-03-25,2,CBJ,3,4,CAR,32,10,12,2,56,28,7,11,4,50,32,9,12,2,55,27,7,11,3,48,1,0,36,33,0.45614,0.54386,4,6
2020020519,2021-03-25,2,CHI,3,0,FLA,13,2,7,2,24,28,6,16,0,50,13,2,6,2,23,28,6,16,0,50,1,0,21,41,0.490566,0.509434,17,21
2020020520,2021-03-25,2,NSH,7,1,DET,20,8,10,6,44,15,6,7,0,28,20,8,10,6,44,15,6,7,0,28,1,0,30,21,0.490566,0.509434,8,8
2020020521,2021-03-25,2,OTT,2,3,TOR,25,6,9,1,41,35,13,15,3,66,23,6,8,1,38,32,11,12,2,57,1,0,31,41,0.632353,0.367647,6,6
2020020522,2021-03-25,2,DAL,4,3,T.B,34,11,13,3,61,22,8,12,3,45,34,11,13,3,61,22,8,12,3,45,0,1,41,27,0.537313,0.462687,5,11
2020020523,2021-03-25,2,COL,5,1,VGK,25,8,8,4,45,17,4,18,1,40,25,8,8,4,45,17,4,18,1,40,0,1,32,19,0.433333,0.566667,2,8
2020020524,2021-03-26,2,WSH,4,0,N.J,21,7,8,4,40,19,12,11,0,42,21,7,8,4,40,19,12,11,0,42,1,0,31,24,0.465517,0.534483,6,4
2020020525,2021-03-26,2,STL,1,4,ANA,29,5,8,1,43,19,5,7,4,35,29,5,8,1,43,19,5,7,4,35,0,1,34,24,0.622222,0.377778,12,14
2020020526,2021-05-12,2,MTL,3,4,EDM,24,12,12,2,50,16,10,6,2,34,23,12,12,2,49,16,10,6,1,33,1,0,29,22,0.613636,0.386364,6,2
2020020527,2021-03-26,2,CGY,2,3,WPG,19,8,18,1,46,20,6,9,1,36,18,8,16,1,43,20,6,9,1,36,0,1,27,29,0.5,0.5,12,8
2020020528,2021-03-26,2,ARI,5,2,S.J,21,9,18,4,52,20,3,15,0,38,21,9,18,4,52,20,3,15,0,38,1,0,28,22,0.48,0.52,4,8
2020020529,2021-05-10,2,BOS,3,2,NYI,31,12,12,2,57,16,5,9,1,31,30,11,12,1,54,16,4,9,1,30,1,0,38,18,0.673469,0.326531,6,10
2020020530,2021-03-27,2,PHI,2,1,NYR,30,10,13,1,54,19,8,7,0,34,30,10,13,1,54,19,8,7,0,34,0,1,37,25,0.660377,0.339623,8,6
2020020531,2021-03-27,2,CAR,4,3,T.B,23,8,6,2,39,15,14,10,3,42,23,8,6,2,39,15,14,10,3,42,0,1,40,22,0.4,0.6,10,14
2020020532,2021-03-25,2,PIT,4,0,BUF,23,11,11,2,47,28,14,12,0,54,23,11,11,2,47,28,14,13,0,55,1,0,31,36,0.568966,0.431034,8,8
2020020533,2021-03-27,2,DET,3,1,CBJ,27,11,13,3,54,20,8,10,1,39,25,11,13,3,52,19,8,10,1,38,1,0,34,22,0.520833,0.479167,6,8
2020020534,2021-03-27,2,CHI,1,3,NSH,26,7,15,1,49,28,7,14,3,52,26,7,15,1,49,28,7,14,3,52,0,1,30,34,0.520833,0.479167,0,4
2020020535,2021-03-28,2,STL,2,3,ANA,32,6,13,1,52,20,7,12,3,42,32,6,13,1,52,20,7,12,2,41,1,0,40,24,0.473684,0.526316,2,6
2020020536,2021-03-27,2,TOR,4,3,EDM,20,10,14,4,48,16,5,12,3,36,20,10,13,3,46,15,5,12,3,35,1,0,31,20,0.666667,0.333333,2,4
2020020537,2021-03-27,2,CGY,4,2,WPG,26,15,10,3,54,19,10,9,2,40,26,15,10,3,54,19,10,9,2,40,1,0,33,24,0.482143,0.517857,4,4
2020020538,2021-03-27,2,DAL,3,4,FLA,28,12,15,3,58,20,11,13,2,46,22,11,13,3,49,17,10,12,1,40,0,1,34,28,0.438596,0.561404,6,6
2020020539,2021-03-27,2,COL,2,3,VGK,14,6,17,2,39,19,9,9,2,39,13,6,16,2,37,18,9,9,1,37,1,0,24,34,0.62963,0.37037,13,9
2020020540,2021-03-27,2,ARI,4,0,S.J,15,8,7,3,33,23,14,11,0,48,15,8,7,3,33,23,13,11,0,47,1,0,27,34,0.470588,0.529412,6,29
2020020541,2021-03-28,2,BOS,0,1,N.J,31,8,9,0,48,20,7,10,1,38,31,8,9,0,48,20,7,10,1,38,0,1,40,29,0.642857,0.357143,8,8
2020020542,2021-03-28,2,WSH,5,4,NYR,15,8,5,5,33,15,7,18,3,43,15,8,5,5,33,15,7,18,3,43,1,0,22,20,0.553571,0.446429,8,6
2020020543,2021-02-20,2,CAR,4,0,T.B,21,13,15,4,53,24,12,12,0,48,21,13,15,4,53,24,12,12,0,48,1,0,28,24,0.471698,0.528302,2,4
2020020544,2021-03-28,2,DET,4,1,CBJ,24,12,12,4,52,16,6,19,1,42,22,12,12,4,50,16,6,19,1,42,1,0,29,17,0.44,0.56,4,4
2020020545,2021-03-28,2,CHI,2,3,NSH,26,9,10,2,47,27,7,13,3,50,26,8,10,2,46,25,7,12,3,47,0,1,29,31,0.54717,0.45283,4,8
2020020546,2021-04-17,2,MTL,0,4,OTT,18,9,15,0,42,7,9,10,3,29,18,9,15,0,42,7,9,10,3,29,0,1,23,15,0.456522,0.543478,8,8
2020020547,2021-03-28,2,DAL,1,4,FLA,25,9,17,0,51,16,6,10,3,35,23,9,16,0,48,16,6,10,2,34,1,0,34,23,0.52459,0.47541,15,13
2020020548,2021-03-29,2,BUF,3,4,PHI,26,5,10,3,44,28,11,14,4,57,26,5,10,3,44,28,11,14,3,56,1,0,32,36,0.457627,0.542373,4,4
2020020549,2021-03-29,2,PIT,2,1,NYI,19,10,9,1,39,22,4,12,0,38,19,9,9,0,37,21,4,11,0,36,1,0,22,25,0.564516,0.435484,8,6
2020020550,2021-02-06,2,STL,1,3,ARI,15,11,6,1,33,11,7,7,1,26,15,11,6,1,33,11,7,6,1,25,0,1,25,19,0.58,0.42,19,13
2020020551,2021-03-29,2,TOR,2,3,EDM,29,13,8,2,52,18,8,12,3,41,28,13,8,2,51,18,8,12,2,40,0,1,31,23,0.557692,0.442308,2,2
2020020552,2021-03-29,2,CGY,1,5,WPG,19,13,4,0,36,18,4,6,5,33,19,13,4,0,36,18,4,6,5,33,1,0,30,29,0.5,0.5,4,8
2020020553,2021-03-29,2,COL,5,2,ANA,27,13,9,4,53,8,6,12,2,28,26,12,9,4,51,8,6,12,2,28,1,0,48,15,0.5,0.5,13,31
2020020554,2021-03-29,2,VGK,4,1,L.A,15,10,14,3,42,21,10,13,1,45,15,10,14,3,42,21,10,13,1,45,0,1,24,25,0.404762,0.595238,6,6
2020020555,2021-03-29,2,S.J,4,3,MIN,37,21,16,6,80,25,21,17,5,68,33,18,15,3,69,21,17,16,3,57,0,1,39,25,0.584906,0.415094,5,7
2020020556,2021-03-30,2,BOS,5,4,N.J,40,16,9,5,70,29,5,6,4,44,35,16,8,3,62,25,4,6,4,39,0,1,48,35,0.507463,0.492537,8,6
2020020557,2021-03-31,2,BUF,6,1,PHI,19,10,6,4,39,28,11,10,1,50,19,10,6,4,39,28,11,10,1,50,1,0,27,32,0.423729,0.576271,6,0
2020020558,2021-03-30,2,NYR,5,2,WSH,20,6,8,4,38,24,6,10,1,41,19,6,8,4,37,24,6,10,1,41,0,1,27,32,0.442308,0.557692,6,16
2020020559,2021-03-30,2,T.B,1,3,CBJ,35,9,13,1,58,17,9,6,3,35,35,9,13,1,58,17,9,6,3,35,0,1,38,21,0.537037,0.462963,0,2
2020020560,2021-03-30,2,FLA,4,1,DET,24,7,11,4,46,25,2,6,0,33,24,7,11,4,46,25,2,6,0,33,1,0,33,36,0.489796,0.510204,8,8
2020020561,2021-03-27,2,PIT,6,3,NYI,13,6,12,4,35,23,5,4,3,35,13,6,12,4,35,23,5,4,2,34,1,0,21,32,0.54717,0.45283,8,8
2020020562,2021-03-30,2,CHI,2,1,CAR,14,8,7,1,30,30,11,17,1,59,14,8,7,1,30,30,11,17,1,59,1,0,16,32,0.359375,0.640625,2,4
2020020563,2021-03-30,2,NSH,3,2,DAL,23,15,6,2,46,31,12,10,1,54,23,14,6,1,44,31,12,10,1,54,0,1,26,35,0.40678,0.59322,2,2
2020020564,2021-05-05,2,OTT,5,1,MTL,21,8,13,5,47,30,10,18,1,59,21,8,12,5,46,30,10,18,1,59,1,0,34,31,0.548387,0.451613,4,6
2020020565,2021-02-08,2,STL,3,4,ARI,31,9,14,3,57,21,12,23,3,59,26,7,12,2,47,18,10,22,1,51,1,0,43,26,0.464286,0.535714,15,15
2020020566,2021-03-31,2,WPG,1,3,TOR,20,6,15,0,41,15,6,9,2,32,20,6,15,0,41,15,6,9,2,32,0,1,27,26,0.508197,0.491803,10,8
2020020567,2021-05-16,2,VAN,5,6,CGY,24,3,7,2,36,18,15,16,6,55,21,2,7,2,32,18,11,16,5,50,0,1,35,36,0.507246,0.492754,29,15
2020020568,2021-03-16,2,COL,8,4,ANA,25,14,21,6,66,12,3,10,3,28,25,14,20,6,65,12,3,8,3,26,1,0,36,22,0.467742,0.532258,6,8
2020020569,2021-03-31,2,VGK,2,4,L.A,31,12,10,2,55,20,4,8,4,36,30,11,9,2,52,20,4,7,4,35,0,1,42,30,0.509091,0.490909,25,8
2020020570,2021-03-31,2,S.J,4,2,MIN,23,6,15,3,47,23,10,11,2,46,22,6,15,3,46,21,10,11,2,44,1,0,33,28,0.509091,0.490909,6,8
2020020571,2021-04-01,2,BOS,1,4,PIT,28,13,11,1,53,19,15,14,4,52,28,13,11,1,53,19,15,14,4,52,0,1,31,23,0.57377,0.42623,4,6
2020020572,2021-04-01,2,BUF,2,3,NYR,20,5,7,2,34,33,18,10,3,64,19,5,5,2,31,33,15,10,2,60,1,0,23,47,0.422222,0.577778,8,2
2020020573,2021-04-01,2,NYI,8,4,WSH,24,6,7,8,45,15,10,15,3,43,24,6,7,8,45,15,10,15,3,43,0,1,33,22,0.5,0.5,17,19
2020020574,2021-04-01,2,T.B,3,2,CBJ,28,5,10,2,45,31,9,11,2,53,28,5,10,2,45,31,9,11,2,53,1,0,34,38,0.489362,0.510638,4,8
2020020575,2021-04-01,2,FLA,3,2,DET,21,12,7,2,42,21,8,14,2,45,20,11,7,1,39,20,8,13,2,43,0,1,36,27,0.5,0.5,16,20
2020020576,2021-04-01,2,CHI,3,4,CAR,14,5,12,3,34,25,8,13,4,50,14,5,12,3,34,25,8,13,4,50,0,1,25,31,0.472222,0.527778,2,6
2020020577,2021-04-01,2,NSH,1,4,DAL,14,8,6,1,29,26,9,11,3,49,14,8,6,1,29,26,9,11,3,49,0,1,22,31,0.472727,0.527273,19,11
2020020578,2021-04-01,2,OTT,1,4,MTL,21,8,8,0,37,32,15,6,3,56,21,8,8,0,37,32,15,6,3,56,0,1,23,38,0.517857,0.482143,6,4
2020020579,2021-04-01,2,VGK,2,3,MIN,30,15,15,2,62,27,19,13,2,61,26,13,15,2,56,23,16,11,1,51,1,0,37,37,0.509091,0.490909,8,10
2020020580,2021-04-02,2,N.J,1,2,WSH,22,13,14,1,50,31,8,12,2,53,19,11,13,1,44,29,7,9,1,46,0,1,23,40,0.433333,0.566667,4,4
2020020581,2021-04-02,2,WPG,1,2,TOR,28,12,16,1,57,30,13,9,2,54,25,10,14,1,50,29,12,9,1,51,0,1,32,38,0.423077,0.576923,6,4
2020020582,2021-04-02,2,EDM,3,2,CGY,18,5,9,1,33,21,9,13,2,45,18,5,9,1,33,20,9,12,2,43,0,1,25,26,0.431818,0.568182,6,12
2020020583,2021-04-02,2,ANA,2,4,ARI,24,5,11,2,42,26,7,6,4,43,24,5,11,2,42,26,7,6,4,43,1,0,29,31,0.5625,0.4375,14,14
2020020584,2021-04-02,2,L.A,0,3,S.J,26,10,15,0,51,28,14,12,3,57,24,10,15,0,49,28,14,12,3,57,0,1,30,36,0.547619,0.452381,6,4
2020020585,2021-04-03,2,BOS,7,5,PIT,20,5,6,6,37,20,6,8,3,37,18,4,6,5,33,17,4,8,3,32,0,1,28,28,0.596491,0.403509,10,8
2020020586,2021-04-03,2,BUF,3,2,NYR,28,9,14,3,54,26,11,5,1,43,25,9,11,2,47,23,9,5,1,38,0,1,29,30,0.54386,0.45614,6,4
2020020587,2021-04-03,2,NYI,3,2,PHI,21,4,5,1,31,23,9,12,2,46,18,3,4,1,26,23,8,11,2,44,1,0,24,32,0.55,0.45,11,15
2020020588,2021-04-03,2,CAR,2,3,DAL,39,10,11,2,62,20,7,11,2,40,39,10,11,2,62,20,7,11,2,40,0,1,43,25,0.60274,0.39726,4,2
2020020589,2021-04-03,2,T.B,2,1,DET,21,13,16,2,52,25,3,11,1,40,21,13,16,2,52,25,3,11,1,40,1,0,29,26,0.404255,0.595745,4,6
2020020590,2021-04-03,2,FLA,5,2,CBJ,29,10,9,5,53,41,3,13,2,59,28,10,9,5,52,40,3,13,2,58,1,0,39,46,0.526316,0.473684,2,8
2020020591,2021-04-03,2,NSH,3,0,CHI,15,9,11,1,36,38,9,9,0,56,15,9,11,1,36,38,9,9,0,56,1,0,21,41,0.568627,0.431373,8,2
2020020592,2021-04-03,2,MTL,3,6,OTT,24,11,16,2,53,20,7,10,4,41,24,11,16,2,53,20,7,10,4,41,0,1,38,32,0.587302,0.412698,9,15
2020020593,2021-05-06,2,EDM,3,6,VAN,33,10,8,2,53,17,3,1,6,27,30,10,7,2,49,17,3,1,6,27,0,1,42,27,0.465517,0.534483,18,20
2020020594,2021-04-03,2,COL,2,1,STL,24,12,14,2,52,21,9,4,1,35,24,12,14,2,52,21,9,4,1,35,1,0,34,28,0.517857,0.482143,11,13
2020020595,2021-04-03,2,VGK,1,2,MIN,23,17,23,1,64,23,9,10,1,43,23,16,23,1,63,23,9,10,1,43,1,0,28,27,0.5,0.5,6,6
2020020596,2021-04-03,2,L.A,2,3,S.J,32,10,7,1,50,16,11,12,3,42,32,10,7,1,50,16,11,12,3,42,0,1,37,23,0.466667,0.533333,4,4
2020020597,2021-04-04,2,N.J,4,5,WSH,28,13,14,4,59,12,8,6,3,29,26,12,14,3,55,12,8,6,3,29,1,0,39,19,0.530303,0.469697,6,8
2020020598,2021-04-04,2,CAR,1,0,DAL,36,17,19,1,73,28,5,14,0,47,32,17,19,1,69,28,5,13,0,46,1,0,38,28,0.591837,0.408163,2,4
2020020599,2021-04-04,2,T.B,1,5,DET,23,11,15,1,50,12,4,8,4,28,23,11,15,1,50,12,4,8,4,28,0,1,28,18,0.518519,0.481481,4,6
2020020600,2021-04-04,2,FLA,3,0,CBJ,31,7,14,3,55,27,5,14,0,46,31,7,14,3,55,27,5,14,0,46,1,0,35,32,0.62069,0.37931,6,2
2020020601,2021-04-19,2,NSH,5,2,CHI,20,5,6,5,36,27,9,14,1,51,20,5,6,5,36,27,9,14,1,51,1,0,30,32,0.519231,0.480769,20,10
2020020602,2021-05-10,2,WPG,1,3,VAN,30,15,15,1,61,22,8,11,3,44,29,15,15,1,60,22,8,11,3,44,0,1,40,31,0.645161,0.354839,2,6
2020020603,2021-04-04,2,CGY,2,4,TOR,28,8,17,2,55,26,10,5,4,45,28,8,17,2,55,26,10,5,4,45,0,1,34,30,0.48,0.52,2,2
2020020604,2021-04-04,2,ANA,2,3,ARI,16,12,5,2,35,28,12,13,3,56,16,12,5,2,35,28,10,12,2,52,1,0,20,31,0.45098,0.54902,7,9
2020020605,2021-04-10,2,PHI,3,2,BOS,19,8,17,2,46,22,7,12,2,43,19,8,16,2,45,22,7,12,2,43,0,1,23,32,0.491228,0.508772,8,4
2020020606,2021-04-05,2,STL,1,6,VGK,22,5,14,1,42,25,6,17,6,54,22,5,14,1,42,25,6,17,6,54,0,1,32,33,0.576271,0.423729,4,6
2020020607,2021-04-05,2,MTL,3,2,EDM,27,10,14,3,54,16,9,8,1,34,25,9,14,2,50,14,8,6,1,29,0,1,32,23,0.653846,0.346154,8,4
2020020608,2021-04-05,2,CGY,3,5,TOR,23,13,11,2,49,19,13,8,4,44,23,13,11,2,49,19,13,8,4,44,0,1,29,30,0.560606,0.439394,8,2
2020020609,2021-04-05,2,MIN,4,5,COL,13,4,6,2,25,28,10,10,4,52,13,4,6,2,25,28,10,10,4,52,1,0,25,36,0.474359,0.525641,37,21
2020020610,2021-04-05,2,L.A,2,5,ARI,28,10,10,1,49,18,13,9,2,42,28,10,10,1,49,18,12,9,2,41,0,1,38,33,0.6,0.4,12,6
2020020611,2021-04-06,2,N.J,3,5,BUF,24,13,7,2,46,12,3,6,4,25,24,13,7,2,46,12,3,6,4,25,1,0,30,18,0.461538,0.538462,4,6
2020020612,2021-04-06,2,NYI,1,0,WSH,34,11,10,1,56,26,7,14,0,47,34,11,10,1,56,26,7,14,0,47,1,0,39,29,0.508772,0.491228,4,4
2020020613,2021-04-06,2,NYR,8,4,PIT,13,7,5,4,29,35,7,14,3,59,12,7,5,4,28,31,6,11,3,51,1,0,25,45,0.409836,0.590164,10,10
2020020614,2021-04-06,2,PHI,2,4,BOS,35,13,16,2,66,22,8,15,2,47,35,13,15,2,65,21,7,15,2,45,0,1,42,26,0.565217,0.434783,6,8
2020020615,2021-04-06,2,CAR,5,2,FLA,25,14,10,3,52,31,5,7,2,45,24,13,10,3,50,30,5,6,2,43,0,1,36,36,0.580645,0.419355,4,8
2020020616,2021-04-06,2,CBJ,4,2,T.B,20,4,4,3,31,28,8,12,2,50,20,4,4,3,31,28,8,12,2,50,1,0,30,38,0.515625,0.484375,8,10
2020020617,2021-04-06,2,DET,2,3,NSH,24,7,10,2,43,24,12,7,3,46,19,7,9,2,37,20,11,7,1,39,1,0,27,31,0.318182,0.681818,10,6
2020020618,2021-04-06,2,CHI,4,2,DAL,18,2,13,4,37,20,12,14,1,47,17,2,13,4,36,20,11,14,1,46,1,0,28,27,0.553846,0.446154,4,6
2020020619,2021-05-11,2,WPG,5,0,VAN,27,4,13,5,49,24,8,2,0,34,26,4,12,5,47,23,8,2,0,33,1,0,36,24,0.520833,0.479167,6,6
2020020620,2021-04-07,2,STL,3,1,VGK,30,9,11,3,53,40,15,24,1,80,30,9,11,3,53,40,15,24,1,80,1,0,35,51,0.517241,0.482759,13,7
2020020621,2021-04-07,2,OTT,2,4,EDM,26,12,14,2,54,22,11,8,3,44,26,12,14,2,54,22,11,8,3,44,0,1,30,35,0.617021,0.382979,6,4
2020020622,2021-04-07,2,TOR,3,2,MTL,26,11,13,3,53,31,10,18,2,61,26,11,13,3,53,31,10,18,2,61,1,0,32,34,0.444444,0.555556,4,4
2020020623,2021-04-07,2,MIN,8,3,COL,4,6,6,4,20,21,7,13,1,42,4,5,6,4,19,19,7,13,1,40,1,0,19,32,0.493333,0.506667,28,24
2020020624,2021-04-07,2,L.A,4,3,ARI,23,13,9,4,49,21,9,7,3,40,23,13,9,4,49,21,9,7,3,40,0,1,30,27,0.607843,0.392157,4,2
2020020625,2021-04-08,2,BUF,3,6,N.J,20,6,5,2,33,24,15,11,4,54,20,6,5,2,33,24,15,11,4,54,1,0,27,38,0.480769,0.519231,8,6
2020020626,2021-04-08,2,NYI,3,2,PHI,16,5,7,2,30,18,7,18,2,45,15,5,7,2,29,16,7,17,2,42,1,0,23,27,0.440678,0.559322,4,19
2020020627,2021-04-08,2,NYR,2,5,PIT,19,7,6,1,33,21,9,9,4,43,18,7,6,1,32,20,9,9,4,42,0,1,24,32,0.410714,0.589286,15,15
2020020628,2021-04-08,2,WSH,2,4,BOS,26,5,14,0,45,23,11,6,2,42,24,5,13,0,42,22,9,6,2,39,0,1,33,32,0.416667,0.583333,15,21
2020020629,2021-04-08,2,CAR,3,0,FLA,15,12,6,2,35,20,8,5,0,33,14,9,6,2,31,17,7,5,0,29,1,0,22,24,0.416667,0.583333,12,12
2020020630,2021-04-08,2,CBJ,4,6,T.B,28,10,5,4,47,22,12,10,5,49,27,10,5,4,46,21,12,10,5,48,0,1,36,30,0.433333,0.566667,13,19
2020020631,2021-04-08,2,DET,1,7,NSH,24,6,11,1,42,22,6,5,7,40,23,6,11,1,41,20,5,5,6,36,1,0,26,32,0.27451,0.72549,11,23
2020020632,2021-04-08,2,CHI,1,5,DAL,35,5,20,1,61,23,6,10,3,42,34,4,20,1,59,23,5,10,2,40,0,1,39,34,0.423077,0.576923,6,6
2020020633,2021-04-08,2,MTL,2,4,WPG,31,9,12,2,54,20,9,12,4,45,31,7,12,2,52,19,8,12,4,43,0,1,38,27,0.586207,0.413793,8,6
2020020634,2021-05-19,2,CGY,6,2,VAN,19,13,7,6,45,18,13,7,1,39,19,12,6,6,43,18,11,7,1,37,1,0,28,21,0.52459,0.47541,14,6
2020020635,2021-02-25,2,BUF,3,4,N.J,22,8,5,1,36,31,9,11,3,54,22,8,5,1,36,31,9,11,2,53,1,0,32,40,0.563636,0.436364,8,8
2020020636,2021-04-09,2,NYI,1,4,NYR,31,9,15,1,56,32,5,10,4,51,31,9,15,1,56,32,5,10,4,51,0,1,32,36,0.5,0.5,0,2
2020020637,2021-04-09,2,STL,9,1,MIN,25,7,8,7,47,23,6,13,1,43,25,7,8,7,47,23,6,13,1,43,1,0,38,25,0.546875,0.453125,4,4
2020020638,2021-04-08,2,OTT,1,3,EDM,37,13,10,1,61,18,16,9,2,45,37,13,10,1,61,18,16,9,2,45,0,1,40,23,0.54902,0.45098,2,4
2020020639,2021-04-09,2,VGK,7,4,ARI,26,5,11,5,47,19,14,18,3,54,25,5,11,5,46,19,14,18,3,54,1,0,37,26,0.509091,0.490909,4,4
2020020640,2021-04-09,2,ANA,0,2,COL,24,12,8,0,44,27,14,11,2,54,24,12,8,0,44,26,13,11,2,52,0,1,28,35,0.521739,0.478261,6,4
2020020641,2021-04-09,2,S.J,5,2,L.A,21,5,9,4,39,24,9,11,2,46,21,5,9,4,39,24,9,10,2,45,0,1,29,34,0.423729,0.576271,23,23
2020020642,2021-04-10,2,CAR,4,5,DET,33,19,13,5,70,24,11,9,6,50,27,17,13,4,61,19,9,8,4,40,1,0,34,28,0.517241,0.482759,4,4
2020020643,2021-04-10,2,CBJ,3,4,CHI,21,13,14,3,51,18,10,4,3,35,21,13,14,3,51,18,10,4,3,35,1,0,26,28,0.457627,0.542373,10,2
2020020644,2021-04-10,2,NSH,0,3,T.B,28,16,8,0,52,24,8,7,3,42,28,16,8,0,52,24,8,7,3,42,0,1,36,34,0.526316,0.473684,16,8
2020020645,2021-04-10,2,MTL,0,5,WPG,14,4,13,0,31,16,8,12,3,39,11,4,13,0,28,16,8,12,3,39,0,1,19,25,0.413043,0.586957,27,13
2020020646,2021-04-10,2,TOR,6,5,OTT,29,10,12,6,57,26,5,9,3,43,29,10,12,6,57,26,5,9,3,43,1,0,38,32,0.5,0.5,4,2
2020020647,2021-05-13,2,CGY,4,1,VAN,21,14,10,3,48,22,10,6,1,39,21,14,10,3,48,21,10,6,1,38,0,1,28,25,0.385965,0.614035,2,8
2020020648,2021-04-10,2,DAL,4,1,FLA,12,11,7,3,33,16,10,23,0,49,12,11,7,3,33,16,10,23,0,49,1,0,20,21,0.542373,0.457627,8,6
2020020649,2021-04-10,2,S.J,2,4,L.A,17,14,14,1,46,14,7,10,3,34,17,14,14,1,46,13,7,10,3,33,0,1,28,26,0.482759,0.517241,10,10
2020020650,2021-04-11,2,N.J,2,5,PIT,22,15,16,2,55,16,7,16,4,43,22,15,16,2,55,16,7,16,4,43,0,1,30,24,0.526316,0.473684,2,4
2020020651,2021-04-11,2,NYI,3,2,NYR,27,7,8,2,44,21,16,7,2,46,26,7,6,1,40,19,16,7,2,44,1,0,32,26,0.584906,0.415094,8,8
2020020652,2021-04-11,2,PHI,3,5,BUF,38,17,10,2,67,26,6,13,5,50,36,16,9,2,63,26,6,13,5,50,1,0,43,31,0.553846,0.446154,8,4
2020020653,2021-05-11,2,WSH,2,1,BOS,28,20,20,2,70,24,8,9,1,42,28,20,20,2,70,24,8,9,1,42,0,1,32,25,0.622222,0.377778,12,12
2020020654,2021-04-10,2,STL,3,2,MIN,21,14,21,2,58,21,1,14,1,37,17,11,21,1,50,18,1,11,1,31,0,1,30,30,0.54717,0.45283,6,8
2020020655,2021-04-11,2,VGK,1,0,ARI,27,19,13,1,60,12,9,16,0,37,27,19,10,1,57,12,9,16,0,37,1,0,29,14,0.653061,0.346939,4,6
2020020656,2021-04-11,2,ANA,1,4,COL,19,13,10,1,43,29,12,17,3,61,17,12,10,0,39,25,12,16,3,56,0,1,25,37,0.5,0.5,29,25
2020020657,2021-04-12,2,CAR,1,3,DET,33,12,12,1,58,25,5,2,2,34,32,11,12,1,56,24,5,2,2,33,0,1,38,30,0.580645,0.419355,10,8
2020020658,2021-04-12,2,CBJ,3,4,CHI,27,12,12,3,54,24,13,9,3,49,26,11,12,3,52,23,13,9,2,47,1,0,33,34,0.428571,0.571429,16,0
2020020659,2021-04-13,2,NSH,7,2,T.B,15,9,2,7,33,17,8,16,1,42,15,9,2,7,33,17,8,14,1,40,1,0,22,23,0.690909,0.309091,6,8
2020020660,2021-04-12,2,MTL,4,2,TOR,20,12,11,3,46,20,8,14,2,44,20,12,11,3,46,20,8,14,2,44,1,0,25,25,0.490196,0.509804,4,4
2020020661,2021-04-12,2,OTT,4,2,WPG,17,10,7,3,37,11,6,19,1,37,17,10,7,2,36,11,6,18,1,36,0,1,24,26,0.38,0.62,17,11
2020020662,2021-05-08,2,EDM,4,3,VAN,24,6,16,2,48,17,6,14,3,40,24,6,16,2,48,16,6,14,2,38,1,0,34,25,0.529412,0.470588,10,8
2020020663,2021-04-12,2,L.A,2,4,VGK,23,7,11,2,43,31,6,11,2,50,23,7,11,2,43,31,6,11,2,50,1,0,28,41,0.509434,0.490566,4,8
2020020664,2021-04-12,2,S.J,0,4,ANA,34,12,10,0,56,15,6,7,4,32,34,12,10,0,56,15,6,7,4,32,0,1,46,21,0.553571,0.446429,4,10
2020020665,2021-04-15,2,BOS,4,1,NYI,33,7,10,3,53,19,9,6,1,35,31,7,10,3,51,19,9,6,1,35,1,0,45,23,0.5,0.5,6,10
2020020666,2021-04-13,2,N.J,0,3,NYR,23,14,12,0,49,17,17,8,2,44,23,14,12,0,49,17,17,8,2,44,0,1,27,20,0.594595,0.405405,10,14
2020020667,2021-02-18,2,WSH,3,1,BUF,16,15,14,1,46,21,13,6,0,40,16,15,14,1,46,21,13,6,0,40,1,0,21,23,0.512821,0.487179,4,2
2020020668,2021-03-06,2,PIT,4,3,PHI,19,5,7,2,33,13,3,9,2,27,18,4,7,2,31,11,3,8,1,23,0,1,27,22,0.352941,0.647059,12,10
2020020669,2021-04-13,2,TOR,2,3,CGY,21,10,8,2,41,21,14,11,2,48,20,10,8,2,40,21,14,11,1,47,0,1,26,28,0.56,0.44,9,9
2020020670,2021-04-13,2,DAL,2,3,FLA,22,12,12,2,48,23,14,12,2,51,19,11,11,2,43,20,12,10,1,43,0,1,26,31,0.5875,0.4125,10,8
2020020671,2021-04-14,2,MTL,1,4,CGY,25,7,23,1,56,29,10,20,4,63,25,7,23,1,56,29,10,20,4,63,0,1,27,34,0.4,0.6,2,4
2020020672,2021-04-14,2,OTT,2,3,WPG,20,7,8,1,36,24,4,7,1,36,20,7,8,1,36,24,4,7,1,36,1,0,29,35,0.462963,0.537037,6,10
2020020673,2021-05-15,2,EDM,1,4,VAN,22,10,6,1,39,31,6,15,3,55,22,10,6,1,39,31,6,15,3,55,1,0,32,41,0.55102,0.44898,4,6
2020020674,2021-04-14,2,L.A,2,6,VGK,18,25,7,1,51,23,11,16,6,56,18,25,7,1,51,23,11,16,6,56,0,1,22,32,0.464286,0.535714,2,2
2020020675,2021-04-14,2,S.J,1,4,ANA,19,11,10,1,41,17,6,13,3,39,19,11,10,1,41,17,6,13,3,39,0,1,28,27,0.55,0.45,20,18
2020020676,2021-04-15,2,NYR,4,0,N.J,28,3,7,4,42,14,15,16,0,45,28,3,7,4,42,14,15,16,0,45,1,0,33,16,0.466667,0.533333,6,4
2020020677,2021-04-15,2,WSH,2,5,BUF,23,17,11,2,53,25,8,9,4,46,21,17,11,2,51,23,7,8,4,42,0,1,29,30,0.612245,0.387755,6,8
2020020678,2021-04-15,2,CAR,4,1,NSH,20,3,7,3,33,18,12,11,0,41,18,3,7,2,30,18,10,10,0,38,1,0,29,20,0.483333,0.516667,12,10
2020020679,2021-04-15,2,T.B,3,2,FLA,15,11,10,2,38,26,5,6,2,39,13,11,10,1,35,23,5,6,2,36,0,1,19,38,0.339623,0.660377,6,4
2020020680,2021-04-15,2,PIT,1,2,PHI,32,7,10,2,51,23,10,3,3,39,25,6,10,1,42,23,9,3,1,36,1,0,32,27,0.484848,0.515152,6,6
2020020681,2021-04-15,2,DET,4,1,CHI,23,9,6,4,42,18,10,19,1,48,23,9,6,3,41,18,10,19,1,48,0,1,28,25,0.619048,0.380952,6,2
2020020682,2021-04-15,2,TOR,2,5,WPG,23,13,13,2,51,16,5,12,3,36,23,13,13,2,51,16,5,12,3,36,1,0,33,24,0.574468,0.425532,6,8
2020020683,2021-04-15,2,DAL,4,1,CBJ,25,13,19,4,61,15,15,8,1,39,25,13,19,4,61,15,15,8,1,39,0,1,31,18,0.660377,0.339623,2,2
2020020684,2021-02-12,2,ARI,1,4,STL,19,7,14,1,41,22,8,12,3,45,19,7,14,1,41,22,8,12,3,45,0,1,25,27,0.520833,0.479167,4,6
2020020685,2021-04-16,2,BOS,3,0,NYI,21,6,10,3,40,14,9,6,0,29,21,6,10,3,40,14,9,6,0,29,1,0,28,25,0.490909,0.509091,10,6
2020020686,2021-04-16,2,MTL,2,1,CGY,15,12,21,2,50,24,13,20,1,58,15,10,19,2,46,23,13,20,1,57,1,0,20,29,0.468085,0.531915,6,6
2020020687,2021-04-16,2,MIN,3,2,S.J,10,13,9,3,35,18,10,12,1,41,10,13,9,3,35,18,10,12,1,41,0,1,18,22,0.608696,0.391304,2,6
2020020688,2021-05-12,2,COL,6,0,L.A,22,16,10,5,53,14,8,13,0,35,22,16,10,5,53,14,8,13,0,35,1,0,37,18,0.606557,0.393443,4,8
2020020689,2021-04-16,2,ANA,0,4,VGK,13,9,10,0,32,34,14,13,4,65,13,9,10,0,32,34,14,13,4,65,0,1,16,51,0.5,0.5,8,4
2020020690,2021-04-17,2,BUF,2,3,PIT,28,9,14,1,52,33,12,9,2,56,28,9,14,1,52,33,12,9,2,56,0,1,30,41,0.533333,0.466667,4,2
2020020691,2021-04-17,2,NYR,6,3,N.J,17,7,10,4,38,26,14,17,3,60,17,5,10,4,36,26,14,17,1,58,1,0,30,33,0.404255,0.595745,10,10
2020020692,2021-04-17,2,PHI,3,6,WSH,10,5,9,2,26,30,11,12,4,57,10,5,9,2,26,30,11,12,4,57,0,1,25,41,0.606557,0.393443,10,8
2020020693,2021-04-17,2,CAR,3,1,NSH,41,17,16,3,77,25,8,16,1,50,41,17,16,3,77,25,8,16,1,50,1,0,48,28,0.546875,0.453125,4,4
2020020694,2021-04-17,2,T.B,3,5,FLA,26,6,13,3,48,26,7,5,4,42,26,6,13,3,48,26,7,5,4,42,0,1,31,32,0.574074,0.425926,6,4
2020020695,2021-04-17,2,DET,0,4,CHI,21,7,10,0,38,13,3,11,4,31,21,7,10,0,38,13,3,11,4,31,0,1,29,27,0.527273,0.472727,4,12
2020020696,2021-04-17,2,WPG,0,3,EDM,20,15,8,0,43,17,10,12,1,40,18,14,8,0,40,16,10,12,1,39,0,1,26,25,0.565217,0.434783,12,6
2020020697,2021-04-18,2,VAN,3,2,TOR,14,6,13,3,36,30,12,16,1,59,14,6,11,2,33,30,12,16,1,59,0,1,24,39,0.469388,0.530612,19,2
2020020698,2021-04-17,2,MIN,5,2,S.J,16,8,8,4,36,24,11,9,2,46,16,8,8,4,36,24,11,9,2,46,0,1,28,28,0.42,0.58,4,8
2020020699,2021-04-17,2,DAL,5,1,CBJ,24,15,13,5,57,16,8,13,1,38,24,15,13,5,57,16,8,13,1,38,0,1,32,22,0.639344,0.360656,4,18
2020020700,2021-04-17,2,ARI,3,2,STL,21,10,10,2,43,19,6,22,1,48,21,10,10,2,43,19,6,22,1,48,0,1,29,22,0.433962,0.566038,2,6
2020020701,2021-04-18,2,BOS,6,3,WSH,16,5,5,5,31,18,9,8,1,36,14,5,5,5,29,18,9,8,1,36,1,0,28,33,0.545455,0.454545,14,21
2020020702,2021-04-18,2,N.J,3,5,NYR,22,6,12,3,43,19,5,10,3,37,22,6,12,3,43,19,5,10,3,37,0,1,30,25,0.571429,0.428571,20,2
2020020703,2021-04-18,2,PHI,0,1,NYI,25,12,15,0,52,23,12,10,1,46,24,12,15,0,51,22,10,10,0,42,0,0,30,28,0.595745,0.404255,4,2
2020020704,2021-05-13,2,COL,5,1,L.A,37,14,23,5,79,19,4,12,1,36,37,14,23,4,78,19,4,11,1,35,0,1,43,22,0.381818,0.618182,19,9
2020020705,2021-04-18,2,ANA,2,5,VGK,27,6,15,2,50,20,6,11,4,41,27,6,15,2,50,19,6,11,4,40,0,1,35,29,0.561404,0.438596,6,8
2020020706,2021-04-19,2,T.B,3,2,CAR,31,8,14,2,55,22,12,7,1,42,27,6,14,1,48,18,12,7,1,38,1,0,36,27,0.478261,0.521739,13,11
2020020707,2021-04-19,2,FLA,4,2,CBJ,33,9,7,4,53,27,7,13,2,49,32,9,7,4,52,27,7,13,2,49,1,0,39,36,0.627119,0.372881,31,21
2020020708,2021-04-19,2,CGY,2,4,OTT,20,9,11,2,42,12,5,11,2,30,20,9,11,2,42,12,5,11,2,30,0,1,28,20,0.576923,0.423077,9,13
2020020709,2021-04-19,2,EDM,4,1,MTL,25,8,10,4,47,20,8,13,1,42,25,8,10,4,47,20,8,13,1,42,0,1,36,23,0.528302,0.471698,4,8
2020020710,2021-04-20,2,VAN,6,3,TOR,21,15,12,4,52,33,4,13,1,51,21,15,12,4,52,33,4,13,1,51,0,1,29,40,0.545455,0.454545,4,4
2020020711,2021-04-19,2,DAL,3,2,DET,33,21,17,3,74,22,11,11,3,47,26,18,17,1,62,17,7,11,2,37,1,0,36,22,0.571429,0.428571,2,4
2020020712,2021-04-19,2,ARI,2,5,MIN,21,17,11,2,51,13,6,10,3,32,21,17,11,2,51,13,6,10,3,32,0,1,24,24,0.685185,0.314815,6,2
2020020713,2021-04-19,2,VGK,3,2,S.J,35,23,15,1,74,29,11,20,2,62,29,18,13,0,60,24,10,19,2,55,0,1,40,31,0.52459,0.47541,4,10
2020020714,2021-04-11,2,BOS,1,8,WSH,29,12,7,0,48,12,10,4,5,31,29,12,7,0,48,12,10,4,5,31,0,1,35,33,0.538462,0.461538,17,13
2020020715,2021-04-18,2,BUF,4,2,PIT,20,7,11,3,41,31,13,9,2,55,20,7,11,3,41,31,13,9,2,55,1,0,29,36,0.540984,0.459016,4,8
2020020716,2021-04-27,2,N.J,6,4,PHI,19,9,7,4,39,25,12,17,4,58,19,9,7,4,39,25,12,17,4,58,1,0,27,30,0.442623,0.557377,9,9
2020020717,2021-04-20,2,NYI,6,1,NYR,19,7,13,5,44,19,9,23,1,52,19,7,13,5,44,19,9,23,1,52,1,0,28,26,0.651163,0.348837,4,6
2020020718,2021-04-20,2,T.B,1,4,CAR,24,11,11,1,47,27,10,10,4,51,23,11,10,1,45,27,10,10,4,51,0,1,27,36,0.52459,0.47541,11,9
2020020719,2021-04-20,2,FLA,5,1,CBJ,25,12,6,5,48,31,5,7,0,43,25,12,6,5,48,31,5,7,0,43,1,0,33,34,0.584906,0.415094,7,9
2020020720,2021-05-09,2,CGY,6,1,OTT,29,12,9,5,55,16,10,5,1,32,26,12,8,5,51,15,10,4,1,30,1,0,36,20,0.42623,0.57377,8,4
2020020721,2021-04-21,2,EDM,3,4,MTL,16,9,18,2,45,25,9,7,3,44,14,8,18,2,42,23,9,7,3,42,0,1,25,31,0.641509,0.358491,13,13
2020020722,2021-04-20,2,DAL,5,2,DET,16,9,9,5,39,23,15,18,2,58,15,9,9,5,38,19,14,18,2,53,1,0,24,26,0.444444,0.555556,11,11
2020020723,2021-04-02,2,COL,3,2,STL,30,6,15,1,52,14,4,11,1,30,30,6,15,1,52,14,4,10,1,29,1,0,39,27,0.509091,0.490909,10,12
2020020724,2021-04-20,2,L.A,4,1,ANA,17,5,2,4,28,19,11,14,1,45,17,5,2,4,28,19,10,12,1,42,1,0,22,25,0.551724,0.448276,13,11
2020020725,2021-04-21,2,CHI,5,4,NSH,22,7,21,5,55,35,7,9,4,55,21,7,21,4,53,34,7,9,4,54,1,0,30,40,0.423077,0.576923,4,8
2020020726,2021-04-22,2,WPG,3,5,TOR,28,8,15,3,54,24,5,8,5,42,28,8,15,3,54,24,5,8,5,42,0,1,37,33,0.555556,0.444444,2,4
2020020727,2021-04-21,2,ARI,1,4,MIN,31,13,16,0,60,18,7,4,4,33,31,13,16,0,60,18,7,4,4,33,1,0,40,23,0.516667,0.483333,2,4
2020020728,2021-04-21,2,VGK,5,2,S.J,31,12,16,4,63,27,7,16,2,52,31,12,16,4,63,26,7,16,2,51,0,1,40,33,0.423729,0.576271,8,8
2020020729,2021-04-22,2,BUF,1,5,BOS,24,8,9,1,42,26,8,9,5,48,23,8,8,1,40,26,8,9,5,48,0,1,30,38,0.508772,0.491228,6,12
2020020730,2021-04-22,2,NYI,0,1,WSH,25,6,7,1,39,26,13,11,2,52,23,5,6,0,34,24,12,11,0,47,0,0,26,28,0.488372,0.511628,6,4
2020020731,2021-04-22,2,T.B,3,1,CBJ,21,3,11,3,38,22,6,4,0,32,21,3,11,3,38,22,6,4,0,32,0,1,28,25,0.654545,0.345455,2,6
2020020732,2021-04-22,2,FLA,2,4,CAR,20,10,17,1,48,22,3,5,1,31,20,10,17,1,48,22,3,5,1,31,1,0,34,29,0.546875,0.453125,15,27
2020020733,2021-04-22,2,PIT,5,1,N.J,16,12,10,4,42,24,11,9,1,45,16,12,10,4,42,24,11,9,1,45,1,0,23,31,0.534884,0.465116,8,2
2020020734,2021-04-22,2,DET,7,3,DAL,15,7,7,7,36,37,6,17,1,61,15,7,7,7,36,37,6,17,1,61,1,0,23,46,0.491803,0.508197,8,2
2020020735,2021-04-22,2,STL,2,4,COL,17,8,20,1,46,15,5,5,3,28,17,8,20,1,46,15,5,5,3,28,1,0,27,29,0.545455,0.454545,10,10
2020020736,2021-04-23,2,CGY,4,2,MTL,26,18,6,3,53,17,8,8,2,35,26,18,6,3,53,17,7,8,2,34,1,0,31,20,0.614035,0.385965,2,2
2020020737,2021-04-22,2,VAN,0,3,OTT,27,6,17,0,50,13,9,12,1,35,27,6,17,0,50,13,9,12,1,35,0,1,31,25,0.645161,0.354839,27,17
2020020738,2021-04-23,2,BUF,6,4,BOS,26,5,7,4,42,35,14,15,4,68,24,5,7,4,40,34,14,15,4,67,0,1,34,40,0.454545,0.545455,4,8
2020020739,2021-04-23,2,NYR,4,1,PHI,18,8,9,3,38,24,11,15,1,51,18,8,9,3,38,24,11,15,1,51,1,0,24,27,0.403846,0.596154,9,9
2020020740,2021-04-23,2,CHI,1,3,NSH,28,7,13,1,49,21,5,19,3,48,28,7,13,1,49,21,5,19,3,48,0,1,30,28,0.433962,0.566038,4,2
2020020741,2021-05-14,2,WPG,4,2,TOR,17,11,4,4,36,28,12,10,2,52,17,11,4,4,36,28,12,10,2,52,0,1,24,36,0.478261,0.521739,4,2
2020020742,2021-03-03,2,L.A,2,3,ARI,34,9,16,1,60,18,10,5,1,34,34,9,16,1,60,18,10,5,1,34,0,1,42,23,0.625,0.375,6,8
2020020743,2021-02-22,2,S.J,2,6,MIN,26,11,8,2,47,25,9,9,5,48,26,11,8,2,47,25,9,9,5,48,1,0,33,34,0.492537,0.507463,11,11
2020020744,2021-04-24,2,NYI,3,6,WSH,21,9,11,0,41,24,13,11,6,54,21,9,11,0,41,24,13,11,6,54,0,1,24,30,0.509434,0.490566,2,4
2020020745,2021-04-24,2,FLA,4,3,CAR,27,8,13,3,51,10,8,7,2,27,27,8,13,2,50,10,8,7,2,27,0,1,36,19,0.375,0.625,10,8
2020020746,2021-04-24,2,PIT,4,2,N.J,31,8,8,3,50,29,7,7,2,45,31,8,8,3,50,29,7,7,2,45,1,0,37,36,0.610169,0.389831,9,7
2020020747,2021-04-24,2,DET,1,2,DAL,15,7,8,1,31,41,9,12,2,64,15,7,8,1,31,41,9,12,1,63,1,0,17,52,0.385965,0.614035,8,2
2020020748,2021-04-24,2,STL,5,3,COL,20,8,6,4,38,27,17,14,1,59,20,8,6,4,38,26,17,14,1,58,0,1,30,31,0.546875,0.453125,10,8
2020020749,2021-04-24,2,WPG,1,4,TOR,15,10,8,1,34,19,7,8,4,38,15,9,8,1,33,18,5,8,2,33,1,0,26,37,0.510204,0.489796,22,20
2020020750,2021-04-24,2,CGY,5,2,MTL,21,6,3,5,35,23,12,11,1,47,19,5,3,5,32,21,11,11,1,44,0,1,34,32,0.483871,0.516129,10,6
2020020751,2021-04-24,2,VAN,4,2,OTT,21,8,8,3,40,17,15,17,2,51,21,8,8,3,40,16,15,17,2,50,1,0,34,28,0.685185,0.314815,17,13
2020020752,2021-04-24,2,L.A,0,4,ARI,23,10,17,0,50,31,11,12,3,57,22,10,17,0,49,30,11,11,3,55,0,1,26,40,0.421053,0.578947,6,6
2020020753,2021-04-24,2,S.J,3,6,MIN,23,12,9,3,47,20,6,15,5,46,23,12,9,3,47,20,6,15,5,46,0,1,30,26,0.574074,0.425926,6,0
2020020754,2021-04-25,2,NYR,6,3,BUF,13,11,2,3,29,25,13,7,2,47,13,11,2,3,29,25,13,7,2,47,1,0,29,34,0.458333,0.541667,8,6
2020020755,2021-03-22,2,PHI,1,2,NYI,34,7,16,1,58,16,9,13,2,40,34,7,15,1,57,13,9,13,1,36,1,0,37,20,0.645833,0.354167,2,4
2020020756,2021-04-25,2,T.B,4,3,CBJ,21,17,11,3,52,17,6,10,3,36,21,17,10,2,50,17,6,10,3,36,1,0,34,22,0.5,0.5,2,8
2020020757,2021-04-25,2,PIT,1,0,BOS,27,9,14,1,51,29,7,8,0,44,27,9,14,1,51,29,7,8,0,44,1,0,29,30,0.517857,0.482143,0,2
2020020758,2021-04-26,2,NSH,4,1,FLA,17,4,3,3,27,37,12,13,1,63,17,4,3,3,27,36,12,13,1,62,0,1,27,40,0.54717,0.45283,6,6
2020020759,2021-04-26,2,OTT,2,1,VAN,23,9,14,2,48,24,6,10,1,41,23,9,14,2,48,24,6,10,1,41,1,0,27,26,0.413043,0.586957,7,7
2020020760,2021-04-26,2,WPG,1,6,EDM,31,12,14,0,57,21,6,14,6,47,31,11,14,0,56,21,6,14,6,47,0,1,37,30,0.5,0.5,2,4
2020020761,2021-04-26,2,CGY,1,2,MTL,20,12,7,0,39,19,10,13,1,43,20,12,7,0,39,19,10,13,1,43,0,1,22,24,0.520833,0.479167,6,6
2020020762,2021-04-29,2,MIN,4,5,STL,26,9,18,4,57,15,13,8,3,39,23,8,18,4,53,14,12,8,2,36,0,1,30,21,0.52459,0.47541,14,22
2020020763,2021-04-26,2,DAL,4,3,CAR,27,7,8,3,45,25,12,14,3,54,27,7,8,2,44,25,12,13,3,53,1,0,31,32,0.578947,0.421053,4,2
2020020764,2021-05-10,2,VGK,1,2,COL,25,11,12,1,49,17,6,14,2,39,24,11,12,1,48,17,6,14,2,39,1,0,37,21,0.557692,0.442308,6,8
2020020765,2021-04-26,2,L.A,4,1,ANA,19,13,10,4,46,19,13,12,1,45,19,13,10,4,46,19,13,12,1,45,1,0,25,22,0.511111,0.488889,2,4
2020020766,2021-04-26,2,S.J,6,4,ARI,21,5,10,6,42,17,8,10,4,39,21,5,10,6,42,17,8,10,4,39,1,0,34,25,0.436364,0.563636,8,10
2020020767,2021-03-14,2,N.J,2,3,NYI,27,7,6,2,42,26,13,5,4,48,24,6,5,1,36,24,12,4,2,42,0,1,31,34,0.586207,0.413793,10,8
2020020768,2021-04-27,2,NYR,3,1,BUF,31,9,6,2,48,34,9,14,0,57,31,9,6,2,48,34,9,14,0,57,1,0,41,37,0.5,0.5,9,11
2020020769,2021-03-07,2,PHI,1,3,WSH,31,8,7,1,47,19,13,13,3,48,28,8,6,1,43,19,13,13,3,48,1,0,37,27,0.557692,0.442308,4,8
2020020770,2021-04-27,2,PIT,1,3,BOS,18,5,15,1,39,26,9,7,3,45,17,5,15,1,38,26,9,6,3,44,0,1,26,31,0.433333,0.566667,7,11
2020020771,2021-04-27,2,CBJ,1,0,DET,29,20,16,2,67,41,7,6,0,54,26,16,14,0,56,34,5,5,0,44,0,0,33,41,0.48,0.52,4,6
2020020772,2021-04-27,2,CHI,4,7,T.B,23,1,12,3,39,18,5,7,6,36,23,1,12,3,39,18,5,7,6,36,0,1,40,30,0.507692,0.492308,28,24
2020020773,2021-04-27,2,NSH,4,7,FLA,21,2,4,4,31,41,11,12,4,68,21,2,4,4,31,41,11,12,4,68,1,0,30,55,0.446154,0.553846,10,4
2020020774,2021-04-27,2,DAL,1,5,CAR,23,9,12,1,45,21,10,13,3,47,23,9,12,1,45,21,10,13,3,47,0,1,28,30,0.545455,0.454545,6,6
2020020775,2021-04-28,2,MTL,1,4,TOR,24,5,19,1,49,19,6,8,3,36,24,5,19,1,49,19,6,8,3,36,0,1,33,29,0.660377,0.339623,6,4
2020020776,2021-04-28,2,OTT,6,3,VAN,22,15,13,6,56,16,10,11,3,40,22,15,13,6,56,16,10,11,3,40,1,0,33,22,0.52,0.48,14,16
2020020777,2021-04-28,2,WPG,1,3,EDM,26,10,11,1,48,21,8,19,1,49,26,10,11,1,48,21,8,19,1,49,0,1,30,27,0.535714,0.464286,6,2
2020020778,2021-04-28,2,MIN,3,4,STL,25,14,11,3,53,26,13,12,2,53,25,14,11,3,53,26,13,12,2,53,1,0,29,32,0.482143,0.517857,4,2
2020020779,2021-04-28,2,VGK,5,2,COL,17,9,7,4,37,27,10,11,2,50,17,9,7,4,37,27,10,11,2,50,1,0,26,37,0.491228,0.508772,8,8
2020020780,2021-04-28,2,L.A,2,3,ANA,23,5,12,0,40,17,14,6,3,40,23,5,12,0,40,17,14,6,3,40,1,0,30,22,0.511111,0.488889,4,10
2020020781,2021-04-28,2,S.J,4,2,ARI,22,5,7,4,38,22,6,14,2,44,22,3,7,3,35,22,6,14,2,44,1,0,31,30,0.45614,0.54386,8,8
2020020782,2021-04-29,2,BOS,5,2,BUF,28,13,5,3,49,26,7,8,2,43,27,13,5,3,48,25,5,8,2,40,1,0,40,31,0.586207,0.413793,6,6
2020020783,2021-04-29,2,N.J,5,3,PHI,11,9,9,3,32,20,13,13,1,47,11,9,9,3,32,20,13,13,1,47,1,0,19,24,0.4,0.6,9,13
2020020784,2021-04-29,2,NYR,0,4,NYI,24,13,17,0,54,20,14,10,3,47,23,13,16,0,52,19,13,10,3,45,0,1,25,27,0.36,0.64,6,6
2020020785,2021-04-29,2,WSH,4,5,PIT,28,9,14,3,54,29,12,11,5,57,26,9,14,3,52,29,11,11,4,55,1,0,37,35,0.493333,0.506667,6,6
2020020786,2021-04-29,2,CAR,3,1,DET,28,11,11,3,53,14,7,6,1,28,28,11,11,3,53,14,7,6,1,28,1,0,32,17,0.490909,0.509091,2,6
2020020787,2021-04-29,2,CHI,3,4,FLA,20,6,7,3,36,27,13,11,3,54,17,4,7,3,31,26,13,11,2,52,1,0,27,39,0.5,0.5,8,4
2020020788,2021-04-11,2,NSH,3,2,DAL,19,12,8,3,42,26,15,7,2,50,15,11,8,2,36,22,14,5,2,43,0,1,20,26,0.5,0.5,11,7
2020020789,2021-04-29,2,EDM,1,3,CGY,27,8,12,1,48,22,10,16,3,51,27,8,12,1,48,22,8,16,3,49,0,1,31,30,0.482759,0.517241,4,8
2020020790,2021-05-12,2,STL,4,0,MIN,23,7,5,4,39,27,11,5,0,43,22,6,5,3,36,26,11,5,0,42,1,0,27,31,0.534884,0.465116,8,2
2020020791,2021-04-30,2,MTL,5,3,WPG,30,11,16,3,60,14,5,9,3,31,29,11,16,3,59,13,5,9,3,30,0,1,35,22,0.407407,0.592593,4,6
2020020792,2021-04-29,2,TOR,4,1,VAN,20,17,15,4,56,13,13,15,0,41,20,17,15,4,56,13,13,15,0,41,1,0,24,16,0.446809,0.553191,9,5
2020020793,2021-04-30,2,COL,3,0,S.J,26,8,16,1,51,13,5,11,0,29,25,8,16,1,50,13,5,11,0,29,1,0,36,21,0.6,0.4,13,13
2020020794,2021-04-30,2,ARI,3,0,VGK,28,9,9,3,49,24,19,15,0,58,26,9,8,3,46,24,19,15,0,58,1,0,32,25,0.568966,0.431034,4,4
2020020795,2021-04-30,2,ANA,1,2,L.A,23,15,12,1,51,21,8,9,2,40,22,14,12,1,49,20,8,9,2,39,1,0,34,25,0.559322,0.440678,4,10
2020020796,2021-05-01,2,BOS,6,2,BUF,31,7,6,5,49,16,6,6,1,29,31,7,6,5,49,16,6,6,1,29,1,0,43,19,0.469697,0.530303,6,10
2020020797,2021-05-01,2,NYI,3,0,NYR,21,15,12,3,51,23,8,14,0,45,21,15,12,3,51,23,8,14,0,45,1,0,25,28,0.485714,0.514286,4,2
2020020798,2021-05-01,2,PHI,1,4,N.J,28,14,15,1,58,16,10,9,3,38,28,14,15,1,58,16,10,9,3,38,0,1,32,21,0.517857,0.482143,4,4
2020020799,2021-05-01,2,WSH,0,3,PIT,23,12,11,0,46,21,8,7,3,39,23,12,11,0,46,21,8,7,3,39,0,1,24,26,0.433962,0.566038,9,7
2020020800,2021-05-01,2,CAR,2,1,CBJ,30,10,21,2,63,29,9,12,1,51,27,9,20,1,57,27,9,12,1,49,0,1,33,32,0.641509,0.358491,4,2
2020020801,2021-05-01,2,DET,1,0,T.B,18,7,8,4,37,26,16,11,3,56,12,4,7,0,23,21,13,10,0,44,0,0,15,33,0.471698,0.528302,10,8
2020020802,2021-05-01,2,CHI,4,5,FLA,24,6,11,2,43,35,21,17,5,78,24,6,11,2,43,35,21,17,5,78,0,1,35,42,0.446429,0.553571,2,8
2020020803,2021-05-13,2,STL,7,3,MIN,14,8,8,4,34,16,6,5,3,30,14,8,8,4,34,16,6,5,3,30,0,1,27,20,0.509804,0.490196,4,8
2020020804,2021-05-01,2,NSH,1,0,DAL,25,15,11,1,52,27,5,8,0,40,24,15,10,0,49,26,3,8,0,37,0,0,34,28,0.489796,0.510204,8,10
2020020805,2021-05-01,2,MTL,3,2,OTT,34,13,20,2,69,20,11,11,2,44,32,13,18,1,64,20,11,11,2,44,0,1,39,23,0.644444,0.355556,9,11
2020020806,2021-05-01,2,TOR,5,1,VAN,25,7,6,5,43,24,13,12,1,50,25,7,6,5,43,24,13,12,1,50,0,1,30,27,0.416667,0.583333,2,2
2020020807,2021-05-01,2,EDM,4,1,CGY,18,4,6,3,31,23,11,13,1,48,18,4,6,3,31,21,11,13,1,46,1,0,29,30,0.648148,0.351852,10,8
2020020808,2021-05-01,2,COL,4,3,S.J,34,5,16,4,59,18,7,8,1,34,32,5,16,3,56,16,7,8,1,32,0,1,44,25,0.590164,0.409836,8,8
2020020809,2021-05-01,2,ARI,2,3,VGK,17,16,7,1,41,20,8,18,2,48,15,16,7,1,39,19,8,16,2,45,0,1,21,34,0.462963,0.537037,12,10
2020020810,2021-05-01,2,ANA,6,2,LAK,27,9,16,6,58,22,11,14,2,49,26,9,16,5,56,22,11,12,2,47,1,0,33,25,0.509434,0.490566,4,4
2020020811,2021-05-02,2,DET,1,2,T.B,17,5,10,1,33,37,12,13,2,64,17,5,10,1,33,37,12,13,2,64,0,1,23,42,0.466667,0.533333,4,8
2020020812,2021-05-03,2,BUF,4,2,NYI,30,9,1,3,43,31,8,15,2,56,30,9,1,3,43,31,8,15,2,56,0,1,40,36,0.464286,0.535714,2,6
2020020813,2021-05-03,2,N.J,0,3,BOS,20,8,11,0,39,38,7,7,3,55,20,8,11,0,39,38,7,7,3,55,0,1,20,42,0.509091,0.490909,7,7
2020020814,2021-05-03,2,NYR,3,6,WSH,15,11,6,2,34,26,10,6,6,48,15,11,6,2,34,26,10,6,6,48,0,1,26,40,0.465517,0.534483,10,22
2020020815,2021-05-03,2,PHI,7,2,PIT,33,5,12,6,56,30,5,12,0,47,31,5,12,6,54,27,5,11,0,43,1,0,45,37,0.681159,0.318841,10,8
2020020816,2021-05-03,2,CAR,5,2,CHI,26,14,15,4,59,14,11,11,2,38,26,14,15,4,59,14,11,11,2,38,1,0,38,17,0.6,0.4,6,6
2020020817,2021-05-03,2,CBJ,3,4,NSH,25,5,10,2,42,28,9,7,3,47,25,5,10,2,42,24,9,7,2,42,0,1,32,38,0.442308,0.557692,8,6
2020020818,2021-05-03,2,STL,3,1,ANA,25,8,11,2,46,17,12,15,1,45,25,8,11,2,46,17,12,15,1,45,1,0,32,20,0.490566,0.509434,4,4
2020020819,2021-05-03,2,MTL,3,2,TOR,13,8,11,2,34,19,3,20,2,44,13,7,10,1,31,17,3,20,2,42,0,1,23,29,0.519231,0.480769,6,8
2020020820,2021-05-03,2,OTT,2,1,WPG,11,2,9,1,23,14,11,12,1,38,10,2,9,1,22,14,10,12,0,36,1,0,18,29,0.365385,0.634615,14,8
2020020821,2021-05-03,2,MIN,6,5,VGK,26,9,8,5,48,24,13,9,4,50,26,9,8,5,48,24,13,9,4,50,1,0,32,32,0.432836,0.567164,10,8
2020020822,2021-05-03,2,ARI,2,3,L.A,31,14,10,1,56,22,10,1,2,35,31,14,10,1,56,22,10,1,2,35,1,0,34,26,0.545455,0.454545,4,4
2020020823,2021-05-03,2,S.J,4,5,COL,22,6,11,4,43,22,17,21,5,65,22,6,11,4,43,22,17,21,4,64,1,0,27,31,0.40678,0.59322,6,2
2020020824,2021-05-04,2,BUF,4,3,NYI,30,9,11,4,54,46,13,14,2,75,28,8,10,3,49,42,13,14,2,71,1,0,31,48,0.358491,0.641509,2,2
2020020825,2021-05-04,2,N.J,4,3,BOS,14,9,9,3,35,30,13,11,2,56,13,9,8,2,32,30,13,11,2,56,1,0,21,36,0.359375,0.640625,6,8
2020020826,2021-05-04,2,PHI,3,7,PIT,28,16,11,3,58,21,9,9,5,44,28,16,10,3,57,21,8,9,5,43,0,1,33,31,0.565217,0.434783,13,9
2020020827,2021-05-04,2,CAR,6,3,CHI,15,9,14,5,43,24,5,7,2,38,15,9,13,5,42,24,5,7,2,38,0,1,28,30,0.576271,0.423729,8,8
2020020828,2021-03-21,2,T.B,5,3,FLA,13,5,11,4,33,21,2,10,1,34,12,5,11,4,32,21,2,9,1,33,0,1,24,32,0.603448,0.396552,14,14
2020020829,2021-05-03,2,VAN,3,5,EDM,18,8,16,3,45,27,13,17,5,62,18,8,16,3,45,27,13,17,5,62,0,1,23,32,0.517857,0.482143,2,2
2020020830,2021-05-05,2,NYR,2,4,WSH,12,4,7,2,25,20,10,13,2,45,12,4,7,2,25,19,9,13,2,43,0,1,21,35,0.350877,0.649123,85,56
2020020831,2021-05-05,2,CBJ,4,2,NSH,19,9,10,3,41,30,11,15,2,58,19,9,10,3,41,30,11,15,2,58,0,1,27,32,0.490566,0.509434,2,4
2020020832,2021-05-05,2,STL,2,3,ANA,22,9,8,1,40,29,7,11,3,50,17,7,8,1,33,26,7,11,2,46,1,0,26,35,0.603448,0.396552,9,11
2020020833,2021-05-12,2,OTT,4,3,TOR,16,14,10,3,43,23,6,9,2,40,16,14,10,2,42,22,6,9,2,39,1,0,28,33,0.428571,0.571429,12,10
2020020834,2021-05-05,2,CGY,0,4,WPG,21,12,10,0,43,13,6,8,2,29,21,11,10,0,42,12,6,8,2,28,0,1,32,19,0.479167,0.520833,6,10
2020020835,2021-05-05,2,MIN,2,3,VGK,22,5,7,2,36,26,5,14,2,47,21,5,7,2,35,25,4,14,1,44,0,1,28,34,0.458333,0.541667,17,17
2020020836,2021-05-05,2,ARI,2,4,L.A,23,12,13,1,49,16,18,9,4,47,22,11,13,1,47,16,18,9,4,47,1,0,30,22,0.563636,0.436364,4,10
2020020837,2021-05-05,2,S.J,3,2,COL,21,9,5,2,37,28,19,19,2,68,21,9,5,2,37,28,19,19,2,68,0,1,33,32,0.467742,0.532258,4,8
2020020838,2021-05-06,2,BOS,4,0,NYR,26,14,8,3,51,14,5,6,0,25,26,14,8,3,51,14,5,6,0,25,1,0,34,15,0.574468,0.425532,2,4
2020020839,2021-05-06,2,NYI,1,2,N.J,26,7,22,1,56,21,4,19,2,46,25,7,21,1,54,21,4,19,2,46,0,1,33,25,0.612245,0.387755,2,4
2020020840,2021-05-07,2,WSH,2,4,PHI,27,5,13,2,47,21,16,12,4,53,27,5,13,2,47,21,16,12,4,53,0,1,30,29,0.428571,0.571429,4,2
2020020841,2021-05-10,2,FLA,4,0,TBL,17,6,10,3,36,22,5,11,0,38,16,4,9,3,32,22,5,10,0,37,1,0,30,30,0.385965,0.614035,19,19
2020020842,2021-05-06,2,PIT,8,4,BUF,25,6,10,7,48,13,5,7,3,28,25,6,10,7,48,13,5,7,3,28,0,1,34,23,0.52,0.48,4,2
2020020843,2021-05-09,2,CHI,4,2,DAL,17,2,12,3,34,37,9,14,2,62,17,2,12,3,34,37,9,14,2,62,1,0,25,39,0.434783,0.565217,0,4
2020020844,2021-05-04,2,VAN,1,4,EDM,21,10,11,1,43,21,9,15,2,47,21,10,11,1,43,19,9,15,2,45,1,0,29,27,0.489796,0.510204,6,8
2020020845,2021-05-07,2,CBJ,2,5,DET,22,9,10,2,43,29,3,13,4,49,22,9,10,2,43,29,3,13,4,49,1,0,24,36,0.295455,0.704545,4,2
2020020846,2021-05-10,2,NSH,5,0,CAR,17,13,3,2,35,24,4,8,0,36,16,13,3,2,34,23,3,8,0,34,1,0,27,30,0.555556,0.444444,17,17
2020020847,2021-05-06,2,TOR,5,2,MTL,26,17,4,5,52,17,10,9,2,38,25,17,4,5,51,17,10,9,2,38,1,0,35,21,0.555556,0.444444,6,8
2020020848,2021-04-05,2,WPG,4,3,OTT,33,11,13,3,60,13,9,8,2,32,33,11,13,3,60,13,9,8,2,32,1,0,46,23,0.672727,0.327273,8,6
2020020849,2021-04-10,2,CGY,5,0,EDM,17,14,10,4,45,16,9,11,0,36,17,14,10,4,45,16,9,11,0,36,1,0,32,17,0.440678,0.559322,4,8
2020020850,2021-05-07,2,MIN,4,3,ANA,29,12,8,4,53,18,9,13,3,43,28,12,8,3,51,18,9,13,3,43,0,1,36,25,0.5,0.5,2,6
2020020851,2021-05-07,2,VGK,4,3,STL,29,8,16,4,57,18,14,19,2,53,27,6,16,3,52,15,13,18,2,48,1,0,35,25,0.425532,0.574468,2,6
2020020852,2021-05-07,2,L.A,2,3,COL,15,4,8,2,29,27,10,16,2,55,14,4,7,2,27,25,10,16,2,53,1,0,17,37,0.454545,0.545455,8,2
2020020853,2021-05-07,2,S.J,2,5,ARI,22,8,9,2,41,27,9,7,4,47,22,8,9,2,41,27,9,7,4,47,1,0,28,34,0.540984,0.459016,4,6
2020020854,2021-05-08,2,BOS,4,5,NYR,32,19,16,3,70,13,7,4,5,29,32,18,16,3,69,13,7,4,5,29,0,1,39,23,0.517241,0.482759,2,6
2020020855,2021-05-08,2,NYI,5,1,N.J,20,6,21,4,51,22,8,13,1,44,20,6,21,4,51,22,8,13,1,44,1,0,27,24,0.545455,0.454545,4,6
2020020856,2021-05-08,2,WSH,2,1,PHI,30,12,13,2,57,25,12,12,1,50,22,10,11,1,44,20,11,11,1,43,0,1,40,29,0.38,0.62,12,14
2020020857,2021-05-08,2,FLA,5,1,T.B,24,7,8,4,43,19,6,7,1,33,22,5,7,4,38,19,6,7,1,33,1,0,35,29,0.471698,0.528302,76,78
2020020858,2021-05-08,2,PIT,1,0,BUF,19,7,7,1,34,26,8,5,0,39,19,7,7,1,34,26,8,5,0,39,1,0,23,29,0.510638,0.489362,2,4
2020020859,2021-05-08,2,CBJ,5,4,DET,29,18,8,4,59,32,12,10,3,57,26,16,7,3,52,28,12,8,3,51,0,1,36,37,0.539683,0.460317,2,0
2020020860,2021-05-10,2,CHI,4,5,DAL,10,8,7,4,29,38,11,18,4,71,9,7,7,4,27,37,11,18,3,69,1,0,23,50,0.434783,0.565217,6,8
2020020861,2021-05-08,2,NSH,3,1,CAR,21,11,5,3,40,20,12,15,1,48,21,11,5,3,40,20,12,15,1,48,1,0,30,22,0.44898,0.55102,2,6
2020020862,2021-05-08,2,TOR,3,2,MTL,23,11,7,3,44,17,9,13,2,41,23,11,7,3,44,17,9,13,2,41,0,1,26,23,0.625,0.375,6,4
2020020863,2021-05-08,2,WPG,2,4,OTT,25,11,15,2,53,18,13,15,3,49,25,11,15,2,53,18,13,15,3,49,0,1,29,23,0.478261,0.521739,4,4
2020020864,2021-05-18,2,VAN,4,2,CGY,20,9,7,4,40,34,7,8,2,51,19,8,7,4,38,34,7,8,2,51,1,0,24,40,0.474576,0.525424,11,11
2020020865,2021-05-08,2,MIN,4,3,ANA,16,11,5,3,35,16,6,13,3,38,14,10,5,2,31,14,6,12,3,35,0,1,25,22,0.490909,0.509091,4,10
2020020866,2021-05-08,2,VGK,4,1,STL,22,15,15,2,54,14,11,14,1,40,21,13,13,2,49,12,10,13,0,35,1,0,29,21,0.428571,0.571429,10,12
2020020867,2021-05-08,2,L.A,2,3,COL,13,9,13,2,37,18,8,11,2,39,13,9,13,2,37,18,8,11,2,39,0,1,18,30,0.577778,0.422222,6,4
2020020868,2021-05-08,2,S.J,4,5,ARI,39,8,7,4,58,26,6,6,4,42,36,7,7,4,54,24,6,6,2,38,0,1,48,32,0.484375,0.515625,6,6
2020030111,2021-05-16,3,PIT,3,4,NYI,36,9,10,3,58,33,7,11,4,55,36,9,10,3,58,33,7,11,4,55,0,1,42,41,0.528571,0.471429,4,6
2020030112,2021-05-18,3,PIT,2,1,NYI,42,7,16,2,67,35,6,6,1,48,40,7,15,2,64,33,5,5,1,44,1,0,45,38,0.52,0.48,6,8
2020030113,2021-05-20,3,NYI,4,5,PIT,23,9,15,3,50,20,8,14,4,46,23,8,13,3,47,18,8,14,4,44,0,1,30,27,0.526316,0.473684,16,20
2020030114,2021-05-22,3,NYI,4,1,PIT,21,5,9,2,37,28,15,14,0,57,18,5,9,2,34,28,14,13,0,55,1,0,26,30,0.66,0.34,4,12
2020030115,2021-05-24,3,PIT,2,3,NYI,43,22,12,1,78,24,6,8,3,41,43,22,12,1,78,24,6,8,3,41,1,0,50,28,0.52459,0.47541,4,4
2020030116,2021-05-26,3,NYI,5,3,PIT,16,10,10,5,41,31,18,22,2,73,16,10,10,5,41,31,18,22,2,73,0,1,24,37,0.561404,0.438596,4,4
2020030121,2021-05-15,3,WSH,3,2,BOS,23,15,17,3,58,20,18,13,1,52,22,14,16,3,55,20,18,13,1,52,1,0,32,26,0.4,0.6,8,2
2020030122,2021-05-17,3,WSH,3,4,BOS,28,9,13,2,52,40,20,16,4,80,26,8,13,2,49,32,18,16,4,70,0,1,39,48,0.369231,0.630769,12,16
2020030123,2021-05-19,3,BOS,3,2,WSH,28,16,17,2,63,28,15,12,1,56,28,16,17,2,63,28,15,11,1,55,0,1,43,37,0.476744,0.523256,10,10
2020030124,2021-05-21,3,BOS,4,1,WSH,28,8,4,1,41,14,9,12,0,35,28,8,4,1,41,14,9,12,0,35,1,0,37,20,0.555556,0.444444,18,14
2020030125,2021-05-23,3,WSH,1,3,BOS,33,10,14,1,58,11,14,12,3,40,33,10,14,1,58,10,13,11,3,37,0,1,41,19,0.53125,0.46875,8,10
2020030131,2021-05-17,3,CAR,5,2,NSH,25,10,10,5,50,19,9,11,2,41,23,9,10,4,46,15,8,11,2,36,0,1,38,24,0.514286,0.485714,20,22
2020030132,2021-05-19,3,CAR,3,0,NSH,20,10,8,2,40,22,9,11,0,42,19,8,7,2,36,17,8,10,0,35,1,0,31,32,0.47541,0.52459,18,10
2020030133,2021-05-21,3,NSH,5,4,CAR,34,18,18,4,74,47,14,18,3,82,34,18,18,4,74,47,14,18,3,82,1,0,54,56,0.5,0.5,6,14
2020030134,2021-05-23,3,NSH,4,3,CAR,35,14,14,3,66,52,31,27,3,113,34,14,13,3,64,51,31,27,3,112,1,0,43,61,0.450549,0.549451,10,6
2020030135,2021-05-25,3,CAR,3,2,NSH,30,13,15,2,60,22,8,11,2,43,29,13,15,1,58,22,8,11,2,43,0,1,37,25,0.586667,0.413333,8,8
2020030136,2021-05-27,3,NSH,3,4,CAR,21,19,9,2,51,25,13,19,3,60,21,19,8,2,50,25,13,19,3,60,1,0,27,31,0.55,0.45,6,8
2020030141,2021-05-16,3,FLA,4,5,T.B,29,9,13,3,54,30,4,14,1,49,22,7,12,3,44,25,3,13,1,42,0,1,39,40,0.493151,0.506849,18,16
2020030142,2021-05-18,3,FLA,1,3,T.B,29,13,13,1,56,22,6,10,3,41,29,13,13,1,56,22,6,10,3,41,0,1,33,29,0.508772,0.491228,18,8
2020030143,2021-05-20,3,T.B,5,6,FLA,25,7,8,3,43,37,8,13,4,62,25,7,8,3,43,37,8,13,4,62,0,1,31,47,0.520548,0.479452,6,8
2020030144,2021-05-22,3,T.B,6,2,FLA,16,4,4,4,28,24,10,8,0,42,15,4,4,3,26,21,10,8,0,39,1,0,26,41,0.451613,0.548387,42,50
2020030145,2021-05-24,3,FLA,4,1,T.B,26,9,11,3,49,31,9,9,1,50,25,9,10,3,47,29,9,9,1,48,0,1,38,37,0.517241,0.482759,6,22
2020030146,2021-05-26,3,T.B,4,0,FLA,20,6,9,3,38,25,12,11,0,48,20,6,9,3,38,25,12,11,0,48,1,0,24,29,0.469388,0.530612,4,6
2020030151,2021-05-17,3,COL,4,1,STL,41,8,16,3,68,16,8,12,1,37,41,8,16,3,68,16,8,12,1,37,1,0,50,23,0.470588,0.529412,9,11
2020030152,2021-05-19,3,COL,6,3,STL,28,6,14,4,52,28,9,9,2,48,28,6,14,4,52,28,9,9,2,48,1,0,35,35,0.642857,0.357143,10,4
2020030153,2021-05-21,3,STL,1,5,COL,27,6,12,0,45,16,14,9,4,43,25,6,12,0,43,16,13,9,4,42,0,1,32,26,0.481481,0.518519,10,8
2020030154,2021-05-23,3,STL,2,5,COL,15,10,12,1,38,28,14,18,2,62,15,9,10,1,35,26,14,17,2,59,1,0,20,34,0.526316,0.473684,8,6
2020030161,2021-05-16,3,VGK,0,1,MIN,35,11,19,0,65,26,4,10,1,41,35,11,19,0,65,26,4,10,1,41,0,0,42,30,0.621212,0.378788,4,6
2020030162,2021-05-18,3,VGK,3,1,MIN,23,8,22,2,55,31,11,20,1,63,23,8,22,2,55,29,10,19,1,59,0,1,28,35,0.596774,0.403226,4,6
2020030163,2021-05-20,3,MIN,2,5,VGK,13,11,19,2,45,20,5,12,5,42,13,11,19,2,45,20,5,12,5,42,1,0,16,40,0.473684,0.526316,10,4
2020030164,2021-05-22,3,MIN,0,4,VGK,30,12,15,0,57,13,11,12,3,39,30,12,15,0,57,13,11,12,3,39,0,1,35,18,0.444444,0.555556,2,6
2020030165,2021-05-24,3,VGK,2,4,MIN,33,19,19,1,72,10,5,13,4,32,33,19,19,1,72,10,5,13,4,32,1,0,40,14,0.48,0.52,0,4
2020030166,2021-05-26,3,MIN,3,0,VGK,20,7,10,2,39,21,20,16,0,57,20,7,10,2,39,21,20,16,0,57,1,0,24,23,0.43662,0.56338,9,9
2020030167,2021-05-28,3,VGK,6,2,MIN,25,18,16,6,65,16,8,15,1,40,24,18,16,6,64,16,8,15,1,40,1,0,34,20,0.66129,0.33871,10,8
2020030171,2021-05-20,3,TOR,1,2,MTL,28,6,7,1,42,17,3,8,1,29,28,6,7,1,42,17,3,8,1,29,0,1,36,30,0.442857,0.557143,15,13
2020030172,2021-05-22,3,TOR,5,1,MTL,22,11,12,3,48,18,6,17,1,42,22,11,12,3,48,18,6,17,1,42,0,1,34,23,0.660714,0.339286,14,24
2020030173,2021-05-24,3,MTL,1,2,TOR,26,6,14,1,47,21,6,11,2,40,26,6,14,1,47,21,6,11,2,40,0,1,29,29,0.5,0.5,12,10
2020030174,2021-05-25,3,MTL,0,4,TOR,25,6,18,0,49,23,4,16,3,46,25,6,18,0,49,23,4,16,3,46,0,1,32,28,0.561404,0.438596,4,8
2020030175,2021-05-27,3,TOR,3,4,MTL,30,7,10,3,50,25,8,12,4,49,30,7,10,3,50,25,8,12,4,49,0,1,35,30,0.482759,0.517241,2,2
2020030176,2021-05-29,3,MTL,3,2,TOR,22,14,22,1,59,37,10,17,2,66,22,14,22,1,59,37,10,17,2,66,1,0,31,43,0.478873,0.521127,8,8
2020030177,2021-05-31,3,TOR,1,3,MTL,26,7,12,1,46,20,9,8,2,39,26,7,12,1,46,20,9,8,2,39,0,1,31,23,0.509434,0.490566,2,4
2020030181,2021-05-19,3,EDM,1,4,WPG,31,13,17,1,62,18,7,8,4,37,31,13,17,1,62,18,7,8,4,37,1,0,33,22,0.395833,0.604167,0,2
2020030182,2021-05-21,3,EDM,0,1,WPG,34,9,20,0,63,31,8,14,1,54,33,9,19,0,61,31,8,14,1,54,0,0,38,36,0.57377,0.42623,6,8
2020030183,2021-05-23,3,WPG,5,4,EDM,28,13,20,3,64,36,11,12,3,62,28,13,20,3,64,36,11,12,3,62,0,1,37,48,0.629032,0.370968,6,6
2020030184,2021-05-24,3,WPG,4,3,EDM,34,14,22,3,73,28,23,40,2,93,34,14,22,3,73,28,23,40,2,93,1,0,43,40,0.538462,0.461538,8,10
2020030211,2021-05-29,3,BOS,5,2,NYI,32,14,9,3,58,17,8,6,1,32,32,14,9,3,58,16,7,6,1,30,0,1,40,22,0.517857,0.482143,6,4
2020030212,2021-05-31,3,BOS,3,4,NYI,38,18,18,2,76,30,12,12,2,56,34,16,16,2,68,28,11,12,2,53,1,0,42,39,0.491803,0.508197,10,8
2020030213,2021-06-03,3,NYI,1,2,BOS,23,10,11,1,45,31,7,19,2,59,23,10,11,1,45,31,7,19,2,59,0,1,29,41,0.555556,0.444444,4,6
2020030214,2021-06-05,3,NYI,4,1,BOS,26,10,18,4,58,19,14,12,0,45,26,10,18,4,58,19,14,12,0,45,0,1,34,29,0.5,0.5,16,14
2020030215,2021-06-07,3,BOS,4,5,NYI,33,16,15,3,67,13,10,5,2,30,33,16,14,3,66,13,10,5,2,30,1,0,44,19,0.509434,0.490566,8,4
2020030216,2021-06-09,3,NYI,6,2,BOS,23,3,20,6,52,22,13,18,0,53,23,3,20,6,52,22,13,18,0,53,1,0,29,25,0.428571,0.571429,6,2
2020030221,2021-05-30,3,CAR,1,2,T.B,29,12,16,0,57,27,8,10,1,46,28,11,16,0,55,26,8,10,1,45,0,1,38,30,0.527273,0.472727,6,10
2020030222,2021-06-01,3,CAR,1,2,T.B,28,13,14,1,56,12,10,12,2,36,28,13,14,1,56,12,10,12,2,36,0,1,32,15,0.516667,0.483333,4,4
2020030223,2021-06-03,3,T.B,2,3,CAR,30,11,12,0,53,22,13,9,2,46,30,11,12,0,53,22,13,9,2,46,0,1,37,27,0.433962,0.566038,4,6
2020030224,2021-06-05,3,T.B,6,4,CAR,13,14,7,3,37,20,17,10,4,51,12,14,7,3,36,20,17,10,4,51,1,0,26,25,0.421053,0.578947,6,14
2020030225,2021-06-08,3,CAR,0,2,T.B,25,13,18,0,56,21,14,12,1,48,24,13,18,0,55,20,12,12,1,45,0,1,29,25,0.425532,0.574468,8,10
2020030231,2021-05-30,3,COL,7,1,VGK,19,6,7,5,37,18,10,11,1,40,20,6,7,5,38,18,10,11,1,40,1,0,37,25,0.428571,0.571429,30,44
2020030232,2021-06-02,3,COL,3,2,VGK,12,5,19,1,37,34,9,16,1,60,12,5,19,1,37,34,9,16,1,60,1,0,25,41,0.4375,0.5625,6,12
2020030233,2021-06-04,3,VGK,3,2,COL,35,21,18,3,77,16,11,18,1,46,35,21,18,3,77,16,11,18,1,46,1,0,43,20,0.5,0.5,4,4
2020030234,2021-06-06,3,VGK,5,1,COL,24,6,13,4,47,17,7,15,1,40,24,6,12,4,46,16,7,14,1,38,0,1,35,18,0.477273,0.522727,6,10
2020030235,2021-06-08,3,COL,2,3,VGK,27,7,26,2,62,21,10,10,3,44,27,7,26,2,62,21,10,10,3,44,1,0,30,25,0.5,0.5,2,2
2020030236,2021-06-10,3,VGK,6,3,COL,16,13,17,6,52,29,9,33,2,73,16,13,17,6,52,29,9,33,2,73,0,1,23,33,0.473684,0.526316,2,2
2020030241,2021-06-02,3,WPG,3,5,MTL,20,6,7,2,35,22,11,7,4,44,20,5,7,2,34,22,11,7,4,44,0,1,30,33,0.480769,0.519231,21,6
2020030242,2021-06-04,3,WPG,0,1,MTL,28,10,17,0,55,23,8,9,0,40,28,10,17,0,55,23,8,9,0,40,0,1,30,24,0.55,0.45,2,4
2020030243,2021-06-06,3,MTL,5,1,WPG,24,6,16,2,48,25,16,17,1,59,22,6,16,2,46,25,16,17,1,59,1,0,33,27,0.484848,0.515152,4,10
2020030244,2021-06-07,3,MTL,3,2,WPG,34,11,17,2,64,11,8,9,2,30,34,11,17,2,64,11,8,9,2,30,1,0,42,16,0.482143,0.517857,2,6
2020030311,2021-06-14,3,VGK,4,1,MTL,21,14,12,4,51,26,6,15,0,47,20,14,12,4,50,26,5,15,0,46,1,0,30,29,0.438596,0.561404,6,8
2020030312,2021-06-16,3,VGK,2,3,MTL,27,12,22,2,63,18,7,18,3,46,27,12,22,2,63,18,7,18,3,46,0,1,31,23,0.416667,0.583333,0,4
2020030313,2021-06-18,3,MTL,3,2,VGK,22,10,20,3,55,32,9,18,2,61,22,10,20,3,55,32,9,18,2,61,0,1,27,45,0.491525,0.508475,8,4
2020030314,2021-06-20,3,MTL,1,2,VGK,25,10,15,1,51,17,15,18,2,52,25,10,15,1,51,15,14,18,2,49,1,0,28,21,0.436364,0.563636,4,4
2020030315,2021-06-22,3,VGK,1,4,MTL,23,8,17,1,49,20,5,7,3,35,23,8,17,1,49,20,5,7,3,35,0,1,27,26,0.576271,0.423729,4,4
2020030316,2021-06-24,3,MTL,3,2,VGK,24,3,12,2,41,34,11,12,2,59,22,3,12,2,39,34,11,12,2,59,1,0,32,39,0.469697,0.530303,4,6
2020030321,2021-06-13,3,T.B,1,2,NYI,23,10,11,0,44,24,6,5,2,37,22,9,11,0,42,23,6,4,2,35,0,1,31,31,0.391304,0.608696,8,6
2020030322,2021-06-15,3,T.B,4,2,NYI,21,5,13,3,42,17,7,7,1,32,20,5,11,3,39,17,7,6,1,31,1,0,33,26,0.470588,0.529412,21,33
2020030323,2021-06-17,3,NYI,1,2,T.B,26,12,18,1,57,22,10,14,2,48,26,12,18,1,57,22,10,14,2,48,0,1,28,25,0.469388,0.530612,2,2
2020030324,2021-06-19,3,NYI,3,2,T.B,22,12,7,3,44,27,12,16,2,57,22,12,7,3,44,26,12,16,2,56,1,0,30,30,0.5625,0.4375,4,8
2020030325,2021-06-21,3,T.B,8,0,NYI,26,7,5,5,43,17,7,10,0,34,26,7,5,5,43,17,7,10,0,34,1,0,42,21,0.509091,0.490909,28,57
2020030326,2021-06-23,3,NYI,3,2,T.B,22,10,16,3,51,17,9,13,2,41,21,10,15,3,49,17,9,13,2,41,0,1,28,24,0.583333,0.416667,6,8
2020030327,2021-06-25,3,T.B,1,0,NYI,30,8,8,0,46,15,10,19,0,44,30,8,8,0,46,15,10,19,0,44,1,0,31,18,0.5,0.5,2,0
2020030411,2021-06-28,3,T.B,5,1,MTL,19,9,5,4,37,16,15,13,1,45,19,9,5,4,37,16,15,12,1,44,1,0,27,19,0.5,0.5,6,8
2020030412,2021-06-30,3,T.B,3,1,MTL,15,11,8,3,37,37,8,13,0,58,15,11,8,3,37,37,8,13,0,58,1,0,23,43,0.473684,0.526316,20,20
2020030413,2021-07-02,3,MTL,3,6,T.B,30,10,13,3,56,24,7,11,5,47,30,10,13,3,56,24,7,11,5,47,0,1,35,30,0.491803,0.508197,2,2
2020030414,2021-07-05,3,MTL,3,2,T.B,13,5,14,3,35,22,12,15,2,51,11,5,14,3,33,21,12,15,2,50,1,0,21,34,0.520833,0.479167,20,12
2020030415,2021-07-07,3,T.B,1,0,MTL,21,8,8,1,38,21,9,9,0,39,21,8,8,1,38,21,9,9,0,39,1,0,30,22,0.517241,0.482759,8,8
