gameId,gameDate,gameType,Team Home,Score Home,Score Away,Team Away,Shot Home EV,Miss Home EV,Block Home EV,Goal Home EV,CF EV,Shot Away EV,Miss Away EV,Block Away EV,Goal Away EV,CA EV,Shot Home 5v5,Miss Home 5v5,Block Home 5v5,Goal Home 5V5,CF 5v5,Shot Away 5v5,Miss Away 5v5,Block Away 5v5,Goal Away 5v5,CA 5v5,First Goal Home,First Goal Away,SOG Home,SOG Away,Faceoff Home,Faceoff Away,Pim Home,Pim Away
2023020001,2023-10-10,2,TBL,5,3,NSH,21,12,9,3,45,21,10,15,2,48,21,12,9,2,44,21,10,15,2,48,1,0,34,31,0.566667,0.433333,8,10
2023020002,2023-10-10,2,PIT,2,4,CHI,35,12,14,2,63,26,13,13,4,56,35,12,14,2,63,26,13,13,4,56,1,0,41,36,0.677966,0.322034,8,4
2023020003,2023-10-10,2,VGK,4,1,SEA,21,7,12,4,44,22,10,18,1,51,21,7,12,4,44,22,10,18,1,51,1,0,28,33,0.591837,0.408163,11,8
2023020004,2023-10-11,2,CAR,5,3,OTT,32,15,12,3,62,17,12,6,2,37,31,15,12,3,61,17,12,6,2,37,0,1,42,30,0.522388,0.477612,10,14
2023020005,2023-10-11,2,TOR,6,5,MTL,31,11,13,4,59,17,12,12,4,45,27,10,13,3,53,15,10,11,4,40,0,1,42,24,0.481481,0.518519,15,25
2023020006,2023-10-11,2,BOS,3,1,CHI,25,14,23,3,65,17,12,10,1,40,25,14,23,3,65,17,12,10,1,40,0,1,33,21,0.62963,0.37037,13,23
2023020007,2023-10-11,2,CGY,5,3,WPG,11,6,13,3,33,20,15,23,3,61,11,6,13,3,33,20,15,23,3,61,1,0,22,37,0.61039,0.38961,8,6
2023020008,2023-10-11,2,LAK,2,5,COL,23,11,16,2,52,25,7,11,4,47,23,11,16,2,52,25,7,11,4,47,0,1,36,37,0.515625,0.484375,15,19
2023020009,2023-10-11,2,VAN,8,1,EDM,14,8,7,5,34,19,11,10,0,40,14,8,7,5,34,19,11,10,0,40,1,0,32,27,0.460317,0.539683,13,17
2023020010,2023-10-12,2,BUF,1,5,NYR,20,7,14,1,42,23,9,10,3,45,18,7,14,1,40,22,9,10,3,44,0,1,25,31,0.366667,0.633333,10,8
2023020011,2023-10-12,2,CBJ,2,4,PHI,27,7,16,2,52,25,13,22,4,64,27,6,15,2,50,23,13,19,4,59,0,1,33,37,0.537037,0.462963,8,10
2023020012,2023-10-12,2,NJD,4,3,DET,19,22,11,3,55,25,9,9,1,44,18,21,10,2,51,23,8,8,1,40,0,1,27,35,0.423729,0.576271,8,12
2023020013,2023-10-12,2,DAL,2,1,STL,30,16,16,3,65,21,8,15,2,46,26,14,16,1,57,16,7,15,1,39,1,0,34,24,0.525424,0.474576,6,8
2023020014,2023-10-12,2,MIN,2,0,FLA,12,6,11,1,30,33,8,24,0,65,10,5,11,1,27,32,8,24,0,64,1,0,21,41,0.403226,0.596774,10,12
2023020015,2023-10-12,2,NSH,3,0,SEA,26,13,17,2,58,21,13,15,0,49,25,13,16,2,56,19,13,14,0,46,1,0,35,23,0.5625,0.4375,6,8
2023020016,2023-10-12,2,SJS,1,4,VGK,19,9,11,1,40,24,7,19,4,54,19,9,11,1,40,24,7,19,4,54,0,1,23,32,0.553571,0.446429,7,9
2023020017,2023-10-13,2,NJD,3,4,ARI,27,9,15,1,52,23,5,10,3,41,22,7,15,0,44,22,4,10,1,37,0,1,36,33,0.491803,0.508197,16,12
2023020018,2023-10-13,2,WSH,0,4,PIT,17,9,17,0,43,28,14,15,2,59,17,8,17,0,42,28,13,14,2,57,0,1,19,35,0.447761,0.552239,13,13
2023020019,2023-10-14,2,OTT,5,2,PHI,20,6,9,2,37,13,8,14,1,36,20,6,9,2,37,13,8,14,1,36,1,0,31,21,0.616667,0.383333,21,19
2023020020,2023-10-14,2,WPG,6,4,FLA,25,8,8,3,44,16,8,8,3,35,25,7,8,3,43,16,8,8,3,35,1,0,35,33,0.602941,0.397059,21,19
2023020021,2023-10-14,2,BOS,3,2,NSH,18,5,19,1,43,18,15,9,2,44,18,5,19,0,42,17,14,9,2,42,0,1,30,36,0.421875,0.578125,14,10
2023020022,2023-10-14,2,CBJ,5,3,NYR,15,11,10,4,40,35,19,24,2,80,15,11,10,4,40,35,19,24,2,80,0,1,21,42,0.423729,0.576271,6,2
2023020023,2023-10-14,2,DET,6,4,TBL,34,10,10,6,60,20,15,23,3,61,34,10,10,6,60,20,15,23,3,61,1,0,42,25,0.46,0.54,6,4
2023020024,2023-10-14,2,MTL,3,2,CHI,24,7,17,2,50,14,7,9,2,32,23,7,17,2,49,14,7,8,1,30,1,0,36,30,0.75,0.25,20,8
2023020025,2023-10-14,2,PIT,5,2,CGY,17,9,4,5,35,31,17,23,1,72,17,9,3,5,34,28,17,23,1,69,0,1,29,36,0.46875,0.53125,8,6
2023020026,2023-10-14,2,TOR,7,4,MIN,23,9,7,5,44,26,13,16,4,59,22,8,7,5,42,26,13,16,4,59,0,1,33,32,0.514286,0.485714,9,13
2023020027,2023-10-14,2,NYI,3,2,BUF,23,9,15,3,50,25,8,15,2,50,23,8,15,3,49,25,8,15,2,50,1,0,29,28,0.646154,0.353846,4,6
2023020028,2023-10-14,2,STL,2,1,SEA,24,12,10,2,48,31,11,19,0,61,21,11,10,1,43,26,10,18,0,54,0,1,25,31,0.403846,0.596154,2,8
2023020029,2023-10-14,2,EDM,3,4,VAN,27,14,21,1,63,11,3,7,3,24,27,14,21,1,63,10,2,7,3,22,1,0,40,16,0.482759,0.517241,6,14
2023020030,2023-10-14,2,SJS,1,2,COL,17,13,11,1,42,41,24,25,2,92,14,12,9,1,36,38,23,25,1,87,1,0,21,52,0.578125,0.421875,10,8
2023020031,2023-10-14,2,VGK,4,1,ANA,25,10,17,2,54,18,12,10,1,41,25,10,16,2,53,17,12,10,1,40,1,0,38,23,0.517857,0.482143,17,22
2023020032,2023-10-14,2,LAK,5,6,CAR,25,12,16,5,58,15,11,10,6,42,19,8,14,3,44,9,7,9,3,28,0,1,30,19,0.529412,0.470588,10,16
2023020033,2023-10-15,2,OTT,5,2,TBL,29,5,16,5,55,19,8,15,2,44,28,5,16,5,54,18,8,15,2,43,1,0,38,24,0.423729,0.576271,6,8
2023020034,2023-10-15,2,ANA,6,3,CAR,18,12,8,6,44,24,19,24,1,68,17,10,8,5,40,22,19,24,1,66,1,0,25,35,0.5,0.5,28,20
2023020035,2023-10-16,2,CBJ,0,4,DET,17,5,10,0,32,18,7,7,2,34,17,5,10,0,32,17,7,7,2,33,0,1,23,28,0.327273,0.672727,15,13
2023020036,2023-10-16,2,NJD,3,4,FLA,20,10,19,1,50,21,8,9,3,41,20,10,19,1,50,21,8,9,3,41,0,1,34,30,0.483871,0.516129,10,12
2023020037,2023-10-16,2,NYR,2,1,ARI,20,15,15,1,51,19,7,11,0,37,20,15,15,1,51,18,7,11,0,36,1,0,28,27,0.458333,0.541667,38,44
2023020038,2023-10-16,2,TOR,1,4,CHI,32,21,25,1,79,24,6,21,2,53,32,21,25,1,79,23,6,20,2,51,0,1,36,31,0.627119,0.372881,13,11
2023020039,2023-10-16,2,WSH,3,2,CGY,18,9,14,3,44,32,10,18,1,61,16,8,14,2,40,29,8,18,1,56,0,1,23,40,0.387097,0.612903,10,6
2023020040,2023-10-17,2,BUF,3,2,TBL,24,12,10,3,49,20,14,10,2,46,22,10,9,2,43,20,13,10,2,45,1,0,31,25,0.509434,0.490566,13,11
2023020041,2023-10-17,2,MTL,2,5,MIN,16,9,4,2,31,15,6,16,0,37,14,9,4,2,29,15,6,16,0,37,0,1,28,35,0.545455,0.454545,40,44
2023020042,2023-10-17,2,PHI,2,0,VAN,31,6,9,2,48,21,13,13,0,47,30,6,8,1,45,19,13,13,0,45,1,0,42,26,0.5,0.5,20,22
2023020043,2023-10-17,2,NYI,1,0,ARI,28,15,12,0,55,14,13,12,0,39,27,15,12,0,54,14,13,11,0,38,1,0,34,14,0.66,0.34,8,8
2023020044,2023-10-17,2,NSH,1,6,EDM,37,7,9,0,53,18,11,8,4,41,37,7,9,0,53,18,11,8,4,41,0,1,44,30,0.508197,0.491803,11,11
2023020045,2023-10-17,2,WPG,1,5,LAK,17,8,16,1,42,21,10,7,4,42,17,8,16,1,42,21,10,7,4,42,0,1,27,29,0.54717,0.45283,29,17
2023020046,2023-10-17,2,SEA,1,4,COL,27,10,15,1,53,22,10,16,3,51,25,10,14,1,50,21,10,15,2,48,1,0,38,28,0.580645,0.419355,11,15
2023020047,2023-10-17,2,SJS,3,6,CAR,9,3,7,1,20,21,7,22,2,52,9,3,7,1,20,20,7,22,2,51,1,0,16,42,0.469697,0.530303,14,22
2023020048,2023-10-17,2,VGK,3,2,DAL,24,8,15,4,51,21,13,19,3,56,19,8,14,2,43,19,10,18,2,49,0,1,34,26,0.478873,0.521127,14,18
2023020049,2023-10-18,2,OTT,6,1,WSH,17,9,16,5,47,18,8,13,1,40,17,9,16,5,47,18,8,13,1,40,1,0,29,24,0.603774,0.396226,13,19
2023020050,2023-10-18,2,DET,6,3,PIT,19,10,8,4,41,23,13,21,3,60,17,10,8,4,39,23,12,21,3,59,0,1,29,33,0.45614,0.54386,13,13
2023020051,2023-10-19,2,BUF,3,4,CGY,17,6,9,2,34,23,12,8,4,47,17,6,9,2,34,23,12,8,4,47,0,1,27,36,0.446154,0.553846,12,12
2023020052,2023-10-19,2,FLA,3,1,TOR,13,10,15,2,40,20,6,22,0,48,12,10,14,2,38,20,6,22,0,48,1,0,24,30,0.571429,0.428571,10,8
2023020053,2023-10-19,2,NYR,1,4,NSH,19,8,18,0,45,22,7,9,2,40,19,8,18,0,45,22,7,9,2,40,0,1,24,27,0.54,0.46,8,8
2023020054,2023-10-19,2,PHI,4,1,EDM,24,6,2,3,35,17,9,18,1,45,24,6,2,3,35,17,9,18,1,45,1,0,32,23,0.522388,0.477612,4,8
2023020055,2023-10-19,2,TBL,4,3,VAN,23,4,12,2,41,24,5,24,3,56,23,4,12,2,41,24,5,24,3,56,1,0,36,29,0.457627,0.542373,7,11
2023020056,2023-10-19,2,MIN,3,7,LAK,25,12,7,3,47,19,8,14,6,47,25,12,7,3,47,19,8,14,6,47,0,1,32,27,0.606061,0.393939,0,8
2023020057,2023-10-19,2,STL,2,6,ARI,18,9,8,2,37,31,9,13,3,56,18,9,8,2,37,30,9,13,3,55,0,1,26,42,0.445946,0.554054,8,14
2023020058,2023-10-19,2,WPG,3,5,VGK,36,11,15,2,64,20,6,23,3,52,36,11,15,2,64,20,6,23,3,52,1,0,39,27,0.404255,0.595745,4,4
2023020059,2023-10-19,2,ANA,2,3,DAL,22,9,19,2,52,20,15,9,1,45,22,9,19,2,52,19,14,9,1,43,1,0,29,24,0.365385,0.634615,10,8
2023020060,2023-10-19,2,SEA,7,4,CAR,27,3,16,4,50,29,13,21,3,66,27,3,16,4,50,29,13,21,3,66,1,0,36,36,0.544118,0.455882,9,13
2023020061,2023-10-19,2,COL,4,0,CHI,30,8,16,2,56,15,7,8,0,30,30,8,16,2,56,15,7,8,0,30,1,0,41,18,0.528302,0.471698,8,6
2023020062,2023-10-19,2,SJS,1,3,BOS,23,18,19,1,61,26,12,9,3,50,23,18,19,1,61,26,12,8,3,49,0,1,27,36,0.532258,0.467742,2,6
2023020063,2023-10-20,2,CBJ,3,1,CGY,23,14,17,3,57,29,13,17,0,59,23,14,17,3,57,29,13,17,0,59,1,0,29,37,0.574074,0.425926,11,24
2023020064,2023-10-20,2,NYI,4,5,NJD,26,6,7,4,43,29,8,26,1,64,23,6,6,4,39,28,8,25,0,61,1,0,32,39,0.516667,0.483333,12,6
2023020065,2023-10-21,2,OTT,2,5,DET,24,14,10,1,49,13,9,10,2,34,22,14,10,1,47,10,9,9,2,30,1,0,37,23,0.618182,0.381818,21,23
2023020066,2023-10-21,2,ARI,2,1,ANA,18,9,15,1,43,22,11,11,0,44,16,8,15,1,40,19,11,10,0,40,1,0,27,33,0.590909,0.409091,15,19
2023020067,2023-10-21,2,BUF,3,1,NYI,30,13,20,3,66,19,8,10,1,38,30,13,20,3,66,19,8,10,1,38,1,0,42,25,0.678571,0.321429,11,11
2023020068,2023-10-21,2,FLA,3,5,VAN,31,12,15,3,61,17,8,13,3,41,31,12,15,3,61,17,8,13,3,41,0,1,36,31,0.528302,0.471698,6,4
2023020069,2023-10-21,2,MTL,3,2,WSH,19,11,18,2,50,23,9,14,2,48,19,11,17,1,48,22,9,14,2,47,1,0,28,33,0.584906,0.415094,10,12
2023020070,2023-10-21,2,TBL,3,4,TOR,25,11,16,1,53,42,13,14,4,73,25,10,16,1,52,38,11,14,3,66,0,1,31,52,0.587302,0.412698,4,8
2023020071,2023-10-21,2,CHI,3,5,VGK,15,4,13,2,34,15,6,9,3,33,15,4,13,2,34,15,6,9,3,33,1,0,24,24,0.423729,0.576271,10,10
2023020072,2023-10-21,2,DAL,5,4,PHI,20,11,14,5,50,32,14,14,1,61,19,11,14,4,48,31,14,14,1,60,1,0,25,40,0.536232,0.463768,9,23
2023020073,2023-10-21,2,MIN,4,5,CBJ,19,10,24,4,57,38,13,24,4,79,17,10,24,4,55,34,13,23,3,73,0,1,28,54,0.344262,0.655738,6,6
2023020074,2023-10-21,2,NSH,5,1,SJS,21,9,8,3,41,24,5,16,1,46,21,9,8,3,41,24,5,16,1,46,1,0,34,32,0.438596,0.561404,9,15
2023020075,2023-10-21,2,STL,4,2,PIT,14,13,8,4,39,28,22,26,2,78,14,13,8,4,39,28,22,26,2,78,1,0,21,33,0.48,0.52,4,4
2023020076,2023-10-21,2,COL,6,4,CAR,16,13,8,2,39,17,11,15,3,46,16,13,8,2,39,17,11,15,3,46,0,1,27,27,0.516129,0.483871,10,10
2023020077,2023-10-21,2,EDM,2,3,WPG,35,10,8,1,54,17,7,11,1,36,32,10,8,1,51,14,7,10,0,31,1,0,40,27,0.515152,0.484848,17,15
2023020078,2023-10-21,2,SEA,1,4,NYR,18,10,13,1,42,19,13,8,4,44,18,10,13,1,42,19,13,8,4,44,1,0,19,27,0.444444,0.555556,21,15
2023020079,2023-10-21,2,LAK,2,4,BOS,23,14,19,1,57,17,10,12,3,42,23,13,19,1,56,17,10,12,3,42,0,1,34,25,0.52,0.48,13,17
2023020080,2023-10-22,2,DET,6,2,CGY,15,4,9,6,34,24,12,9,2,47,15,4,9,6,34,24,12,9,2,47,1,0,30,31,0.561404,0.438596,4,10
2023020081,2023-10-22,2,ANA,1,3,BOS,24,16,9,1,50,12,11,7,3,33,24,16,9,1,50,10,10,6,3,29,1,0,31,26,0.5,0.5,12,8
2023020082,2023-10-23,2,BUF,1,3,MTL,26,12,13,0,51,15,7,10,2,34,26,12,13,0,51,15,7,10,2,34,0,1,37,27,0.472727,0.527273,6,10
2023020083,2023-10-24,2,WSH,1,4,TOR,23,12,10,0,45,10,5,14,2,31,22,12,10,0,44,10,5,14,2,31,0,1,38,17,0.465116,0.534884,6,6
2023020084,2023-10-24,2,CBJ,2,3,ANA,21,15,14,1,51,17,7,13,3,40,20,14,13,1,48,16,6,12,2,36,1,0,37,27,0.385965,0.614035,8,14
2023020085,2023-10-24,2,OTT,4,6,BUF,26,10,12,3,51,17,7,10,4,38,26,10,12,3,51,17,7,10,4,38,0,1,38,24,0.567164,0.432836,27,31
2023020086,2023-10-24,2,TBL,3,0,CAR,15,8,7,2,32,25,11,17,0,53,15,8,7,2,32,24,11,17,0,52,1,0,23,32,0.519231,0.480769,17,37
2023020087,2023-10-24,2,MTL,2,5,NJD,24,6,12,1,43,24,17,18,3,62,24,6,12,1,43,24,17,18,3,62,1,0,29,34,0.366667,0.633333,8,8
2023020088,2023-10-24,2,PIT,1,4,DAL,28,13,16,1,58,25,14,12,4,55,27,13,16,1,57,25,13,12,4,54,1,0,39,34,0.532258,0.467742,6,8
2023020089,2023-10-24,2,FLA,3,1,SJS,24,10,21,2,57,23,9,8,0,40,23,9,19,2,53,23,9,8,0,40,0,1,36,28,0.38,0.62,6,8
2023020090,2023-10-24,2,NYI,4,7,COL,21,11,8,3,43,25,11,16,6,58,21,10,8,3,42,22,10,16,6,54,0,1,32,38,0.62069,0.37931,10,12
2023020091,2023-10-24,2,DET,4,5,SEA,18,12,12,1,43,29,20,19,3,71,17,9,12,1,39,29,16,18,2,65,1,0,27,38,0.482759,0.517241,12,14
2023020092,2023-10-24,2,CHI,0,3,BOS,21,9,10,0,40,36,8,10,3,57,20,8,10,0,38,34,8,10,3,55,0,1,23,43,0.492308,0.507692,10,8
2023020093,2023-10-24,2,WPG,4,2,STL,24,7,17,4,52,16,6,8,1,31,24,7,17,3,51,16,6,8,1,31,1,0,30,20,0.351852,0.648148,8,6
2023020094,2023-10-24,2,MIN,7,4,EDM,17,8,9,7,41,20,11,14,3,48,17,8,9,6,40,20,9,14,3,46,0,1,32,28,0.4,0.6,17,13
2023020095,2023-10-24,2,NSH,2,3,VAN,12,7,10,2,31,21,15,23,3,62,12,7,10,2,31,20,15,23,3,61,0,1,18,24,0.55102,0.44898,2,6
2023020096,2023-10-24,2,CGY,1,3,NYR,21,14,18,1,54,13,7,8,1,29,20,14,17,1,52,12,7,8,0,27,1,0,26,20,0.603774,0.396226,10,8
2023020097,2023-10-24,2,LAK,6,3,ARI,17,6,9,5,37,19,7,11,2,39,17,6,9,5,37,18,7,11,2,38,0,1,28,27,0.527027,0.472973,8,18
2023020098,2023-10-24,2,VGK,3,2,PHI,24,7,29,3,63,25,11,19,2,57,21,7,27,3,58,25,11,19,2,57,1,0,29,28,0.564516,0.435484,4,6
2023020099,2023-10-25,2,NJD,4,6,WSH,18,11,22,4,55,15,10,13,5,43,18,11,22,4,55,15,10,13,5,43,0,1,22,25,0.541667,0.458333,6,2
2023020100,2023-10-26,2,BOS,3,4,ANA,22,9,10,2,43,22,10,10,4,46,21,7,10,1,39,21,10,10,3,44,0,1,30,32,0.525424,0.474576,12,8
2023020101,2023-10-26,2,CAR,3,2,SEA,40,19,19,3,81,23,5,12,2,42,40,19,18,2,79,20,4,10,2,36,0,1,45,26,0.561644,0.438356,2,2
2023020102,2023-10-26,2,DET,1,4,WPG,27,13,17,1,58,19,9,12,4,44,27,13,17,1,58,19,9,12,4,44,0,1,36,29,0.534483,0.465517,6,4
2023020103,2023-10-26,2,MTL,4,3,CBJ,21,14,23,2,60,24,8,17,1,50,15,12,20,1,48,23,8,14,1,46,0,1,29,36,0.462963,0.537037,17,19
2023020104,2023-10-26,2,PHI,6,2,MIN,25,7,15,4,51,25,14,18,2,59,25,7,15,4,51,25,14,18,2,59,1,0,35,28,0.528302,0.471698,9,11
2023020105,2023-10-26,2,PIT,4,0,COL,24,8,9,4,45,27,12,9,0,48,24,8,9,4,45,27,12,9,0,48,1,0,29,31,0.606557,0.393443,10,4
2023020106,2023-10-26,2,TBL,6,0,SJS,22,16,19,5,62,20,6,8,0,34,22,12,18,5,57,19,6,7,0,32,1,0,31,23,0.384615,0.615385,6,10
2023020107,2023-10-26,2,NYI,3,2,OTT,28,5,19,2,54,29,10,15,1,55,28,5,18,2,53,27,9,15,1,52,1,0,38,47,0.477612,0.522388,21,15
2023020108,2023-10-26,2,DAL,1,4,TOR,27,16,20,1,64,15,14,14,3,46,27,16,20,1,64,15,14,14,2,45,0,1,32,24,0.45614,0.54386,8,4
2023020109,2023-10-26,2,CGY,0,3,STL,26,15,13,0,54,25,7,13,2,47,26,15,13,0,54,24,6,13,2,45,0,1,27,35,0.545455,0.454545,17,13
2023020110,2023-10-26,2,EDM,0,3,NYR,27,16,18,0,61,25,12,10,2,49,27,16,18,0,61,25,12,10,2,49,0,1,29,32,0.415094,0.584906,6,4
2023020111,2023-10-27,2,VGK,3,4,CHI,13,10,12,3,38,20,15,17,3,55,13,10,12,3,38,19,15,17,3,54,1,0,21,24,0.615385,0.384615,2,8
2023020112,2023-10-27,2,CAR,3,0,SJS,25,20,20,2,67,16,9,13,0,38,24,19,18,2,63,16,9,13,0,38,1,0,40,20,0.442857,0.557143,6,10
2023020113,2023-10-27,2,NJD,5,4,BUF,20,6,19,3,48,20,12,10,4,46,19,5,19,2,45,18,12,10,4,44,0,1,39,27,0.607143,0.392857,21,16
2023020114,2023-10-27,2,WSH,3,2,MIN,29,8,15,1,53,30,9,10,2,51,24,5,15,0,44,19,6,10,2,37,0,1,33,41,0.528302,0.471698,12,8
2023020115,2023-10-27,2,ARI,4,5,LAK,17,4,7,4,32,28,10,18,4,60,17,4,7,4,32,28,10,18,4,60,1,0,24,41,0.478261,0.521739,10,4
2023020116,2023-10-27,2,VAN,5,0,STL,24,11,16,4,55,15,9,3,0,27,24,10,13,4,51,12,7,3,0,22,1,0,35,22,0.527273,0.472727,10,14
2023020117,2023-10-28,2,PHI,4,7,ANA,23,12,17,3,55,15,7,10,4,36,23,12,17,3,55,15,7,10,4,36,0,1,30,25,0.625,0.375,9,13
2023020118,2023-10-28,2,FLA,3,2,SEA,33,15,14,2,64,30,15,12,2,59,33,15,14,2,64,30,15,12,2,59,0,1,37,33,0.477612,0.522388,2,2
2023020119,2023-10-28,2,BOS,4,1,DET,16,12,9,3,40,18,12,22,1,53,15,11,9,2,37,17,11,20,1,49,1,0,31,24,0.478261,0.521739,10,10
2023020120,2023-10-28,2,CBJ,0,2,NYI,28,13,16,0,57,25,20,11,2,58,28,13,16,0,57,25,20,11,2,58,0,1,34,34,0.425,0.575,6,6
2023020121,2023-10-28,2,MTL,4,3,WPG,25,8,13,3,49,41,13,14,3,71,20,6,13,2,41,35,11,14,2,62,0,1,29,45,0.4,0.6,13,9
2023020122,2023-10-28,2,NSH,3,2,TOR,17,15,10,1,43,27,10,18,1,56,16,13,10,0,39,27,8,17,1,53,0,1,24,35,0.457627,0.542373,8,10
2023020123,2023-10-28,2,PIT,2,5,OTT,36,9,23,2,70,18,8,9,4,39,36,9,23,2,70,18,8,9,4,39,0,1,43,26,0.508475,0.491525,6,4
2023020124,2023-10-28,2,VAN,3,4,NYR,18,13,13,1,45,11,8,8,1,28,12,13,10,1,36,10,8,8,0,26,0,1,33,24,0.428571,0.571429,12,12
2023020125,2023-10-28,2,LAK,3,4,VGK,33,15,21,3,72,21,18,11,3,53,28,13,20,3,64,20,17,11,2,50,1,0,40,30,0.574074,0.425926,11,13
2023020126,2023-10-29,2,BUF,4,0,COL,18,5,6,4,33,16,15,18,0,49,18,5,6,4,33,16,15,18,0,49,1,0,29,23,0.491228,0.508772,12,16
2023020127,2023-10-29,2,NJD,4,3,MIN,24,10,15,2,51,18,8,12,2,40,24,10,15,2,51,18,8,12,2,40,1,0,30,34,0.45098,0.54902,12,6
2023020128,2023-10-29,2,WSH,3,1,SJS,33,8,19,3,63,27,9,19,1,56,33,8,19,3,63,27,9,19,1,56,0,1,42,31,0.52459,0.47541,0,6
2023020129,2023-10-29,2,EDM,5,2,CGY,25,10,12,5,52,18,14,12,0,44,25,10,12,5,52,18,14,12,0,44,1,0,33,26,0.555556,0.444444,12,4
2023020130,2023-10-30,2,BOS,3,2,FLA,19,9,18,3,49,23,14,19,2,58,18,8,17,2,45,23,12,18,2,55,0,1,26,37,0.438596,0.561404,9,2
2023020131,2023-10-30,2,PHI,2,3,CAR,19,15,4,2,40,25,8,12,2,47,19,15,4,2,40,25,8,12,2,47,0,1,28,32,0.290909,0.709091,2,10
2023020132,2023-10-30,2,PIT,3,4,ANA,22,20,16,1,59,21,7,12,2,42,22,20,16,1,59,21,7,12,2,42,1,0,42,27,0.704918,0.295082,6,14
2023020133,2023-10-30,2,TBL,3,4,SEA,26,15,18,2,61,33,20,13,2,68,26,14,18,2,60,31,20,12,2,65,0,1,37,43,0.6,0.4,6,4
2023020134,2023-10-30,2,NYI,3,4,DET,32,18,11,1,62,28,15,19,4,66,31,18,11,1,61,27,14,19,3,63,1,0,40,36,0.515152,0.484848,14,4
2023020135,2023-10-30,2,WPG,2,3,NYR,20,15,20,2,57,16,9,10,2,37,19,13,19,2,53,16,8,9,1,34,0,1,29,26,0.440678,0.559322,6,6
2023020136,2023-10-30,2,DAL,5,3,CBJ,19,20,15,5,59,19,15,16,3,53,19,20,15,5,59,19,15,15,2,51,1,0,33,25,0.581818,0.418182,6,6
2023020137,2023-10-30,2,ARI,8,1,CHI,24,16,7,7,54,26,10,18,1,55,22,15,6,7,50,25,10,17,1,53,0,1,33,30,0.440678,0.559322,16,20
2023020138,2023-10-30,2,VGK,3,2,MTL,23,12,10,3,48,32,13,11,2,58,16,10,9,1,36,27,12,11,1,51,1,0,25,39,0.4,0.6,8,6
2023020139,2023-10-31,2,TOR,1,4,LAK,23,7,7,0,37,18,17,14,3,52,23,7,7,0,37,18,17,14,3,52,0,1,30,27,0.574074,0.425926,18,8
2023020140,2023-10-31,2,VAN,5,2,NSH,21,6,11,4,42,24,22,12,2,60,20,5,9,2,36,23,22,12,2,59,1,0,27,29,0.617021,0.382979,8,6
2023020141,2023-11-01,2,PHI,2,5,BUF,30,12,19,2,63,9,10,12,5,36,30,11,19,2,62,8,10,11,5,34,1,0,40,15,0.540984,0.459016,4,6
2023020142,2023-11-01,2,CGY,3,4,DAL,33,15,16,2,66,20,13,9,3,45,33,15,16,2,66,20,13,9,3,45,1,0,47,30,0.536232,0.463768,4,10
2023020143,2023-11-01,2,COL,4,1,STL,22,13,12,3,50,19,12,8,1,40,22,13,12,3,50,19,12,8,1,40,1,0,28,28,0.492308,0.507692,8,6
2023020144,2023-11-01,2,ANA,4,3,ARI,20,4,6,2,32,26,12,14,3,55,18,3,6,1,28,25,11,12,3,51,1,0,29,35,0.418182,0.581818,15,25
2023020145,2023-11-02,2,BOS,3,2,TOR,36,14,16,4,70,30,17,12,2,61,32,13,16,2,63,28,15,11,2,56,1,0,40,35,0.660714,0.339286,4,4
2023020146,2023-11-02,2,CBJ,4,2,TBL,17,13,17,4,51,19,10,23,2,54,17,12,17,4,50,19,10,22,2,53,1,0,28,29,0.454545,0.545455,8,10
2023020147,2023-11-02,2,DET,0,2,FLA,15,11,8,0,34,16,12,12,2,42,15,11,6,0,32,15,12,12,2,41,0,1,22,27,0.338983,0.661017,10,10
2023020148,2023-11-02,2,NYR,2,1,CAR,19,8,10,1,38,22,16,22,0,60,18,8,10,1,37,22,16,22,0,60,1,0,26,27,0.516129,0.483871,4,10
2023020149,2023-11-02,2,OTT,2,3,LAK,18,7,11,1,37,28,13,17,2,60,18,7,11,1,37,28,13,17,2,60,0,1,26,38,0.589286,0.410714,8,6
2023020150,2023-11-02,2,WSH,0,3,NYI,27,24,19,0,70,17,12,6,3,38,27,24,19,0,70,17,12,6,3,38,0,1,32,21,0.481481,0.518519,4,6
2023020151,2023-11-02,2,MIN,3,5,NJD,19,14,13,2,48,27,11,9,2,49,19,14,13,2,48,27,11,9,2,49,0,1,25,38,0.367347,0.632653,10,4
2023020152,2023-11-02,2,EDM,3,4,DAL,36,16,23,3,78,21,2,12,3,38,36,16,23,3,78,21,2,12,3,38,0,1,49,27,0.60274,0.39726,4,8
2023020153,2023-11-02,2,ARI,3,2,MTL,24,11,21,2,58,21,13,9,1,44,24,11,21,1,57,21,13,9,1,44,1,0,35,30,0.365079,0.634921,10,8
2023020154,2023-11-02,2,SEA,4,2,NSH,25,3,16,3,47,20,15,11,0,46,23,3,16,3,45,20,15,10,0,45,0,1,31,34,0.431373,0.568627,10,10
2023020155,2023-11-02,2,VGK,5,2,WPG,18,6,6,3,33,26,11,17,1,55,18,6,6,3,33,26,11,17,1,55,1,0,26,31,0.519231,0.480769,10,10
2023020156,2023-11-02,2,SJS,1,10,VAN,25,12,14,0,51,19,7,18,6,50,25,12,14,0,51,19,7,18,6,50,0,1,31,33,0.530303,0.469697,15,11
2023020157,2023-11-03,2,BUF,1,5,PHI,18,11,12,1,42,12,12,19,5,48,18,11,12,1,42,12,12,19,5,48,0,1,22,19,0.6,0.4,11,11
2023020158,2023-11-03,2,STL,4,1,NJD,27,11,11,4,53,33,18,9,1,61,26,10,11,4,51,31,17,8,1,57,1,0,35,34,0.388889,0.611111,4,6
2023020159,2023-11-04,2,EDM,2,5,NSH,30,11,14,0,55,27,8,7,4,46,28,11,12,0,51,25,7,7,4,43,1,0,35,34,0.33871,0.66129,10,8
2023020160,2023-11-04,2,ARI,3,5,WPG,19,5,11,2,37,17,14,21,4,56,19,5,11,2,37,17,14,21,4,56,1,0,25,27,0.490196,0.509804,6,6
2023020161,2023-11-04,2,DET,5,4,BOS,28,11,19,3,61,23,5,11,3,42,27,10,19,3,59,19,5,11,3,38,0,1,40,30,0.467742,0.532258,20,32
2023020162,2023-11-04,2,OTT,4,6,TBL,18,10,10,3,41,31,7,16,5,59,18,10,10,3,41,30,7,16,5,58,1,0,28,38,0.447761,0.552239,11,13
2023020163,2023-11-04,2,PHI,0,5,LAK,16,11,12,0,39,22,10,8,4,44,16,11,12,0,39,22,10,8,4,44,0,1,24,30,0.415094,0.584906,10,8
2023020164,2023-11-04,2,STL,6,3,MTL,26,11,15,5,57,26,9,13,2,50,26,11,15,5,57,26,9,13,2,50,1,0,35,33,0.507937,0.492063,8,2
2023020165,2023-11-04,2,TOR,4,6,BUF,12,8,17,3,40,28,7,11,4,50,12,8,17,3,40,28,7,11,4,50,1,0,28,41,0.688525,0.311475,6,8
2023020166,2023-11-04,2,WSH,2,1,CBJ,23,8,14,2,47,26,9,22,1,58,22,8,14,2,46,26,9,22,1,58,1,0,27,35,0.490909,0.509091,10,8
2023020167,2023-11-04,2,NYI,3,4,CAR,21,6,6,2,35,37,24,25,3,89,19,6,6,1,32,37,24,25,2,88,1,0,25,46,0.469697,0.530303,8,4
2023020168,2023-11-04,2,CHI,5,2,FLA,20,9,6,4,39,34,13,25,1,73,20,8,6,3,37,32,11,22,1,66,1,0,25,40,0.442308,0.557692,8,8
2023020169,2023-11-04,2,MIN,5,4,NYR,25,21,28,6,80,16,7,13,5,41,23,19,27,4,73,14,7,13,4,38,0,1,39,18,0.408163,0.591837,2,8
2023020170,2023-11-04,2,SEA,3,6,CGY,15,11,12,2,40,19,7,9,5,40,15,11,12,2,40,19,7,9,5,40,1,0,20,31,0.6,0.4,6,9
2023020171,2023-11-04,2,SJS,2,10,PIT,19,10,10,0,39,24,7,18,8,57,19,10,9,0,38,23,7,18,8,56,0,1,26,35,0.438596,0.561404,8,12
2023020172,2023-11-04,2,VAN,2,0,DAL,13,12,8,2,35,16,16,10,0,42,13,12,8,2,35,16,16,10,0,42,1,0,28,27,0.6,0.4,11,15
2023020173,2023-11-04,2,VGK,7,0,COL,17,7,8,4,36,31,13,28,0,72,15,7,8,4,34,30,13,28,0,71,1,0,34,41,0.513158,0.486842,12,14
2023020174,2023-11-05,2,CHI,2,4,NJD,29,6,12,2,49,33,11,16,3,63,29,6,12,2,49,33,11,16,3,63,1,0,34,41,0.537313,0.462687,6,4
2023020175,2023-11-05,2,ANA,4,2,VGK,18,13,14,3,48,25,12,11,2,50,15,13,13,3,44,24,12,11,1,48,0,1,23,32,0.54,0.46,10,6
2023020176,2023-11-06,2,FLA,5,4,CBJ,40,15,31,5,91,16,12,24,3,55,39,15,30,4,88,16,12,24,3,55,1,0,46,23,0.519231,0.480769,6,4
2023020177,2023-11-06,2,TOR,6,5,TBL,23,9,11,6,49,22,5,14,3,44,22,9,10,5,46,22,5,14,3,44,1,0,34,31,0.457627,0.542373,6,6
2023020178,2023-11-06,2,DAL,2,3,BOS,30,16,16,2,64,17,5,18,2,42,30,16,16,2,64,17,5,18,2,42,0,1,37,29,0.453125,0.546875,8,6
2023020179,2023-11-06,2,VAN,6,2,EDM,23,8,10,3,44,33,12,19,1,65,22,8,10,3,43,33,11,19,1,64,0,1,36,43,0.452055,0.547945,8,24
2023020180,2023-11-07,2,CAR,3,2,BUF,17,15,12,2,46,16,12,8,1,37,16,15,12,1,44,14,12,8,1,35,1,0,27,21,0.595745,0.404255,8,8
2023020181,2023-11-07,2,MTL,3,5,TBL,15,12,14,2,43,18,8,10,3,39,14,11,13,2,40,17,8,10,3,38,0,1,26,32,0.526316,0.473684,19,21
2023020182,2023-11-07,2,NYI,2,4,MIN,20,12,17,1,50,23,7,12,3,45,18,11,17,1,47,20,7,12,3,42,0,1,29,31,0.517857,0.482143,12,14
2023020183,2023-11-07,2,NYR,5,3,DET,23,18,8,3,52,17,10,7,3,37,23,18,8,3,52,17,10,7,3,37,1,0,32,28,0.584906,0.415094,12,6
2023020184,2023-11-07,2,STL,2,5,WPG,17,10,9,2,38,29,11,11,3,54,16,10,9,2,37,29,11,11,3,54,0,1,22,37,0.461538,0.538462,8,4
2023020185,2023-11-07,2,ARI,4,3,SEA,21,14,7,2,44,30,18,13,2,63,14,12,7,1,34,26,15,13,2,56,0,1,27,38,0.5,0.5,10,12
2023020186,2023-11-07,2,CGY,4,2,NSH,33,16,14,4,67,15,6,12,2,35,33,16,14,4,67,15,6,12,2,35,0,1,39,18,0.545455,0.454545,4,6
2023020187,2023-11-07,2,ANA,0,2,PIT,27,3,12,0,42,29,9,15,2,55,27,3,11,0,41,29,8,15,2,54,0,1,31,36,0.469697,0.530303,4,6
2023020188,2023-11-07,2,COL,6,3,NJD,18,9,13,4,44,18,7,16,1,42,18,9,12,4,43,18,7,16,1,42,0,1,32,23,0.426471,0.573529,21,12
2023020189,2023-11-07,2,SJS,2,1,PHI,15,9,20,1,45,30,5,16,1,52,14,7,19,1,41,29,4,14,1,48,1,0,19,39,0.698113,0.301887,37,37
2023020190,2023-11-08,2,TOR,3,6,OTT,26,15,15,2,58,19,11,11,5,46,26,15,15,2,58,19,11,11,5,46,1,0,30,31,0.5625,0.4375,6,4
2023020191,2023-11-08,2,WSH,3,4,FLA,21,9,14,2,46,19,8,11,4,42,21,9,14,2,46,19,8,11,3,41,1,0,28,25,0.431034,0.568966,2,4
2023020192,2023-11-08,2,VGK,1,4,LAK,36,7,17,1,61,24,11,22,2,59,34,7,17,1,59,23,11,22,2,58,0,1,38,33,0.557377,0.442623,8,4
2023020193,2023-11-09,2,BOS,5,2,NYI,23,8,14,3,48,24,12,19,0,55,23,8,14,3,48,24,12,19,0,55,1,0,35,29,0.442308,0.557692,2,6
2023020194,2023-11-09,2,CBJ,2,5,DAL,25,15,9,2,51,22,19,19,5,65,24,13,9,2,48,22,19,18,5,64,1,0,29,31,0.507937,0.492063,6,4
2023020195,2023-11-09,2,DET,2,3,MTL,17,14,14,2,47,22,10,13,1,46,14,10,13,2,39,18,10,13,1,42,0,1,29,27,0.465517,0.534483,22,10
2023020196,2023-11-09,2,NYR,4,1,MIN,22,13,12,3,50,22,21,15,1,59,22,13,12,3,50,22,21,15,1,59,1,0,28,26,0.586957,0.413043,7,7
2023020197,2023-11-09,2,OTT,2,5,VAN,23,8,17,2,50,11,5,17,4,37,23,8,17,2,50,11,5,17,4,37,0,1,30,16,0.583333,0.416667,6,4
2023020198,2023-11-09,2,TBL,3,5,CHI,20,13,16,2,51,17,4,4,4,29,20,13,16,2,51,17,4,4,4,29,1,0,33,29,0.641791,0.358209,22,8
2023020199,2023-11-09,2,STL,2,1,ARI,22,8,7,2,39,19,10,12,0,41,22,8,7,2,39,19,10,12,0,41,1,0,33,20,0.557377,0.442623,4,14
2023020200,2023-11-09,2,WPG,6,3,NSH,21,3,12,5,41,14,10,9,3,36,21,3,11,5,40,13,10,9,2,34,1,0,37,23,0.482143,0.517857,20,28
2023020201,2023-11-09,2,COL,3,4,SEA,21,8,22,3,54,12,15,8,3,38,21,8,22,3,54,12,15,8,3,38,0,1,26,22,0.563636,0.436364,10,8
2023020202,2023-11-09,2,LAK,3,4,PIT,29,12,14,2,57,13,13,9,3,38,27,11,14,2,54,13,12,8,2,35,0,1,36,20,0.5,0.5,6,8
2023020203,2023-11-09,2,SJS,3,2,EDM,14,11,12,3,40,31,12,25,2,70,14,11,12,3,40,30,12,25,2,69,1,0,18,41,0.568966,0.431034,8,4
2023020204,2023-11-10,2,BUF,3,2,MIN,12,10,13,3,38,21,16,23,0,60,12,9,12,3,36,20,15,23,0,58,1,0,25,35,0.272727,0.727273,10,8
2023020205,2023-11-10,2,FLA,5,2,CAR,26,8,15,5,54,28,13,21,2,64,26,8,13,5,52,28,13,21,2,64,0,1,35,30,0.40625,0.59375,6,4
2023020206,2023-11-10,2,NJD,2,4,WSH,20,9,15,2,46,19,8,8,4,39,20,9,15,2,46,17,7,8,4,36,0,1,26,27,0.508475,0.491525,8,8
2023020207,2023-11-10,2,TOR,5,4,CGY,31,27,19,4,81,27,12,16,5,60,27,23,18,2,70,17,12,15,4,48,1,0,36,28,0.592593,0.407407,6,4
2023020208,2023-11-10,2,ANA,3,6,PHI,22,10,15,1,48,23,8,10,6,47,21,9,14,1,45,23,8,10,6,47,0,1,38,36,0.507937,0.492063,6,12
2023020209,2023-11-10,2,VGK,5,0,SJS,33,10,17,4,64,16,7,12,0,35,33,10,17,4,64,16,7,12,0,35,1,0,39,20,0.440678,0.559322,10,2
2023020210,2023-11-11,2,DET,5,4,CBJ,20,7,12,5,44,14,14,21,4,53,20,7,12,5,44,14,14,21,4,53,1,0,28,22,0.615385,0.384615,6,6
2023020211,2023-11-11,2,WPG,2,3,DAL,28,5,17,2,52,19,6,12,1,38,28,5,17,2,52,19,6,12,1,38,0,1,33,29,0.353846,0.646154,8,6
2023020212,2023-11-11,2,MTL,3,2,BOS,20,9,14,2,45,19,12,13,1,45,19,8,14,1,42,18,11,11,1,41,0,1,27,28,0.547619,0.452381,8,8
2023020213,2023-11-11,2,OTT,4,1,CGY,21,13,11,3,48,20,12,18,1,51,21,13,11,3,48,20,12,18,1,51,1,0,38,25,0.576271,0.423729,6,10
2023020214,2023-11-11,2,TBL,0,4,CAR,20,6,15,0,41,25,12,12,3,52,20,6,15,0,41,25,12,12,3,52,0,1,22,32,0.559322,0.440678,11,11
2023020215,2023-11-11,2,TOR,5,2,VAN,10,15,9,5,39,22,13,12,0,47,10,15,9,5,39,22,13,12,0,47,0,1,22,33,0.479167,0.520833,42,14
2023020216,2023-11-11,2,NYI,1,4,WSH,36,27,31,1,95,20,8,12,4,44,36,27,31,1,95,20,8,12,4,44,0,1,37,28,0.5,0.5,2,2
2023020217,2023-11-11,2,PIT,4,0,BUF,29,15,12,3,59,33,14,10,0,57,29,15,12,3,59,33,14,10,0,57,1,0,39,35,0.638298,0.361702,4,6
2023020218,2023-11-11,2,NSH,5,7,ARI,26,13,14,4,57,15,10,9,5,39,26,13,14,4,57,15,10,9,5,39,1,0,42,25,0.470588,0.529412,8,8
2023020219,2023-11-11,2,COL,2,8,STL,26,12,18,2,58,28,2,9,4,43,26,12,18,2,58,28,2,9,4,43,0,1,38,42,0.515152,0.484848,8,6
2023020220,2023-11-11,2,SEA,1,4,EDM,14,7,13,0,34,19,10,9,3,41,12,7,11,0,30,18,9,9,3,39,0,1,18,26,0.542373,0.457627,13,13
2023020221,2023-11-11,2,LAK,2,4,PHI,25,17,22,2,66,16,6,7,4,33,25,17,22,2,66,16,6,7,4,33,0,1,37,26,0.563636,0.436364,8,6
2023020222,2023-11-12,2,FLA,4,3,CHI,22,13,21,2,58,21,5,9,3,38,22,13,21,2,58,21,5,9,3,38,1,0,31,26,0.581818,0.418182,6,8
2023020223,2023-11-12,2,MIN,3,8,DAL,10,9,8,2,29,16,8,11,1,36,10,9,8,2,29,16,8,11,1,36,0,1,26,37,0.349206,0.650794,30,15
2023020224,2023-11-12,2,MTL,2,5,VAN,27,9,17,1,54,26,15,20,5,66,27,9,17,1,54,26,15,20,5,66,0,1,32,37,0.428571,0.571429,4,4
2023020225,2023-11-12,2,NYR,4,3,CBJ,32,19,21,4,76,26,11,13,3,53,29,16,19,3,67,20,5,10,3,38,0,1,40,28,0.652174,0.347826,6,10
2023020226,2023-11-12,2,ANA,4,1,SJS,27,11,12,2,52,20,11,7,1,39,27,11,12,2,52,20,9,7,1,37,1,0,44,26,0.545455,0.454545,18,24
2023020227,2023-11-13,2,EDM,4,1,NYI,26,10,21,1,58,28,12,10,1,51,26,10,20,1,57,28,11,10,1,50,0,1,32,33,0.545455,0.454545,6,6
2023020228,2023-11-13,2,SEA,1,5,COL,16,16,14,1,47,17,14,18,3,52,15,15,13,1,44,15,12,18,3,48,1,0,19,31,0.47541,0.52459,29,13
2023020229,2023-11-14,2,BUF,2,5,BOS,27,15,14,2,58,21,8,12,4,45,26,15,13,2,56,20,8,12,3,43,0,1,34,32,0.480769,0.519231,8,6
2023020230,2023-11-14,2,CBJ,3,5,PIT,17,16,7,3,43,31,8,21,5,65,17,16,7,3,43,31,8,21,5,65,0,1,30,41,0.481481,0.518519,2,8
2023020231,2023-11-14,2,MTL,1,2,CGY,24,14,18,1,57,24,12,9,2,47,24,14,18,1,57,24,12,9,2,47,0,1,35,29,0.5,0.5,6,8
2023020232,2023-11-14,2,WSH,3,0,VGK,21,12,7,3,43,32,13,15,0,60,21,12,7,3,43,32,13,15,0,60,1,0,31,35,0.309091,0.690909,9,14
2023020233,2023-11-14,2,DAL,4,3,ARI,27,15,21,3,66,20,6,9,2,37,27,15,21,2,65,18,6,9,2,35,0,1,36,26,0.618182,0.381818,4,8
2023020234,2023-11-14,2,NSH,2,3,ANA,17,10,16,1,44,14,9,8,3,34,17,10,16,1,44,14,9,8,3,34,1,0,30,20,0.5,0.5,16,30
2023020235,2023-11-14,2,STL,5,0,TBL,24,6,12,5,47,29,12,27,0,68,24,6,12,5,47,29,12,27,0,68,1,0,29,30,0.54902,0.45098,4,0
2023020236,2023-11-14,2,WPG,6,3,NJD,20,8,8,4,40,29,8,18,1,56,20,8,8,4,40,29,8,18,1,56,1,0,31,34,0.47541,0.52459,19,17
2023020237,2023-11-14,2,SJS,3,5,FLA,18,14,5,2,39,21,9,25,3,58,18,14,5,2,39,21,9,25,3,58,0,1,22,31,0.545455,0.454545,6,6
2023020238,2023-11-15,2,CAR,1,3,PHI,29,11,28,1,69,19,4,9,3,35,29,11,28,1,69,19,4,9,3,35,0,1,32,24,0.455882,0.544118,2,6
2023020239,2023-11-15,2,EDM,4,3,SEA,21,13,12,4,50,28,13,16,3,60,18,12,12,3,45,25,12,13,3,53,1,0,31,35,0.5,0.5,12,8
2023020240,2023-11-15,2,COL,8,2,ANA,19,9,7,7,42,13,10,9,2,34,18,9,7,7,41,12,10,9,2,33,1,0,38,17,0.45,0.55,8,10
2023020241,2023-11-15,2,VAN,4,3,NYI,35,13,17,1,66,26,9,15,1,51,33,12,17,0,62,26,8,15,1,50,0,1,43,33,0.565217,0.434783,4,12
2023020242,2023-11-16,2,OTT,5,4,DET,23,7,8,4,42,29,17,13,4,63,20,7,7,2,36,25,15,12,4,56,1,0,34,41,0.4375,0.5625,6,12
2023020243,2023-11-16,2,CBJ,2,3,ARI,33,18,26,2,79,27,8,13,2,50,33,18,26,2,79,27,8,13,2,50,1,0,41,32,0.534483,0.465517,4,6
2023020244,2023-11-16,2,MTL,5,6,VGK,17,6,9,5,37,25,16,21,2,64,17,6,9,5,37,25,16,21,2,64,1,0,28,42,0.514706,0.485294,14,6
2023020245,2023-11-16,2,PIT,2,5,NJD,20,14,9,2,45,23,9,9,4,45,20,14,8,2,44,23,9,9,3,44,1,0,23,31,0.428571,0.571429,2,6
2023020246,2023-11-16,2,CHI,2,4,TBL,7,8,14,1,30,25,18,13,3,59,7,7,14,1,29,23,18,13,3,57,1,0,14,32,0.586207,0.413793,13,11
2023020247,2023-11-16,2,CGY,5,2,VAN,33,17,20,5,75,18,12,16,1,47,33,15,19,4,71,17,11,15,1,44,0,1,39,22,0.483871,0.516129,10,8
2023020248,2023-11-16,2,SEA,4,3,NYI,29,16,10,3,58,20,16,18,3,57,25,15,10,0,50,14,12,15,1,42,0,1,32,23,0.5,0.5,12,10
2023020249,2023-11-16,2,LAK,2,1,FLA,21,5,15,1,42,20,4,18,1,43,21,5,14,1,41,20,4,17,1,42,1,0,27,31,0.542373,0.457627,12,6
2023020250,2023-11-16,2,SJS,5,1,STL,28,7,9,5,49,34,7,22,1,64,28,7,9,5,49,34,7,22,1,64,1,0,35,45,0.532258,0.467742,8,2
2023020251,2023-11-17,2,DET,2,3,TOR,20,6,14,2,42,20,9,17,2,48,20,6,14,1,41,20,9,17,2,48,1,0,29,29,0.444444,0.555556,10,12
2023020252,2023-11-17,2,WPG,3,2,BUF,10,11,10,3,34,23,14,17,2,56,10,11,10,3,34,23,14,17,2,56,1,0,18,28,0.519231,0.480769,4,8
2023020253,2023-11-17,2,ANA,1,2,FLA,29,13,12,0,54,25,8,22,2,57,29,13,12,0,54,25,8,22,2,57,0,1,35,35,0.460317,0.539683,8,6
2023020254,2023-11-18,2,OTT,2,1,MIN,26,6,18,2,52,20,10,13,1,44,23,6,17,1,47,16,9,13,1,39,0,1,31,25,0.603774,0.396226,13,13
2023020255,2023-11-18,2,PHI,4,3,VGK,26,6,21,2,55,21,9,25,2,57,26,6,19,1,52,21,7,23,2,53,1,0,38,31,0.509434,0.490566,10,23
2023020256,2023-11-18,2,NSH,4,2,CHI,20,17,9,3,49,25,4,14,2,45,20,17,9,3,49,25,4,14,2,45,1,0,31,31,0.561404,0.438596,4,6
2023020257,2023-11-18,2,TBL,6,4,EDM,13,11,12,4,40,33,10,15,3,61,13,10,11,3,37,32,10,15,2,59,0,1,24,42,0.576271,0.423729,17,15
2023020258,2023-11-18,2,BOS,5,2,MTL,30,19,11,3,63,15,1,12,2,30,30,19,11,3,63,15,1,12,2,30,1,0,44,22,0.5,0.5,6,12
2023020259,2023-11-18,2,CAR,4,2,PIT,26,18,11,3,58,24,11,12,2,49,26,18,11,3,58,24,11,12,2,49,0,1,34,28,0.474576,0.525424,4,6
2023020260,2023-11-18,2,CGY,4,5,NYI,35,15,21,5,76,29,12,17,5,63,27,13,18,4,62,24,9,14,2,49,1,0,39,33,0.442308,0.557692,6,6
2023020261,2023-11-18,2,NJD,3,5,NYR,28,15,19,2,64,26,8,16,4,54,28,15,19,2,64,26,8,16,4,54,0,1,33,35,0.468085,0.531915,6,2
2023020262,2023-11-18,2,WPG,5,2,ARI,19,9,6,5,39,14,9,16,2,41,19,9,6,5,39,14,9,16,2,41,0,1,26,18,0.483871,0.516129,9,7
2023020263,2023-11-18,2,WSH,4,3,CBJ,19,8,15,4,46,25,18,17,3,63,19,8,15,3,45,24,18,16,3,61,0,1,26,36,0.5,0.5,8,6
2023020264,2023-11-18,2,DAL,3,6,COL,18,13,11,2,44,27,13,13,5,58,17,13,11,2,43,25,13,13,5,56,1,0,28,38,0.603774,0.396226,8,8
2023020265,2023-11-18,2,VAN,3,4,SEA,20,11,16,3,50,21,8,8,4,41,20,11,15,3,49,19,8,8,3,38,1,0,24,26,0.44898,0.55102,6,4
2023020266,2023-11-18,2,LAK,5,1,STL,24,15,16,3,58,22,11,18,1,52,24,15,16,3,58,22,11,18,1,52,1,0,31,30,0.4375,0.5625,6,4
2023020267,2023-11-19,2,MIN,3,4,TOR,27,11,15,3,56,19,14,17,3,53,26,11,13,3,53,18,14,16,2,50,1,0,36,25,0.390625,0.609375,4,6
2023020268,2023-11-19,2,PHI,5,2,CBJ,17,12,12,3,44,20,13,12,2,47,17,12,12,2,43,20,12,12,2,46,1,0,27,22,0.5,0.5,17,15
2023020269,2023-11-19,2,PIT,3,0,VGK,25,13,19,3,60,33,16,14,0,63,25,13,19,3,60,33,16,14,0,63,1,0,32,38,0.61194,0.38806,6,4
2023020270,2023-11-19,2,CHI,2,3,BUF,22,13,12,2,49,15,10,8,2,35,22,13,12,2,49,15,10,8,2,35,0,1,26,20,0.45098,0.54902,6,6
2023020271,2023-11-19,2,ANA,1,3,STL,25,4,13,1,43,23,11,6,2,42,25,4,13,1,43,23,11,6,2,42,0,1,31,32,0.408163,0.591837,12,4
2023020272,2023-11-20,2,FLA,5,3,EDM,25,10,12,4,51,22,14,15,3,54,24,10,12,3,49,21,13,15,2,51,0,1,33,29,0.577465,0.422535,17,29
2023020273,2023-11-20,2,TBL,5,4,BOS,32,7,18,4,61,20,8,11,4,43,31,7,18,3,59,17,8,11,4,40,1,0,47,27,0.55,0.45,6,14
2023020274,2023-11-20,2,DAL,6,3,NYR,26,14,20,3,63,27,10,7,2,46,26,14,20,3,63,27,10,7,2,46,0,1,36,33,0.534483,0.465517,8,6
2023020275,2023-11-20,2,NSH,4,3,COL,21,6,23,4,54,22,6,9,1,38,17,6,22,4,49,22,6,9,1,38,0,1,30,29,0.565217,0.434783,10,8
2023020276,2023-11-20,2,ARI,1,4,LAK,14,9,13,1,37,14,10,10,3,37,14,9,13,1,37,14,10,10,3,37,0,1,31,25,0.444444,0.555556,23,17
2023020277,2023-11-20,2,SEA,3,4,CGY,24,16,19,3,62,23,10,11,3,47,23,16,19,3,61,22,9,11,2,44,0,1,31,31,0.539683,0.460317,4,4
2023020278,2023-11-20,2,VAN,3,1,SJS,27,14,16,2,59,21,9,14,0,44,27,14,16,2,59,21,9,14,0,44,1,0,37,28,0.574468,0.425532,7,6
2023020279,2023-11-22,2,CAR,6,3,EDM,17,10,17,5,49,16,16,17,1,50,17,10,16,5,48,15,16,17,1,49,1,0,27,23,0.438596,0.561404,8,10
2023020280,2023-11-22,2,CBJ,7,3,CHI,18,13,11,6,48,27,12,16,3,58,17,13,11,6,47,27,11,16,3,57,1,0,26,36,0.5,0.5,8,6
2023020281,2023-11-22,2,DET,4,0,NJD,18,8,7,3,36,14,16,15,0,45,18,8,7,3,36,14,16,15,0,45,1,0,28,16,0.5,0.5,4,8
2023020282,2023-11-22,2,FLA,1,3,BOS,23,20,22,1,66,18,9,15,3,45,21,20,22,1,64,13,9,14,2,38,0,1,28,25,0.372549,0.627451,13,13
2023020283,2023-11-22,2,PIT,0,1,NYR,26,16,20,0,62,30,7,11,1,49,26,15,20,0,61,30,7,11,1,49,0,1,32,36,0.52459,0.47541,6,10
2023020284,2023-11-22,2,TBL,2,3,WPG,31,14,23,1,69,27,7,11,2,47,30,14,23,1,68,25,7,11,1,44,0,1,33,32,0.52381,0.47619,4,2
2023020285,2023-11-22,2,WSH,4,3,BUF,22,11,10,4,47,16,12,22,2,52,20,10,9,3,42,14,9,20,2,45,0,1,30,27,0.470588,0.529412,11,9
2023020286,2023-11-22,2,NYI,3,2,PHI,18,11,13,3,45,32,17,27,2,78,18,11,13,3,45,32,17,27,2,78,1,0,25,36,0.59322,0.40678,4,6
2023020287,2023-11-22,2,ARI,5,6,STL,18,24,15,5,62,22,11,14,4,51,18,23,15,5,61,19,10,14,4,47,0,1,25,31,0.387097,0.612903,18,6
2023020288,2023-11-22,2,NSH,4,2,CGY,28,13,10,2,53,20,7,13,1,41,28,10,10,2,50,19,7,13,1,40,1,0,45,26,0.471429,0.528571,18,20
2023020289,2023-11-22,2,DAL,1,2,VGK,27,13,17,1,58,17,6,7,1,31,25,13,17,1,56,16,4,7,0,27,0,1,32,26,0.568966,0.431034,8,6
2023020290,2023-11-22,2,ANA,3,4,MTL,28,17,17,2,64,18,7,14,4,43,27,17,17,2,63,17,7,14,3,41,0,1,33,28,0.508475,0.491525,8,4
2023020291,2023-11-22,2,COL,5,2,VAN,16,7,22,4,49,22,11,9,2,44,14,7,20,4,45,20,11,9,1,41,0,1,25,29,0.428571,0.571429,21,10
2023020292,2023-11-22,2,SEA,7,1,SJS,17,8,20,6,51,13,4,10,1,28,17,8,20,6,51,13,4,10,1,28,1,0,30,14,0.519231,0.480769,9,11
2023020293,2023-11-24,2,BOS,2,5,DET,17,13,14,1,45,17,10,9,3,39,17,13,14,1,45,17,10,9,3,39,0,1,27,28,0.507937,0.492063,12,6
2023020294,2023-11-24,2,PHI,1,3,NYR,23,6,13,1,43,10,13,13,3,39,23,6,13,1,43,10,13,13,3,39,0,1,37,19,0.464286,0.535714,16,34
2023020295,2023-11-24,2,CHI,4,3,TOR,28,11,20,4,63,29,9,20,3,61,22,10,16,3,51,25,8,19,2,54,0,1,34,37,0.408163,0.591837,8,10
2023020296,2023-11-24,2,NJD,1,2,CBJ,29,11,26,1,67,21,9,10,2,42,29,11,26,1,67,21,9,10,2,42,0,1,38,28,0.5,0.5,6,4
2023020297,2023-11-24,2,STL,3,8,NSH,30,5,16,2,53,18,6,5,7,36,30,5,16,2,53,18,6,5,7,36,0,1,39,35,0.693878,0.306122,15,13
2023020298,2023-11-24,2,WSH,0,5,EDM,19,7,3,0,29,25,14,13,2,54,19,7,3,0,29,25,13,13,2,53,0,1,25,35,0.433962,0.566038,8,10
2023020299,2023-11-24,2,ANA,2,5,LAK,26,12,11,1,50,23,12,10,3,48,25,12,11,1,49,23,12,10,2,47,0,1,31,31,0.509091,0.490909,19,17
2023020300,2023-11-24,2,SJS,2,3,MTL,28,11,15,2,56,22,15,16,4,57,22,9,14,1,46,18,11,16,2,47,1,0,33,24,0.4375,0.5625,4,4
2023020301,2023-11-24,2,BUF,3,2,PIT,23,21,12,2,58,26,10,11,2,49,23,20,11,2,56,24,8,11,2,45,0,1,34,33,0.507937,0.492063,8,12
2023020302,2023-11-24,2,OTT,3,5,NYI,23,16,31,2,72,19,6,18,4,47,23,16,31,2,72,19,6,18,4,47,1,0,31,26,0.409836,0.590164,2,6
2023020303,2023-11-24,2,CAR,2,8,TBL,17,16,20,1,54,6,8,7,4,25,17,16,20,1,54,6,8,7,4,25,1,0,24,14,0.589286,0.410714,22,34
2023020304,2023-11-24,2,FLA,0,3,WPG,28,10,21,0,59,26,12,8,2,48,26,9,18,0,53,23,10,8,2,43,0,1,33,31,0.59322,0.40678,25,15
2023020305,2023-11-24,2,DAL,4,7,CGY,20,11,8,3,42,15,11,16,7,49,20,10,8,3,41,15,10,15,7,47,1,0,28,27,0.442308,0.557692,6,6
2023020306,2023-11-24,2,MIN,2,3,COL,14,10,9,1,34,13,12,13,2,40,14,10,9,1,34,13,12,13,2,40,0,1,21,25,0.5,0.5,14,12
2023020307,2023-11-24,2,SEA,1,5,VAN,18,12,19,1,50,16,13,12,4,45,18,12,19,1,50,16,13,12,4,45,0,1,24,27,0.491228,0.508772,19,13
2023020308,2023-11-25,2,NYR,7,4,BOS,30,16,15,5,66,22,10,13,3,48,30,16,14,5,65,22,9,13,3,47,1,0,40,31,0.585714,0.414286,6,6
2023020309,2023-11-25,2,LAK,4,0,MTL,23,10,17,4,54,10,10,12,0,32,23,10,17,4,54,10,10,12,0,32,1,0,30,18,0.4,0.6,6,4
2023020310,2023-11-25,2,NJD,7,2,BUF,29,15,19,6,69,10,9,8,0,27,27,15,19,6,67,10,9,7,0,26,1,0,37,12,0.571429,0.428571,6,4
2023020311,2023-11-25,2,PIT,3,2,TOR,28,14,17,3,62,26,14,19,2,61,28,14,17,3,62,26,14,19,2,61,0,1,35,33,0.459016,0.540984,6,6
2023020312,2023-11-25,2,NYI,0,1,PHI,28,12,23,0,63,36,15,24,1,76,22,8,21,0,51,30,13,22,0,65,0,0,25,40,0.5625,0.4375,2,6
2023020313,2023-11-25,2,COL,3,1,CGY,17,16,13,2,48,27,11,19,1,58,17,15,13,2,47,27,11,19,1,58,1,0,24,30,0.525424,0.474576,10,10
2023020314,2023-11-25,2,SJS,4,3,VAN,17,9,15,3,44,25,17,20,1,63,17,9,15,2,43,25,17,20,1,63,1,0,22,33,0.507937,0.492063,22,16
2023020315,2023-11-25,2,VGK,0,2,ARI,23,11,13,0,47,16,5,15,2,38,23,11,12,0,46,15,5,15,2,37,0,1,34,18,0.630435,0.369565,6,12
2023020316,2023-11-26,2,DET,4,1,MIN,11,4,14,2,31,30,7,8,0,45,10,3,14,1,28,29,7,8,0,44,1,0,23,38,0.473684,0.526316,14,14
2023020317,2023-11-26,2,CHI,2,4,STL,28,7,23,2,60,23,9,4,3,39,28,7,23,2,60,23,9,4,3,39,0,1,33,28,0.529412,0.470588,4,4
2023020318,2023-11-26,2,CAR,3,2,CBJ,35,12,19,3,69,20,6,13,2,41,35,12,19,3,69,20,6,13,2,41,0,1,43,23,0.553571,0.446429,0,4
2023020319,2023-11-26,2,NSH,3,2,WPG,23,10,11,2,46,31,7,14,1,53,23,10,11,2,46,31,7,14,1,53,1,0,26,34,0.5,0.5,4,4
2023020320,2023-11-26,2,EDM,8,2,ANA,14,2,10,6,32,20,9,14,2,45,14,2,9,6,31,20,8,14,2,44,0,1,26,23,0.490566,0.509434,6,12
2023020321,2023-11-27,2,CBJ,5,2,BOS,26,8,14,4,52,27,21,10,2,60,26,8,14,4,52,27,21,10,2,60,1,0,40,33,0.5,0.5,4,10
2023020322,2023-11-27,2,NYR,1,5,BUF,22,6,15,0,43,31,5,15,5,56,22,6,15,0,43,31,5,15,5,56,0,1,26,39,0.723404,0.276596,4,6
2023020323,2023-11-27,2,OTT,0,5,FLA,15,6,12,0,33,23,9,16,2,50,15,6,8,0,29,22,8,15,1,46,0,1,20,37,0.548387,0.451613,84,83
2023020324,2023-11-27,2,COL,4,1,TBL,16,12,9,3,40,24,14,17,1,56,16,12,9,3,40,24,14,17,1,56,1,0,23,39,0.516667,0.483333,26,40
2023020325,2023-11-27,2,CGY,2,1,VGK,25,19,21,2,67,22,10,12,0,44,23,17,19,1,60,22,10,12,0,44,0,1,34,28,0.545455,0.454545,6,6
2023020326,2023-11-27,2,SJS,2,1,WSH,15,12,12,1,40,27,9,11,1,48,15,12,12,1,40,27,9,11,1,48,1,0,23,34,0.5,0.5,6,6
2023020327,2023-11-28,2,NJD,5,4,NYI,22,16,18,4,60,19,6,5,3,33,22,16,18,4,60,19,6,5,3,33,0,1,33,26,0.603774,0.396226,13,13
2023020328,2023-11-28,2,PHI,1,4,CAR,26,10,14,1,51,28,11,21,4,64,26,10,14,1,51,28,11,21,4,64,0,1,29,36,0.518519,0.481481,4,4
2023020329,2023-11-28,2,TOR,2,1,FLA,25,9,7,3,44,34,16,24,2,76,22,7,6,1,36,28,14,21,1,64,0,1,32,39,0.527273,0.472727,11,17
2023020330,2023-11-28,2,MIN,3,1,STL,30,12,13,3,58,17,16,19,1,53,30,12,13,3,58,17,16,19,1,53,1,0,37,24,0.423729,0.576271,8,2
2023020331,2023-11-28,2,NSH,3,2,PIT,14,10,13,3,40,22,15,9,2,48,14,10,13,2,39,22,15,9,2,48,1,0,25,31,0.529412,0.470588,9,11
2023020332,2023-11-28,2,WPG,0,2,DAL,21,10,13,0,44,16,12,15,2,45,21,10,13,0,44,16,12,15,2,45,0,1,27,21,0.5,0.5,4,8
2023020333,2023-11-28,2,CHI,4,3,SEA,15,8,14,4,41,24,6,21,2,53,15,7,14,4,40,24,6,20,2,52,1,0,23,36,0.5,0.5,14,10
2023020334,2023-11-28,2,ARI,3,1,TBL,19,9,9,3,40,25,17,24,1,67,19,9,9,3,40,25,17,24,1,67,1,0,27,31,0.5,0.5,9,9
2023020335,2023-11-28,2,EDM,5,4,VGK,22,11,18,5,56,17,7,18,4,46,21,8,16,2,47,13,5,17,4,39,1,0,34,27,0.522388,0.477612,12,8
2023020336,2023-11-28,2,VAN,3,1,ANA,19,15,15,2,51,21,10,6,0,37,19,15,15,2,51,21,10,6,0,37,1,0,27,31,0.543478,0.456522,8,10
2023020337,2023-11-29,2,CBJ,2,4,MTL,26,14,12,2,54,26,12,19,4,61,25,14,12,1,52,24,12,19,4,59,1,0,28,31,0.486486,0.513514,2,4
2023020338,2023-11-29,2,NYR,3,2,DET,30,12,20,3,65,19,7,14,1,41,28,10,20,3,61,19,7,14,1,41,1,0,41,27,0.66,0.34,14,8
2023020339,2023-11-29,2,LAK,1,2,WSH,33,13,13,1,60,13,8,10,2,33,33,13,13,1,60,13,8,10,2,33,1,0,39,15,0.6,0.4,0,6
2023020340,2023-11-30,2,BOS,3,0,SJS,29,9,8,2,48,22,9,10,0,41,28,9,8,2,47,22,9,10,0,41,1,0,37,26,0.527273,0.472727,22,20
2023020341,2023-11-30,2,CAR,4,5,NYI,34,19,29,4,86,9,12,11,3,35,32,18,28,4,82,8,11,9,2,30,1,0,43,16,0.460317,0.539683,8,6
2023020342,2023-11-30,2,DET,5,1,CHI,21,9,7,2,39,28,13,14,0,55,21,9,7,2,39,28,13,14,0,55,1,0,29,35,0.574468,0.425532,18,10
2023020343,2023-11-30,2,MTL,1,5,FLA,13,13,11,1,38,17,8,17,4,46,12,13,10,1,36,16,8,16,3,43,0,1,22,29,0.574074,0.425926,13,17
2023020344,2023-11-30,2,PHI,3,4,NJD,28,13,14,1,56,18,8,6,3,35,28,13,13,1,55,18,8,5,2,33,0,1,47,35,0.47619,0.52381,23,12
2023020345,2023-11-30,2,TBL,2,4,PIT,37,19,17,1,74,23,13,18,4,58,37,19,17,1,74,23,13,18,4,58,1,0,41,29,0.377778,0.622222,2,4
2023020346,2023-11-30,2,TOR,4,3,SEA,20,5,13,4,42,29,14,15,2,60,17,4,13,2,36,23,12,15,2,52,1,0,28,40,0.610169,0.389831,12,8
2023020347,2023-11-30,2,NSH,1,6,MIN,20,8,11,1,40,20,13,7,5,45,20,8,11,1,40,20,13,7,5,45,0,1,27,31,0.596154,0.403846,17,17
2023020348,2023-11-30,2,STL,6,4,BUF,13,15,5,5,38,35,20,12,4,71,13,15,5,5,38,35,20,12,4,71,1,0,20,46,0.491525,0.508475,6,4
2023020349,2023-11-30,2,WPG,1,3,EDM,18,8,7,0,33,32,20,18,2,72,18,8,7,0,33,32,20,18,2,72,1,0,26,39,0.290323,0.709677,4,6
2023020350,2023-11-30,2,ARI,4,3,COL,21,12,15,3,51,24,11,15,1,51,20,12,15,2,49,22,11,13,0,46,0,1,32,31,0.422222,0.577778,11,11
2023020351,2023-11-30,2,CGY,4,3,DAL,27,9,19,4,59,13,12,24,3,52,26,9,19,3,57,13,11,24,2,50,0,1,36,16,0.4,0.6,0,4
2023020352,2023-11-30,2,ANA,4,5,WSH,20,14,13,4,51,13,4,9,3,29,19,11,11,4,45,11,3,8,3,25,0,1,32,26,0.548387,0.451613,16,14
2023020353,2023-11-30,2,VAN,1,4,VGK,18,13,14,1,46,37,8,9,3,57,18,13,14,1,46,36,8,9,3,56,0,1,22,44,0.391304,0.608696,6,6
2023020354,2023-12-01,2,CBJ,4,2,OTT,14,6,13,2,35,25,11,12,1,49,14,6,13,2,35,25,11,12,1,49,0,1,23,43,0.442308,0.557692,10,4
2023020355,2023-12-01,2,NJD,3,6,SJS,41,19,29,2,91,12,11,10,6,39,41,19,29,2,91,12,11,10,6,39,0,1,47,18,0.548387,0.451613,0,4
2023020356,2023-12-02,2,DAL,8,1,TBL,21,10,6,6,43,21,14,7,0,42,21,10,6,6,43,21,14,7,0,42,1,0,34,33,0.45,0.55,12,4
2023020357,2023-12-02,2,WPG,3,1,CHI,25,13,16,2,56,16,12,13,1,42,24,13,16,2,55,16,12,13,1,42,0,1,28,21,0.52,0.48,4,8
2023020358,2023-12-02,2,NSH,3,4,NYR,32,14,19,1,66,19,10,16,3,48,32,14,19,1,66,19,10,16,3,48,1,0,40,25,0.424242,0.575758,4,8
2023020359,2023-12-02,2,FLA,3,4,NYI,36,21,25,3,85,20,8,16,3,47,36,21,25,3,85,20,8,16,3,47,0,1,45,27,0.59375,0.40625,4,4
2023020360,2023-12-02,2,CAR,6,2,BUF,30,21,17,3,71,15,5,6,2,28,30,21,17,3,71,15,5,6,2,28,1,0,37,22,0.54386,0.45614,19,13
2023020361,2023-12-02,2,MTL,4,5,DET,22,13,20,2,57,23,8,12,3,46,21,13,20,2,56,21,6,12,2,41,0,1,30,33,0.57377,0.42623,8,10
2023020362,2023-12-02,2,OTT,2,0,SEA,21,6,5,2,34,30,10,22,0,62,21,6,5,2,34,30,10,22,0,62,1,0,28,39,0.5,0.5,6,6
2023020363,2023-12-02,2,PIT,3,4,PHI,24,13,16,3,56,27,10,9,2,48,17,9,15,3,44,22,10,8,1,41,1,0,32,33,0.617647,0.382353,8,10
2023020364,2023-12-02,2,TOR,3,4,BOS,36,11,18,3,68,30,11,18,4,63,31,10,18,3,62,20,11,17,3,51,0,1,40,37,0.540984,0.459016,2,2
2023020365,2023-12-02,2,ARI,4,1,STL,16,14,6,3,39,26,20,19,1,66,16,14,6,3,39,26,20,19,1,66,1,0,22,32,0.6,0.4,8,6
2023020366,2023-12-02,2,ANA,4,3,COL,32,9,14,2,57,30,12,17,3,62,26,6,12,1,45,26,8,16,3,53,0,1,37,37,0.550725,0.449275,6,6
2023020367,2023-12-02,2,CGY,3,4,VAN,15,12,11,1,39,15,10,9,4,38,15,12,11,1,39,15,10,9,4,38,0,1,24,22,0.474576,0.525424,8,10
2023020368,2023-12-02,2,VGK,4,1,WSH,28,11,7,3,49,21,12,23,1,57,28,11,7,3,49,20,12,23,1,56,1,0,36,22,0.416667,0.583333,4,10
2023020369,2023-12-03,2,MIN,4,1,CHI,28,11,21,2,62,17,5,10,0,32,28,11,21,2,62,17,5,10,0,32,1,0,34,29,0.462963,0.537037,6,6
2023020370,2023-12-03,2,NYR,6,5,SJS,27,8,16,5,56,20,16,16,4,56,26,8,16,5,55,20,16,16,4,56,0,1,36,28,0.535714,0.464286,4,6
2023020371,2023-12-03,2,BOS,3,1,CBJ,18,10,18,1,47,20,12,14,1,47,18,10,18,1,47,19,12,13,1,45,0,1,28,25,0.510638,0.489362,8,12
2023020372,2023-12-03,2,BUF,1,2,NSH,34,20,13,1,68,24,12,17,2,55,34,20,13,0,67,24,12,17,2,55,0,1,35,29,0.407407,0.592593,4,2
2023020373,2023-12-03,2,LAK,4,1,COL,31,16,18,4,69,18,7,15,1,41,31,16,18,4,69,18,7,15,1,41,0,1,38,21,0.538462,0.461538,4,2
2023020374,2023-12-04,2,PHI,2,1,PIT,27,16,14,2,59,30,13,13,1,57,24,14,14,1,53,28,12,13,1,54,0,1,33,32,0.557692,0.442308,6,2
2023020375,2023-12-04,2,TBL,4,0,DAL,19,10,13,4,46,25,13,23,0,61,18,10,13,3,44,25,13,22,0,60,1,0,23,25,0.403846,0.596154,4,4
2023020376,2023-12-04,2,MTL,4,2,SEA,26,9,7,3,45,28,8,23,1,60,26,9,7,3,45,28,8,23,1,60,1,0,30,33,0.541667,0.458333,4,2
2023020377,2023-12-04,2,WPG,2,1,CAR,19,10,11,2,42,35,23,16,1,75,19,10,11,2,42,35,23,16,1,75,1,0,22,43,0.482143,0.517857,6,2
2023020378,2023-12-04,2,ARI,6,0,WSH,11,9,9,3,32,19,10,21,0,50,11,9,9,3,32,19,10,21,0,50,1,0,27,26,0.553571,0.446429,10,10
2023020379,2023-12-04,2,VGK,1,2,STL,32,15,16,0,63,25,12,24,2,63,32,15,16,0,63,25,12,24,1,62,0,1,34,27,0.490566,0.509434,2,6
2023020380,2023-12-05,2,BUF,3,5,DET,24,7,16,1,48,14,5,8,3,30,24,7,16,1,48,14,5,8,3,30,0,1,32,27,0.47541,0.52459,8,10
2023020381,2023-12-05,2,CBJ,3,4,LAK,23,12,18,2,55,31,22,12,4,69,23,12,18,2,55,31,22,12,3,68,1,0,29,39,0.491228,0.508772,4,2
2023020382,2023-12-05,2,OTT,6,2,NYR,23,10,17,6,56,26,6,9,1,42,23,10,17,6,56,26,6,9,1,42,1,0,36,35,0.442623,0.557377,13,11
2023020383,2023-12-05,2,NYI,4,5,SJS,32,19,20,1,72,24,10,23,5,62,30,17,18,1,66,22,9,22,4,57,1,0,39,37,0.507042,0.492958,4,6
2023020384,2023-12-05,2,CHI,3,4,NSH,25,7,15,4,51,26,12,20,5,63,22,5,14,3,44,25,11,20,2,58,1,0,28,30,0.511628,0.488372,4,4
2023020385,2023-12-05,2,CGY,2,5,MIN,24,10,18,2,54,17,10,14,4,45,24,10,18,2,54,16,8,14,4,42,0,1,30,29,0.590909,0.409091,13,13
2023020386,2023-12-05,2,COL,3,2,ANA,24,11,12,3,50,27,4,17,0,48,24,11,12,3,50,27,4,17,0,48,1,0,30,33,0.538462,0.461538,6,6
2023020387,2023-12-05,2,VAN,5,6,NJD,21,5,7,4,37,23,5,14,5,47,21,5,7,4,37,23,5,14,5,47,0,1,33,32,0.442623,0.557377,4,8
2023020388,2023-12-06,2,FLA,5,4,DAL,21,15,16,4,56,23,15,10,2,50,17,14,14,4,49,23,15,10,2,50,1,0,31,33,0.440678,0.559322,10,4
2023020389,2023-12-06,2,TBL,3,1,PIT,19,10,6,1,36,20,10,25,1,56,19,10,6,1,36,20,10,25,1,56,1,0,27,25,0.407407,0.592593,8,8
2023020390,2023-12-06,2,STL,3,6,VGK,20,4,15,3,42,27,12,10,4,53,20,4,15,3,42,27,12,10,4,53,0,1,29,49,0.515625,0.484375,16,6
2023020391,2023-12-06,2,EDM,6,1,CAR,25,10,6,6,47,31,12,18,1,62,25,10,6,6,47,31,12,18,1,62,1,0,34,39,0.529412,0.470588,4,2
2023020392,2023-12-07,2,BOS,1,3,BUF,28,13,19,1,61,29,7,10,3,49,28,13,19,1,61,29,7,10,3,49,0,1,32,35,0.5,0.5,6,2
2023020393,2023-12-07,2,DET,5,6,SJS,24,18,11,5,58,23,9,15,4,51,23,18,10,5,56,21,9,15,3,48,1,0,31,36,0.59375,0.40625,6,6
2023020394,2023-12-07,2,MTL,0,4,LAK,20,10,20,0,50,36,9,12,3,60,20,10,20,0,50,36,9,12,3,60,0,1,24,42,0.603448,0.396552,9,13
2023020395,2023-12-07,2,OTT,3,4,TOR,36,4,20,3,63,16,10,23,4,53,36,4,20,3,63,16,10,23,4,53,1,0,41,22,0.428571,0.571429,2,4
2023020396,2023-12-07,2,WSH,4,5,DAL,20,10,14,3,47,32,12,24,4,72,16,10,12,3,41,31,11,24,3,69,1,0,27,38,0.440678,0.559322,2,8
2023020397,2023-12-07,2,NYI,7,3,CBJ,27,5,15,6,53,28,14,22,3,67,27,5,15,6,53,28,14,22,3,67,1,0,36,35,0.460317,0.539683,2,4
2023020398,2023-12-07,2,NSH,5,1,TBL,23,10,15,3,51,26,8,13,1,48,23,10,15,3,51,26,8,13,1,48,0,1,30,33,0.472727,0.527273,13,23
2023020399,2023-12-07,2,CHI,1,0,ANA,18,9,8,0,35,31,8,19,0,58,18,9,8,0,35,31,8,19,0,58,1,0,25,37,0.471698,0.528302,6,8
2023020400,2023-12-07,2,ARI,1,4,PHI,24,16,19,1,60,22,13,9,3,47,24,16,19,1,60,22,13,9,3,47,0,1,26,26,0.433962,0.566038,0,6
2023020401,2023-12-07,2,CGY,3,2,CAR,21,15,10,2,48,25,8,19,2,54,21,15,10,2,48,25,8,19,2,54,0,1,27,30,0.454545,0.545455,2,6
2023020402,2023-12-07,2,COL,2,4,WPG,26,11,11,2,50,23,10,13,4,50,26,11,11,2,50,23,10,13,4,50,0,1,34,28,0.521739,0.478261,2,8
2023020403,2023-12-07,2,SEA,1,2,NJD,33,14,17,1,65,13,16,11,2,42,32,12,17,1,62,13,16,11,2,42,0,1,38,17,0.490909,0.509091,6,4
2023020404,2023-12-07,2,VAN,2,0,MIN,12,14,13,2,41,23,12,27,0,62,12,14,13,2,41,23,12,27,0,62,1,0,17,26,0.515625,0.484375,12,14
2023020405,2023-12-08,2,CBJ,5,2,STL,14,10,9,4,37,36,12,11,2,61,14,9,8,4,35,36,11,10,2,59,1,0,22,43,0.557377,0.442623,8,6
2023020406,2023-12-08,2,FLA,3,1,PIT,27,19,18,3,67,21,9,12,1,43,27,19,18,3,67,21,9,12,1,43,0,1,33,26,0.526316,0.473684,6,4
2023020407,2023-12-08,2,EDM,4,3,MIN,27,12,14,2,55,13,21,14,3,51,27,12,14,2,55,13,21,14,3,51,1,0,40,20,0.519231,0.480769,6,10
2023020408,2023-12-09,2,BOS,5,3,ARI,13,13,11,4,41,19,8,13,3,43,13,13,11,4,41,19,8,13,3,43,1,0,29,33,0.7,0.3,10,6
2023020409,2023-12-09,2,CGY,2,4,NJD,23,14,17,1,55,22,10,14,4,50,23,14,17,1,55,22,10,14,4,50,1,0,25,30,0.46,0.54,4,0
2023020410,2023-12-09,2,DAL,1,6,VGK,15,10,14,1,40,17,7,9,6,39,15,10,14,1,40,17,7,9,6,39,0,1,20,27,0.488889,0.511111,4,6
2023020411,2023-12-09,2,BUF,2,3,MTL,38,11,15,4,68,22,10,6,4,42,30,9,12,2,53,19,10,6,0,35,0,1,48,31,0.433962,0.566038,24,17
2023020412,2023-12-09,2,DET,1,5,OTT,20,7,12,0,39,23,13,17,3,56,19,7,12,0,38,23,13,17,3,56,0,1,31,37,0.402985,0.597015,18,17
2023020413,2023-12-09,2,TOR,4,0,NSH,21,8,14,2,45,14,6,14,0,34,21,8,14,2,45,14,6,14,0,34,1,0,37,18,0.557692,0.442308,11,15
2023020414,2023-12-09,2,WSH,4,0,NYR,21,9,9,4,43,27,14,11,0,52,21,9,9,4,43,27,14,11,0,52,1,0,29,31,0.603448,0.396552,7,11
2023020415,2023-12-09,2,NYI,3,2,LAK,21,11,10,3,45,25,7,19,1,52,20,10,10,2,42,23,7,17,1,48,0,1,30,35,0.482759,0.517241,15,13
2023020416,2023-12-09,2,CHI,3,1,STL,17,10,12,3,42,36,17,17,0,70,17,10,11,3,41,36,17,17,0,70,1,0,24,39,0.553571,0.446429,11,11
2023020417,2023-12-09,2,COL,2,5,PHI,30,11,22,2,65,28,9,12,5,54,30,11,22,2,65,28,9,12,4,53,0,1,38,34,0.451613,0.548387,2,4
2023020418,2023-12-09,2,SEA,3,4,TBL,25,8,14,2,49,17,8,10,4,39,23,7,14,2,46,17,8,10,3,38,0,1,29,30,0.403509,0.596491,6,12
2023020419,2023-12-09,2,VAN,4,3,CAR,14,5,4,4,27,12,15,16,2,45,14,5,4,4,27,12,15,16,2,45,1,0,24,24,0.474576,0.525424,10,6
2023020420,2023-12-10,2,CBJ,2,5,FLA,16,10,15,2,43,20,14,20,4,58,16,10,15,2,43,20,14,20,4,58,0,1,19,35,0.510204,0.489796,39,16
2023020421,2023-12-10,2,EDM,4,1,NJD,23,12,7,3,45,18,12,20,1,51,23,12,7,3,45,18,12,20,1,51,1,0,30,26,0.491803,0.508197,8,6
2023020422,2023-12-10,2,CHI,2,4,WSH,24,8,14,2,48,20,10,14,4,48,21,8,13,1,43,18,9,14,4,45,1,0,34,27,0.603774,0.396226,6,32
2023020423,2023-12-10,2,MTL,1,2,NSH,29,14,13,1,57,26,5,15,1,47,28,14,13,1,56,23,5,14,1,43,0,1,37,32,0.555556,0.444444,8,12
2023020424,2023-12-10,2,NYR,4,1,LAK,13,9,12,2,36,22,6,8,0,36,13,9,12,2,36,22,6,8,0,36,1,0,27,26,0.627451,0.372549,22,26
2023020425,2023-12-10,2,ANA,2,4,WPG,17,12,11,1,41,16,13,11,4,44,17,12,11,1,41,16,13,11,4,44,1,0,26,31,0.534483,0.465517,28,9
2023020426,2023-12-10,2,SEA,0,3,MIN,17,12,25,0,54,18,7,23,3,51,17,12,25,0,54,18,7,23,3,51,0,1,24,26,0.65,0.35,4,6
2023020427,2023-12-10,2,VGK,5,4,SJS,19,12,16,5,52,31,7,15,3,56,17,11,15,3,46,27,7,15,3,52,0,1,27,38,0.370968,0.629032,6,8
2023020428,2023-12-11,2,BUF,5,2,ARI,31,8,12,5,56,18,8,9,1,36,31,8,12,5,56,18,8,8,1,35,1,0,38,23,0.581818,0.418182,6,4
2023020429,2023-12-11,2,NYI,4,3,TOR,25,19,13,4,61,37,13,16,2,68,25,19,13,3,60,35,12,16,2,65,0,1,29,40,0.464286,0.535714,2,2
2023020430,2023-12-11,2,DAL,6,3,DET,24,13,22,4,63,21,5,9,2,37,22,13,22,3,60,21,5,9,2,37,0,1,35,30,0.586207,0.413793,8,10
2023020431,2023-12-11,2,COL,6,5,CGY,27,9,25,5,66,26,11,13,5,55,26,9,24,5,64,25,11,13,4,53,0,1,38,32,0.528571,0.471429,6,10
2023020432,2023-12-12,2,NYR,3,7,TOR,27,18,20,2,67,19,7,9,6,41,27,18,20,2,67,18,7,9,6,40,0,1,31,30,0.472727,0.527273,10,8
2023020433,2023-12-12,2,OTT,1,4,CAR,26,9,11,1,47,22,14,14,2,52,20,8,11,1,40,20,14,14,1,49,1,0,32,28,0.473684,0.526316,20,12
2023020434,2023-12-12,2,PIT,4,2,ARI,34,15,13,1,63,14,17,14,0,45,34,15,13,1,63,14,17,14,0,45,1,0,43,21,0.62069,0.37931,12,10
2023020435,2023-12-12,2,NSH,3,2,PHI,14,14,25,3,56,21,9,7,2,39,13,14,25,2,54,21,9,7,2,39,1,0,22,39,0.557692,0.442308,13,11
2023020436,2023-12-12,2,STL,4,6,DET,24,10,14,3,51,14,5,7,4,30,24,10,14,3,51,14,5,7,4,30,1,0,37,32,0.470588,0.529412,10,6
2023020437,2023-12-12,2,EDM,4,1,CHI,22,14,19,3,58,22,7,10,1,40,22,14,19,3,58,22,7,10,1,40,0,1,29,23,0.538462,0.461538,6,4
2023020438,2023-12-12,2,SEA,4,0,FLA,16,10,11,4,41,24,18,15,0,57,16,10,11,4,41,24,18,15,0,57,1,0,23,24,0.569231,0.430769,6,2
2023020439,2023-12-12,2,VAN,4,1,TBL,15,12,11,3,41,21,13,17,1,52,15,12,11,3,41,21,13,17,1,52,0,1,22,29,0.490196,0.509804,6,4
2023020440,2023-12-12,2,VGK,5,4,CGY,29,7,18,3,57,20,10,15,4,49,29,7,16,2,54,20,9,15,4,48,0,1,39,31,0.415094,0.584906,4,8
2023020441,2023-12-12,2,SJS,2,1,WPG,26,11,10,1,48,28,13,14,1,56,25,11,10,1,47,28,13,13,1,55,1,0,32,37,0.5,0.5,10,6
2023020442,2023-12-13,2,MTL,3,4,PIT,36,17,15,5,73,27,16,17,5,65,25,14,14,2,55,21,14,17,1,53,1,0,42,30,0.516667,0.483333,6,8
2023020443,2023-12-13,2,NJD,2,1,BOS,30,16,17,2,65,23,14,12,1,50,25,14,17,1,57,23,14,11,1,49,0,1,35,24,0.491525,0.508475,2,4
2023020444,2023-12-13,2,NYI,4,3,ANA,26,14,13,2,55,16,10,11,2,39,26,14,13,2,55,16,10,11,2,39,1,0,35,24,0.514706,0.485294,4,8
2023020445,2023-12-13,2,COL,5,1,BUF,21,14,17,4,56,23,10,16,1,50,21,14,17,4,56,23,10,16,1,50,1,0,29,30,0.5,0.5,4,4
2023020446,2023-12-13,2,LAK,2,5,WPG,21,14,20,1,56,20,17,6,5,48,21,14,20,1,56,20,17,6,5,48,1,0,34,29,0.62963,0.37037,4,8
2023020447,2023-12-14,2,DET,1,2,CAR,18,8,13,1,40,30,16,16,2,64,18,8,13,1,40,30,16,16,2,64,0,1,26,39,0.327273,0.672727,8,6
2023020448,2023-12-14,2,PHI,4,3,WSH,23,12,12,5,52,21,12,16,3,52,19,12,12,3,46,16,9,16,2,43,1,0,32,30,0.47619,0.52381,6,10
2023020449,2023-12-14,2,TOR,5,6,CBJ,39,12,38,4,93,23,11,7,5,46,35,10,37,4,86,22,9,7,3,41,0,1,48,35,0.560606,0.439394,6,6
2023020450,2023-12-14,2,MIN,3,2,CGY,24,13,22,4,63,32,11,12,1,56,22,9,20,2,53,28,10,10,0,48,1,0,32,37,0.418182,0.581818,8,8
2023020451,2023-12-14,2,STL,4,2,OTT,23,10,8,4,45,25,13,13,2,53,23,10,8,4,45,25,13,13,2,53,1,0,30,34,0.509804,0.490196,9,11
2023020452,2023-12-14,2,EDM,4,7,TBL,37,12,17,1,67,13,5,18,6,42,37,12,17,1,67,13,5,18,6,42,0,1,57,24,0.538462,0.461538,4,8
2023020453,2023-12-14,2,SEA,7,1,CHI,19,15,21,6,61,16,8,10,1,35,19,15,21,6,61,16,8,10,1,35,1,0,29,22,0.568627,0.431373,2,4
2023020454,2023-12-14,2,VAN,4,0,FLA,11,13,10,3,37,33,12,15,0,60,11,13,10,3,37,33,12,15,0,60,1,0,18,36,0.510638,0.489362,6,6
2023020455,2023-12-15,2,CAR,5,6,NSH,25,11,20,3,59,20,11,11,5,47,25,11,20,3,59,20,11,10,4,45,0,1,31,30,0.553846,0.446154,6,6
2023020456,2023-12-15,2,NYR,5,1,ANA,27,6,14,3,50,25,16,7,1,49,27,6,11,3,47,25,16,6,1,48,0,1,39,30,0.52459,0.47541,6,32
2023020457,2023-12-15,2,NYI,4,5,BOS,29,13,8,3,53,30,9,18,3,60,25,13,8,2,48,24,9,18,1,52,1,0,37,34,0.565789,0.434211,6,8
2023020458,2023-12-15,2,DAL,5,4,OTT,16,12,12,3,43,23,12,13,4,52,16,12,12,2,42,21,12,12,3,48,0,1,24,29,0.6,0.4,6,6
2023020459,2023-12-15,2,ARI,1,0,SJS,17,14,14,1,46,21,15,16,0,52,17,14,14,1,46,21,15,16,0,52,1,0,24,21,0.625,0.375,0,8
2023020460,2023-12-15,2,VGK,2,5,BUF,24,20,18,1,63,20,8,12,5,45,24,20,18,1,63,20,8,12,5,45,0,1,35,27,0.444444,0.555556,2,8
2023020461,2023-12-16,2,MIN,2,1,VAN,24,12,12,2,50,26,8,9,1,44,23,10,12,1,46,22,6,9,1,38,1,0,31,36,0.492063,0.507937,10,4
2023020462,2023-12-16,2,BOS,1,2,NYR,18,10,16,1,45,21,11,10,1,43,18,9,16,1,44,19,10,9,0,38,1,0,22,34,0.42,0.58,30,15
2023020463,2023-12-16,2,CBJ,3,6,NJD,20,9,14,2,45,22,8,13,5,48,18,9,13,2,42,21,8,13,5,47,0,1,26,30,0.411765,0.588235,6,10
2023020464,2023-12-16,2,MTL,5,3,NYI,28,12,16,5,61,26,9,18,2,55,28,12,16,5,61,26,9,18,2,55,1,0,41,33,0.673077,0.326923,2,4
2023020465,2023-12-16,2,PHI,1,0,DET,28,7,12,1,48,25,11,20,0,56,28,7,12,1,48,25,11,20,0,56,1,0,34,32,0.438596,0.561404,6,6
2023020466,2023-12-16,2,TOR,7,0,PIT,19,9,7,5,40,31,9,18,0,58,17,8,7,5,37,29,8,14,0,51,1,0,35,38,0.410714,0.589286,15,33
2023020467,2023-12-16,2,WPG,6,2,COL,16,14,15,5,50,20,7,14,1,42,16,14,15,5,50,20,7,14,1,42,1,0,25,32,0.411765,0.588235,8,4
2023020468,2023-12-16,2,NSH,3,1,WSH,18,6,9,2,35,14,15,16,0,45,18,6,9,2,35,14,15,16,0,45,1,0,23,22,0.386364,0.613636,8,6
2023020469,2023-12-16,2,STL,4,3,DAL,29,11,13,3,56,18,14,15,3,50,29,10,13,2,54,18,14,15,3,50,0,1,34,23,0.421875,0.578125,6,2
2023020470,2023-12-16,2,ARI,2,0,BUF,17,15,20,2,54,24,14,17,0,55,17,14,20,2,53,23,14,17,0,54,1,0,22,28,0.552632,0.447368,4,6
2023020471,2023-12-16,2,CGY,4,2,TBL,21,10,19,4,54,31,11,18,1,61,21,9,18,4,52,29,10,17,1,57,1,0,26,33,0.357143,0.642857,9,9
2023020472,2023-12-16,2,EDM,1,5,FLA,33,7,14,1,55,30,8,12,4,54,32,7,14,1,54,30,8,12,4,54,0,1,39,39,0.645161,0.354839,8,6
2023020473,2023-12-16,2,SEA,2,3,LAK,19,15,11,4,49,32,18,15,5,70,12,15,10,1,38,28,16,15,1,60,1,0,19,38,0.392857,0.607143,8,4
2023020474,2023-12-17,2,CHI,3,4,VAN,16,12,8,1,37,15,9,13,3,40,16,12,8,1,37,15,9,13,3,40,1,0,28,27,0.446809,0.553191,13,23
2023020475,2023-12-17,2,CAR,1,2,WSH,25,19,12,1,57,17,8,7,2,34,22,18,12,1,53,15,6,5,1,27,1,0,29,21,0.448276,0.551724,4,10
2023020476,2023-12-17,2,NJD,1,5,ANA,18,12,15,1,46,17,10,9,3,39,17,12,12,1,42,13,9,8,1,31,0,1,29,28,0.566038,0.433962,19,29
2023020477,2023-12-17,2,COL,6,2,SJS,16,17,15,4,52,20,7,17,0,44,16,17,15,4,52,20,7,16,0,43,1,0,29,27,0.618182,0.381818,30,31
2023020478,2023-12-17,2,VGK,6,3,OTT,21,8,12,3,44,16,12,15,1,44,21,8,12,3,44,16,12,15,1,44,1,0,31,25,0.433333,0.566667,10,10
2023020479,2023-12-18,2,DET,3,4,ANA,22,11,16,1,50,12,17,8,3,40,20,10,14,1,45,10,15,8,3,36,0,1,32,22,0.553846,0.446154,10,18
2023020480,2023-12-18,2,PIT,4,3,MIN,15,11,9,2,37,18,13,16,3,50,15,11,9,2,37,18,12,16,3,49,1,0,30,27,0.578947,0.421053,10,14
2023020481,2023-12-18,2,WPG,2,3,MTL,26,14,23,2,65,17,9,11,1,38,26,14,23,2,65,17,9,11,1,38,0,1,32,26,0.462963,0.537037,8,6
2023020482,2023-12-18,2,DAL,4,3,SEA,22,3,8,4,37,31,11,14,3,59,22,3,8,3,36,28,10,14,3,55,1,0,28,38,0.571429,0.428571,8,8
2023020483,2023-12-18,2,CGY,3,1,FLA,19,7,5,1,32,24,11,20,0,55,18,7,5,1,31,23,11,19,0,53,1,0,24,34,0.611111,0.388889,10,10
2023020484,2023-12-19,2,BOS,3,4,MIN,32,11,11,2,56,24,14,16,3,57,30,8,9,2,49,23,14,16,2,55,0,1,43,30,0.622642,0.377358,14,28
2023020485,2023-12-19,2,BUF,4,9,CBJ,18,17,14,3,52,23,8,12,8,51,18,17,14,3,52,23,8,12,8,51,1,0,29,34,0.546875,0.453125,4,6
2023020486,2023-12-19,2,CAR,6,3,VGK,26,20,14,3,63,24,6,10,3,43,26,20,14,3,63,24,6,10,3,43,1,0,39,33,0.430556,0.569444,8,6
2023020487,2023-12-19,2,NJD,2,3,PHI,21,10,23,1,55,19,15,9,3,46,18,10,22,1,51,17,13,9,2,41,1,0,26,26,0.611111,0.388889,6,2
2023020488,2023-12-19,2,TBL,6,1,STL,21,4,17,5,47,23,10,15,0,48,21,4,17,5,47,23,10,15,0,48,1,0,33,29,0.575,0.425,23,13
2023020489,2023-12-19,2,TOR,2,5,NYR,30,14,16,2,62,26,8,17,3,54,30,14,16,2,62,26,8,17,3,54,0,1,33,36,0.446809,0.553191,4,0
2023020490,2023-12-19,2,NYI,3,1,EDM,14,6,7,0,27,23,21,18,1,63,14,6,7,0,27,23,21,18,1,63,0,1,21,31,0.477273,0.522727,8,8
2023020491,2023-12-19,2,NSH,2,5,VAN,22,8,19,2,51,25,7,6,5,43,21,8,19,2,50,25,7,6,5,43,0,1,28,35,0.446429,0.553571,26,4
2023020492,2023-12-19,2,CHI,3,2,COL,17,11,6,2,36,29,13,12,0,54,17,11,6,2,36,29,13,12,0,54,1,0,22,37,0.479167,0.520833,16,32
2023020493,2023-12-19,2,ARI,4,3,OTT,29,13,21,4,67,19,11,14,2,46,29,13,20,4,66,18,11,14,2,45,0,1,38,22,0.540984,0.459016,15,15
2023020494,2023-12-19,2,SJS,1,4,LAK,11,8,12,0,31,33,16,15,2,66,11,8,12,0,31,33,16,15,2,66,0,1,16,39,0.461538,0.538462,4,6
2023020495,2023-12-20,2,WPG,5,2,DET,35,15,11,5,66,23,14,19,2,58,35,15,11,5,66,23,14,19,2,58,1,0,41,28,0.564516,0.435484,4,0
2023020496,2023-12-20,2,WSH,3,2,NYI,23,12,11,2,48,27,7,15,2,51,23,12,11,2,48,27,7,15,2,51,1,0,36,32,0.5,0.5,6,6
2023020497,2023-12-20,2,LAK,1,2,SEA,41,14,9,0,64,25,6,20,2,53,39,14,9,0,62,25,6,18,2,51,0,1,43,30,0.622951,0.377049,6,8
2023020498,2023-12-21,2,BUF,9,3,TOR,20,14,11,7,52,17,7,16,1,41,20,14,11,7,52,17,7,16,1,41,1,0,34,27,0.415094,0.584906,8,10
2023020499,2023-12-21,2,CBJ,2,3,WSH,32,19,15,2,68,21,6,17,1,45,30,19,15,2,66,19,6,17,1,43,0,1,36,32,0.45614,0.54386,6,2
2023020500,2023-12-21,2,FLA,1,4,STL,34,19,16,1,70,17,10,3,4,34,34,19,16,1,70,17,10,3,4,34,0,1,38,24,0.685185,0.314815,2,2
2023020501,2023-12-21,2,NJD,3,6,EDM,23,10,14,3,50,28,10,21,6,65,23,10,14,3,50,28,10,21,6,65,0,1,26,38,0.527273,0.472727,4,0
2023020502,2023-12-21,2,PHI,2,4,NSH,19,7,9,1,36,23,10,11,3,47,18,7,9,1,35,23,10,11,3,47,1,0,31,31,0.481481,0.518519,10,21
2023020503,2023-12-21,2,PIT,2,1,CAR,18,6,18,2,44,20,11,25,1,57,16,5,15,1,37,17,11,24,1,53,1,0,25,24,0.491803,0.508197,4,10
2023020504,2023-12-21,2,TBL,5,4,VGK,23,12,22,3,60,23,11,14,3,51,22,12,22,3,59,23,11,14,3,51,0,1,36,34,0.517857,0.482143,18,18
2023020505,2023-12-21,2,DAL,4,3,VAN,27,12,10,4,53,17,13,13,3,46,25,12,9,2,48,16,13,13,3,45,0,1,36,20,0.5,0.5,6,6
2023020506,2023-12-21,2,MIN,4,3,MTL,13,9,10,2,34,17,12,8,2,39,11,9,9,1,30,14,8,6,2,30,1,0,24,25,0.490909,0.509091,25,19
2023020507,2023-12-21,2,COL,6,4,OTT,27,10,7,2,46,25,10,19,3,57,27,10,7,2,46,25,10,19,3,57,1,0,39,45,0.5625,0.4375,12,10
2023020508,2023-12-21,2,ANA,0,3,CGY,22,5,17,0,44,20,6,9,2,37,22,5,17,0,44,20,6,9,2,37,0,1,25,44,0.5,0.5,19,13
2023020509,2023-12-21,2,SJS,2,5,ARI,25,14,19,2,60,21,12,19,4,56,25,14,19,2,60,21,12,19,4,56,0,1,31,30,0.489796,0.510204,6,2
2023020510,2023-12-22,2,DET,7,6,PHI,25,11,16,7,59,32,17,9,6,64,19,8,13,5,45,26,13,8,6,53,1,0,37,43,0.507463,0.492537,15,47
2023020511,2023-12-22,2,NYR,3,4,EDM,25,9,24,2,60,16,12,13,4,45,25,9,24,2,60,16,12,13,4,45,1,0,34,28,0.410714,0.589286,4,6
2023020512,2023-12-22,2,WPG,5,1,BOS,22,12,20,3,57,22,16,12,1,51,22,12,20,3,57,22,16,12,1,51,1,0,33,25,0.573529,0.426471,4,6
2023020513,2023-12-22,2,CHI,2,5,MTL,19,14,19,2,54,22,10,21,5,58,19,14,19,2,54,22,10,21,5,58,1,0,21,28,0.431373,0.568627,11,7
2023020514,2023-12-23,2,FLA,4,2,VGK,25,14,20,2,61,14,7,8,2,31,25,14,20,2,61,14,7,8,2,31,0,1,42,25,0.523077,0.476923,41,39
2023020515,2023-12-23,2,NSH,2,3,DAL,17,7,13,1,38,29,10,27,3,69,17,7,13,1,38,29,10,27,3,69,1,0,21,34,0.421053,0.578947,4,4
2023020516,2023-12-23,2,CAR,4,5,NYI,34,18,23,2,77,22,6,8,5,41,34,17,23,2,76,22,6,6,5,39,0,1,40,28,0.485294,0.514706,8,10
2023020517,2023-12-23,2,CBJ,1,4,TOR,20,9,17,1,47,21,9,12,2,44,17,8,17,1,43,20,9,11,1,41,0,1,28,30,0.45283,0.54717,8,12
2023020518,2023-12-23,2,MIN,3,2,BOS,20,12,10,2,44,19,10,12,1,42,20,12,10,2,44,19,10,12,1,42,0,1,35,21,0.553571,0.446429,9,15
2023020519,2023-12-23,2,NJD,3,2,DET,19,14,9,3,45,18,7,9,2,36,19,14,9,3,45,18,7,9,2,36,0,1,36,24,0.509804,0.490196,8,10
2023020520,2023-12-23,2,OTT,5,4,PIT,13,8,8,5,34,23,8,23,3,57,13,8,8,4,33,23,8,23,3,57,1,0,26,34,0.409836,0.590164,14,8
2023020521,2023-12-23,2,WSH,1,2,TBL,33,8,22,2,65,15,22,17,3,57,26,5,22,1,54,12,21,15,1,49,0,1,34,20,0.369565,0.630435,4,2
2023020522,2023-12-23,2,NYR,4,3,BUF,21,13,15,3,52,26,13,13,3,55,21,12,15,2,50,23,13,13,3,52,1,0,33,30,0.533333,0.466667,7,33
2023020523,2023-12-23,2,ANA,2,3,SEA,24,10,11,1,46,19,13,18,2,52,24,10,11,1,46,19,13,18,2,52,0,1,34,22,0.625,0.375,2,6
2023020524,2023-12-23,2,STL,7,5,CHI,28,10,11,5,54,12,14,13,3,42,28,10,11,5,54,12,14,13,3,42,1,0,42,20,0.603448,0.396552,4,8
2023020525,2023-12-23,2,COL,4,1,ARI,17,4,9,4,34,21,7,7,0,35,17,4,9,4,34,21,7,7,0,35,1,0,26,25,0.568182,0.431818,11,9
2023020526,2023-12-23,2,LAK,5,3,CGY,20,12,23,5,60,13,7,16,1,37,20,12,23,5,60,13,7,16,1,37,1,0,34,32,0.507463,0.492537,12,8
2023020527,2023-12-23,2,VAN,7,4,SJS,12,13,16,6,47,15,5,8,4,32,12,13,16,6,47,15,5,8,4,32,1,0,26,25,0.53125,0.46875,6,8
2023020528,2023-12-27,2,NJD,4,3,CBJ,25,11,22,4,62,18,10,20,3,51,23,10,22,3,58,17,10,20,3,50,0,1,35,29,0.517241,0.482759,6,6
2023020529,2023-12-27,2,NYR,5,1,WSH,22,10,5,4,41,23,13,11,1,48,22,10,5,4,41,23,13,11,1,48,0,1,31,27,0.5,0.5,4,6
2023020530,2023-12-27,2,TBL,2,3,FLA,18,15,10,2,45,20,12,18,2,52,18,15,9,2,44,20,12,18,2,52,0,1,29,31,0.461538,0.538462,12,12
2023020531,2023-12-27,2,TOR,2,4,OTT,28,20,20,2,70,23,13,10,3,49,28,20,20,2,70,23,13,10,3,49,1,0,36,30,0.516129,0.483871,7,11
2023020532,2023-12-27,2,BUF,1,4,BOS,20,14,13,1,48,18,10,9,1,38,20,14,13,1,48,18,10,8,1,37,0,1,26,25,0.453125,0.546875,10,12
2023020533,2023-12-27,2,NYI,0,7,PIT,20,12,12,0,44,17,13,15,7,52,20,12,12,0,44,17,13,15,7,52,0,1,22,32,0.451613,0.548387,6,4
2023020534,2023-12-27,2,MIN,6,3,DET,21,11,6,6,44,22,13,15,2,52,21,11,6,6,44,22,13,15,2,52,1,0,31,28,0.442308,0.557692,4,4
2023020535,2023-12-27,2,NSH,2,5,CAR,26,5,8,1,40,14,10,16,2,42,26,5,8,1,40,14,10,16,2,42,0,1,37,25,0.372881,0.627119,12,8
2023020536,2023-12-27,2,STL,2,1,DAL,17,6,9,2,34,37,16,19,1,73,17,6,9,2,34,37,16,19,1,73,1,0,30,40,0.548387,0.451613,4,8
2023020537,2023-12-27,2,ARI,5,4,COL,22,16,15,5,58,17,11,9,2,39,18,13,12,4,47,15,9,9,2,35,0,1,27,24,0.423077,0.576923,8,4
2023020538,2023-12-27,2,CHI,2,1,WPG,19,8,11,2,40,35,22,21,1,79,19,7,9,1,36,33,21,21,1,76,1,0,25,38,0.535714,0.464286,8,4
2023020539,2023-12-27,2,CGY,1,2,SEA,31,14,18,0,63,17,8,16,2,43,31,14,18,0,63,17,8,16,2,43,0,1,38,21,0.666667,0.333333,4,8
2023020540,2023-12-27,2,ANA,5,2,VGK,19,10,8,5,42,23,10,24,1,58,19,10,8,5,42,23,10,24,1,58,1,0,26,32,0.458333,0.541667,10,2
2023020541,2023-12-27,2,LAK,5,1,SJS,29,16,14,5,64,22,11,20,1,54,29,16,14,5,64,21,11,19,1,52,0,1,43,25,0.592593,0.407407,11,11
2023020542,2023-12-28,2,CAR,5,3,MTL,21,8,27,4,60,17,18,9,2,46,21,8,27,4,60,17,18,9,2,46,1,0,31,21,0.449275,0.550725,8,6
2023020543,2023-12-28,2,VAN,1,4,PHI,20,8,17,1,46,15,9,10,2,36,20,8,17,1,46,15,9,10,2,36,0,1,27,25,0.327273,0.672727,8,8
2023020544,2023-12-28,2,VGK,3,2,LAK,27,7,10,3,47,29,24,32,2,87,27,7,10,3,47,29,24,32,2,87,1,0,32,34,0.442623,0.557377,4,0
2023020545,2023-12-28,2,SJS,0,5,EDM,23,13,11,0,47,23,13,16,5,57,21,13,10,0,44,22,13,16,5,56,0,1,25,30,0.56,0.44,2,6
2023020546,2023-12-29,2,CBJ,6,5,TOR,14,14,18,5,51,27,14,13,3,57,12,12,17,4,45,26,12,13,3,54,0,1,21,33,0.428571,0.571429,15,11
2023020547,2023-12-29,2,DET,5,4,NSH,12,20,14,4,50,31,18,17,3,69,12,20,14,3,49,29,18,16,3,66,1,0,23,37,0.492063,0.507937,11,11
2023020548,2023-12-29,2,FLA,4,3,NYR,24,12,23,3,62,28,12,11,2,53,24,12,23,3,62,28,12,11,2,53,1,0,33,34,0.576271,0.423729,4,6
2023020549,2023-12-29,2,OTT,2,6,NJD,18,8,14,2,42,18,11,17,4,50,18,8,14,2,42,18,11,17,4,50,1,0,27,30,0.472727,0.527273,8,8
2023020550,2023-12-29,2,NYI,5,1,WSH,24,17,15,5,61,24,11,8,1,44,24,17,15,5,61,24,11,8,1,44,1,0,32,27,0.586957,0.413043,4,6
2023020551,2023-12-29,2,DAL,5,4,CHI,26,17,22,4,69,17,15,14,3,49,24,17,21,3,65,17,15,14,3,49,0,1,35,29,0.636364,0.363636,6,6
2023020552,2023-12-29,2,STL,1,2,COL,23,12,8,0,43,18,5,10,2,35,23,12,8,0,43,17,5,10,2,34,0,1,29,23,0.522727,0.477273,4,8
2023020553,2023-12-29,2,ANA,0,2,ARI,25,9,12,0,46,24,16,16,1,57,25,9,12,0,46,23,16,14,1,54,0,1,28,32,0.587302,0.412698,10,10
2023020554,2023-12-29,2,SEA,2,1,PHI,25,16,19,1,61,22,11,11,0,44,22,16,19,0,57,21,11,10,0,42,0,1,29,28,0.6,0.4,6,4
2023020555,2023-12-30,2,WPG,4,2,MIN,21,9,12,4,46,21,5,13,1,40,21,9,12,4,46,21,5,13,1,40,1,0,32,36,0.527273,0.472727,17,15
2023020556,2023-12-30,2,BUF,3,2,CBJ,38,15,22,3,78,17,7,7,2,33,37,15,22,2,76,17,6,7,2,32,0,1,42,20,0.574074,0.425926,2,2
2023020557,2023-12-30,2,BOS,5,2,NJD,25,9,13,3,50,28,8,13,1,50,25,9,13,3,50,28,8,13,1,50,0,1,31,33,0.27451,0.72549,4,4
2023020558,2023-12-30,2,FLA,4,1,MTL,19,12,19,2,52,17,13,10,0,40,19,12,19,2,52,17,13,10,0,40,1,0,26,19,0.408163,0.591837,9,11
2023020559,2023-12-30,2,PIT,4,2,STL,17,11,18,3,49,21,13,18,1,53,17,11,18,3,49,21,13,18,1,53,1,0,30,27,0.672131,0.327869,6,6
2023020560,2023-12-30,2,TBL,1,5,NYR,29,17,22,0,68,16,10,8,4,38,28,17,20,0,65,14,8,8,4,34,0,1,35,21,0.535714,0.464286,8,10
2023020561,2023-12-30,2,TOR,2,3,CAR,23,7,14,2,46,19,12,10,1,42,23,6,14,2,45,19,11,10,1,41,0,1,27,28,0.610169,0.389831,10,8
2023020562,2023-12-30,2,WSH,2,3,NSH,26,13,13,2,54,34,19,21,3,77,22,12,11,2,47,30,18,20,1,69,0,1,29,36,0.392857,0.607143,11,13
2023020563,2023-12-30,2,LAK,2,3,EDM,22,13,14,3,52,21,14,9,4,48,18,10,11,1,40,18,13,8,0,39,1,0,28,26,0.509091,0.490909,8,8
2023020564,2023-12-31,2,MIN,2,3,WPG,22,9,29,1,61,21,9,17,2,49,22,9,29,1,61,21,9,17,2,49,1,0,26,29,0.622642,0.377358,11,7
2023020565,2023-12-31,2,DET,3,5,BOS,17,10,18,2,47,15,6,14,5,40,17,10,18,2,47,14,6,14,5,39,0,1,30,24,0.679245,0.320755,8,16
2023020566,2023-12-31,2,OTT,5,1,BUF,24,7,15,4,50,36,8,15,1,60,22,6,14,3,45,33,8,14,1,56,1,0,31,46,0.5,0.5,20,16
2023020567,2023-12-31,2,PIT,3,1,NYI,28,16,25,3,72,33,11,16,1,61,28,16,25,3,72,33,11,16,1,61,1,0,38,38,0.609375,0.390625,11,25
2023020568,2023-12-31,2,TBL,4,3,MTL,16,10,18,4,48,25,15,18,3,61,16,10,18,4,48,25,15,18,3,61,0,1,20,29,0.326923,0.673077,19,13
2023020569,2023-12-31,2,ANA,2,7,EDM,22,9,11,2,44,27,8,13,7,55,19,9,11,2,41,26,8,13,7,54,0,1,30,39,0.458333,0.541667,31,41
2023020570,2023-12-31,2,CGY,4,3,PHI,26,10,17,4,57,19,10,19,3,51,23,10,17,3,53,18,10,19,3,50,0,1,33,31,0.423729,0.576271,8,4
2023020571,2023-12-31,2,COL,3,1,SJS,22,15,27,1,65,10,9,10,0,29,21,14,27,1,63,10,9,9,0,28,1,0,33,11,0.45,0.55,8,24
2023020572,2023-12-31,2,DAL,8,1,CHI,29,5,13,7,54,21,12,18,0,51,29,5,13,7,54,21,12,18,0,51,1,0,41,24,0.545455,0.454545,6,6
2023020573,2024-01-01,2,SEA,3,0,VGK,23,13,21,3,60,34,11,20,0,65,23,13,21,3,60,34,11,20,0,65,1,0,27,35,0.47541,0.52459,2,4
2023020574,2024-01-02,2,CBJ,1,4,BOS,24,11,13,1,49,18,5,14,3,40,23,11,13,1,48,17,5,13,3,38,0,1,27,27,0.596491,0.403509,8,4
2023020575,2024-01-02,2,NYR,1,6,CAR,24,9,8,1,42,15,9,10,4,38,24,9,8,1,42,15,9,10,4,38,0,1,29,27,0.491525,0.508475,8,6
2023020576,2024-01-02,2,PIT,3,4,WSH,24,13,21,2,60,17,11,10,3,41,24,13,21,2,60,17,11,10,3,41,0,1,35,22,0.551724,0.448276,4,6
2023020577,2024-01-02,2,DAL,3,4,MTL,28,20,28,3,79,10,6,9,3,28,28,20,28,3,79,10,6,9,3,28,1,0,33,18,0.518519,0.481481,6,2
2023020578,2024-01-02,2,MIN,1,3,CGY,20,11,21,1,53,28,15,14,3,60,20,11,21,1,53,27,13,14,2,56,0,1,29,33,0.415094,0.584906,4,8
2023020579,2024-01-02,2,NSH,3,0,CHI,26,17,21,1,65,19,8,8,0,35,26,17,21,1,65,19,8,8,0,35,1,0,36,21,0.58,0.42,11,13
2023020580,2024-01-02,2,WPG,4,2,TBL,19,11,11,4,45,27,15,17,0,59,19,11,11,4,45,27,15,17,0,59,0,1,28,34,0.466667,0.533333,6,6
2023020581,2024-01-02,2,ARI,1,4,FLA,18,13,9,0,40,24,14,14,3,55,17,13,9,0,39,24,14,14,3,55,0,1,22,38,0.344828,0.655172,40,23
2023020582,2024-01-02,2,COL,5,4,NYI,29,14,25,3,71,16,5,12,3,36,29,14,25,3,71,16,5,12,3,36,0,1,39,22,0.528302,0.471698,6,10
2023020583,2024-01-02,2,EDM,5,2,PHI,25,10,9,4,48,24,3,6,2,35,25,10,9,4,48,22,3,6,2,33,1,0,36,37,0.52381,0.47619,10,8
2023020584,2024-01-02,2,VAN,6,3,OTT,19,13,21,5,58,34,7,17,3,61,19,13,21,5,58,34,7,17,3,61,1,0,26,38,0.509434,0.490566,2,12
2023020585,2024-01-02,2,LAK,0,3,TOR,25,14,27,0,66,21,5,13,3,42,25,13,25,0,63,21,5,13,3,42,0,1,31,29,0.52381,0.47619,13,11
2023020586,2024-01-02,2,SJS,3,5,DET,22,6,28,3,59,23,7,14,3,47,21,5,27,3,56,23,7,13,2,45,0,1,27,31,0.467742,0.532258,10,6
2023020587,2024-01-03,2,WSH,3,6,NJD,19,9,6,1,35,20,14,19,5,58,19,9,6,1,35,20,14,19,5,58,0,1,26,28,0.426471,0.573529,4,8
2023020588,2024-01-03,2,ANA,1,2,TOR,21,3,10,0,34,40,12,19,1,72,18,2,9,0,29,30,10,18,0,58,1,0,28,57,0.408451,0.591549,29,24
2023020589,2024-01-04,2,BOS,5,6,PIT,19,7,18,4,48,24,8,11,5,48,19,7,18,4,48,24,8,11,5,48,1,0,29,35,0.35,0.65,6,4
2023020590,2024-01-04,2,MTL,1,6,BUF,22,12,16,0,50,26,16,13,4,59,22,12,16,0,50,26,16,13,4,59,0,1,33,38,0.539683,0.460317,12,10
2023020591,2024-01-04,2,NYR,4,1,CHI,26,18,15,3,62,20,7,16,1,44,24,14,15,3,56,19,7,16,1,43,1,0,32,23,0.644444,0.355556,11,9
2023020592,2024-01-04,2,PHI,2,3,CBJ,29,13,14,2,58,19,9,17,3,48,24,12,13,2,51,17,7,16,2,42,1,0,41,28,0.557377,0.442623,10,8
2023020593,2024-01-04,2,DAL,4,5,COL,24,15,22,3,64,21,13,18,4,56,23,14,22,3,62,19,12,18,3,52,1,0,32,34,0.492063,0.507937,6,6
2023020594,2024-01-04,2,MIN,1,4,TBL,20,7,13,1,41,23,12,8,3,46,20,7,13,1,41,23,12,8,3,46,0,1,23,30,0.568627,0.431373,11,7
2023020595,2024-01-04,2,NSH,3,6,CGY,28,13,22,3,66,21,11,13,5,50,25,13,21,3,62,18,11,13,4,46,0,1,32,39,0.4,0.6,13,4
2023020596,2024-01-04,2,STL,2,1,VAN,28,11,10,2,51,24,19,14,1,58,28,11,10,2,51,24,19,14,1,58,0,1,32,26,0.680851,0.319149,2,4
2023020597,2024-01-04,2,ARI,1,5,NYI,24,11,16,0,51,21,9,10,4,44,24,11,16,0,51,21,9,10,4,44,0,1,27,31,0.333333,0.666667,4,4
2023020598,2024-01-04,2,SEA,4,1,OTT,20,12,14,4,50,23,23,20,1,67,20,12,14,4,50,23,23,20,1,67,1,0,28,33,0.44898,0.55102,8,4
2023020599,2024-01-04,2,VGK,1,4,FLA,18,11,9,1,39,19,12,11,1,43,18,11,8,1,38,19,12,11,1,43,1,0,27,36,0.457143,0.542857,16,16
2023020600,2024-01-04,2,LAK,3,4,DET,39,10,22,3,74,18,17,9,5,49,34,9,22,3,68,16,14,8,3,41,1,0,43,27,0.517857,0.482143,4,4
2023020601,2024-01-04,2,SJS,1,2,WPG,23,11,15,1,50,24,14,21,1,60,23,11,15,1,50,24,14,21,1,60,1,0,28,30,0.695652,0.304348,2,4
2023020602,2024-01-05,2,NJD,4,2,CHI,19,6,18,4,47,21,6,10,0,37,17,6,18,4,45,21,6,10,0,37,0,1,32,25,0.654545,0.345455,26,38
2023020603,2024-01-05,2,WSH,2,6,CAR,14,9,10,1,34,27,19,20,3,69,14,9,10,1,34,27,19,19,3,68,1,0,17,34,0.393443,0.606557,6,6
2023020604,2024-01-05,2,ANA,1,3,WPG,35,15,17,1,68,24,12,18,2,56,34,15,16,1,66,23,12,18,2,55,1,0,38,27,0.611111,0.388889,4,6
2023020605,2024-01-06,2,PHI,3,2,CGY,27,12,15,1,55,18,10,21,2,51,27,12,15,1,55,18,10,21,2,51,0,1,42,24,0.5,0.5,29,25
2023020606,2024-01-06,2,COL,4,8,FLA,16,3,6,3,28,14,6,15,7,42,16,3,6,3,28,14,6,15,6,41,0,1,26,29,0.5,0.5,12,10
2023020607,2024-01-06,2,BOS,7,3,TBL,12,2,8,5,27,18,11,11,3,43,12,1,8,4,25,18,10,11,2,41,0,1,26,26,0.52,0.48,8,8
2023020608,2024-01-06,2,CAR,1,2,STL,30,23,24,1,78,23,8,13,3,47,25,22,22,0,69,18,7,13,1,39,0,1,30,22,0.574074,0.425926,2,2
2023020609,2024-01-06,2,CBJ,3,4,MIN,21,8,18,2,49,25,5,14,2,46,18,8,18,2,46,24,3,14,1,42,1,0,29,36,0.477612,0.522388,10,10
2023020610,2024-01-06,2,MTL,4,3,NYR,21,17,14,4,56,31,15,20,3,69,18,15,12,3,48,27,13,20,3,63,1,0,30,48,0.5,0.5,6,4
2023020611,2024-01-06,2,NJD,4,6,VAN,19,5,13,4,41,31,14,21,6,72,19,5,13,4,41,31,14,21,6,72,0,1,25,43,0.566667,0.433333,2,4
2023020612,2024-01-06,2,PIT,1,3,BUF,37,14,18,0,69,20,10,17,3,50,36,14,18,0,68,19,10,16,3,48,0,1,41,32,0.534483,0.465517,6,10
2023020613,2024-01-06,2,SJS,1,4,TOR,22,16,13,1,52,27,21,21,3,72,22,16,13,1,52,27,21,21,3,72,0,1,24,32,0.454545,0.545455,4,0
2023020614,2024-01-06,2,DAL,3,4,NSH,25,13,23,2,63,15,12,17,4,48,24,13,23,2,62,15,12,17,4,48,0,1,29,22,0.59322,0.40678,2,4
2023020615,2024-01-06,2,EDM,3,1,OTT,34,6,15,1,56,23,16,15,1,55,34,6,15,1,56,23,16,15,1,55,1,0,46,30,0.615385,0.384615,6,6
2023020616,2024-01-06,2,VGK,5,2,NYI,24,12,18,4,58,23,9,19,2,53,24,12,18,4,58,23,9,19,2,53,1,0,30,29,0.5,0.5,4,2
2023020617,2024-01-07,2,CHI,4,3,CGY,16,6,15,3,40,20,10,21,2,53,16,6,15,3,40,20,10,21,2,53,1,0,20,30,0.431034,0.568966,6,6
2023020618,2024-01-07,2,WSH,4,3,LAK,29,7,17,4,57,36,21,12,1,70,29,7,17,4,57,36,21,12,1,70,1,0,34,41,0.508772,0.491228,6,2
2023020619,2024-01-07,2,ARI,2,6,WPG,13,15,12,2,42,20,15,15,6,56,13,15,12,2,42,20,15,15,6,56,0,1,17,36,0.484375,0.515625,13,9
2023020620,2024-01-07,2,ANA,2,3,DET,21,7,11,2,41,14,6,10,2,32,21,7,11,2,41,14,6,10,2,32,1,0,31,28,0.45283,0.54717,10,8
2023020621,2024-01-08,2,NYR,3,6,VAN,34,10,11,2,57,20,12,9,6,47,34,10,11,2,57,20,12,9,6,47,1,0,42,26,0.59322,0.40678,0,4
2023020622,2024-01-08,2,PHI,1,4,PIT,28,11,16,0,55,26,12,8,3,49,26,11,16,0,53,26,12,8,3,49,0,1,37,39,0.545455,0.454545,16,8
2023020623,2024-01-08,2,MIN,0,4,DAL,16,8,14,0,38,12,11,15,1,39,16,8,14,0,38,12,11,15,1,39,0,1,23,20,0.353846,0.646154,4,12
2023020624,2024-01-08,2,COL,4,3,BOS,25,13,21,3,62,19,10,16,2,47,22,13,21,2,58,15,7,15,2,39,0,1,36,26,0.45,0.55,8,14
2023020625,2024-01-09,2,BUF,2,5,SEA,34,14,24,2,74,19,10,14,4,47,34,14,24,2,74,19,10,14,4,47,1,0,38,26,0.625,0.375,2,2
2023020626,2024-01-09,2,TBL,3,2,LAK,23,14,24,3,64,18,10,10,2,40,22,12,24,2,60,18,9,10,2,39,0,1,29,22,0.5,0.5,4,6
2023020627,2024-01-09,2,TOR,7,1,SJS,36,17,22,4,79,20,7,8,0,35,36,17,22,4,79,20,7,8,0,35,1,0,46,23,0.612903,0.387097,2,6
2023020628,2024-01-09,2,NYI,2,5,VAN,18,5,8,1,32,19,12,12,5,48,18,5,8,1,32,19,12,12,5,48,0,1,20,34,0.58,0.42,8,4
2023020629,2024-01-09,2,NSH,3,5,ANA,32,11,15,2,60,22,5,13,4,44,32,11,15,2,60,22,5,13,4,44,0,1,42,33,0.486111,0.513889,11,11
2023020630,2024-01-09,2,STL,1,5,FLA,21,11,12,1,45,17,4,8,4,33,20,10,12,1,43,17,4,8,4,33,1,0,30,31,0.490196,0.509804,10,12
2023020631,2024-01-09,2,WPG,5,0,CBJ,15,13,21,4,53,26,9,19,0,54,15,13,21,4,53,24,9,19,0,52,1,0,23,29,0.5,0.5,8,8
2023020632,2024-01-09,2,CHI,1,2,EDM,19,11,12,1,43,11,12,13,2,38,19,11,12,1,43,11,12,13,2,38,1,0,26,15,0.358491,0.641509,2,6
2023020633,2024-01-09,2,ARI,4,3,BOS,29,16,12,3,60,22,8,16,1,47,28,15,12,2,57,20,8,16,1,45,0,1,36,33,0.41791,0.58209,19,17
2023020634,2024-01-09,2,CGY,6,3,OTT,27,8,14,6,55,29,7,13,2,51,27,8,14,6,55,29,7,13,2,51,0,1,36,33,0.448276,0.551724,6,4
2023020635,2024-01-10,2,PHI,3,2,MTL,38,14,25,2,79,19,11,15,2,47,30,13,25,1,69,16,9,15,2,42,0,1,39,19,0.54386,0.45614,2,4
2023020636,2024-01-10,2,DAL,7,2,MIN,26,14,11,7,58,17,12,21,1,51,25,13,11,6,55,17,11,20,1,49,1,0,34,23,0.444444,0.555556,6,6
2023020637,2024-01-10,2,COL,3,0,VGK,28,7,21,1,57,16,12,15,0,43,28,7,21,1,57,16,12,15,0,43,1,0,35,25,0.44,0.56,8,8
2023020638,2024-01-11,2,BUF,5,3,OTT,25,5,12,4,46,20,10,26,3,59,25,5,12,4,46,20,10,26,3,59,1,0,32,28,0.5,0.5,8,6
2023020639,2024-01-11,2,CAR,6,3,ANA,20,9,12,5,46,12,9,7,2,30,20,9,12,5,46,12,9,7,2,30,1,0,34,16,0.491525,0.508475,17,13
2023020640,2024-01-11,2,DET,2,3,EDM,15,10,21,2,48,37,13,18,3,71,15,9,20,2,46,35,12,18,2,67,1,0,18,47,0.462963,0.537037,6,8
2023020641,2024-01-11,2,FLA,3,2,LAK,30,18,18,2,68,30,10,13,1,54,27,17,18,2,64,29,8,11,1,49,0,1,41,33,0.581081,0.418919,8,8
2023020642,2024-01-11,2,MTL,2,3,SJS,32,12,21,2,67,29,8,14,3,54,30,12,21,2,65,28,8,14,3,53,0,1,35,35,0.45614,0.54386,8,4
2023020643,2024-01-11,2,PIT,3,4,VAN,26,12,16,3,57,24,10,8,3,45,25,11,16,3,55,22,10,8,2,42,0,1,35,29,0.525424,0.474576,4,8
2023020644,2024-01-11,2,TBL,4,3,NJD,9,9,11,3,32,25,12,15,3,55,9,9,11,2,31,22,12,15,3,52,0,1,20,30,0.489362,0.510638,6,10
2023020645,2024-01-11,2,WSH,1,4,SEA,21,19,13,1,54,19,22,18,4,63,21,19,13,1,54,19,22,18,4,63,0,1,26,23,0.528302,0.471698,2,2
2023020646,2024-01-11,2,NYI,4,3,TOR,20,12,20,2,54,31,7,21,3,62,20,12,20,1,53,31,7,21,3,62,1,0,30,35,0.528302,0.471698,2,6
2023020647,2024-01-11,2,STL,5,2,NYR,13,5,12,3,33,29,14,22,1,66,13,5,12,3,33,29,14,22,1,66,0,1,20,43,0.456522,0.543478,6,8
2023020648,2024-01-11,2,WPG,2,1,CHI,24,11,22,2,59,17,7,19,1,44,24,11,22,2,59,17,7,19,1,44,0,1,28,21,0.5,0.5,4,8
2023020649,2024-01-11,2,ARI,2,6,CGY,29,11,27,2,69,19,10,10,4,43,28,10,25,2,65,16,10,10,4,40,0,1,34,30,0.411765,0.588235,8,4
2023020650,2024-01-11,2,VGK,2,1,BOS,13,8,20,1,42,28,11,18,1,58,13,8,20,0,41,28,11,17,1,57,1,0,25,33,0.469388,0.530612,6,10
2023020651,2024-01-12,2,DAL,3,6,NSH,16,15,17,2,50,25,12,11,5,53,15,15,17,2,49,25,12,10,4,51,0,1,22,38,0.596774,0.403226,10,6
2023020652,2024-01-12,2,MIN,3,4,PHI,23,8,16,3,50,27,16,10,3,56,23,8,16,3,50,25,16,10,3,54,1,0,29,35,0.482143,0.517857,11,9
2023020653,2024-01-13,2,WSH,3,2,NYR,18,10,13,3,44,21,12,20,2,55,18,10,13,3,44,21,12,20,2,55,0,1,21,27,0.305085,0.694915,10,10
2023020654,2024-01-13,2,BUF,0,1,VAN,19,7,16,0,42,17,10,14,1,42,18,7,16,0,41,15,8,12,1,36,0,1,26,23,0.396226,0.603774,13,15
2023020655,2024-01-13,2,OTT,5,4,SJS,31,14,28,5,78,11,7,13,4,35,31,14,28,5,78,11,7,13,4,35,1,0,41,18,0.574074,0.425926,4,4
2023020656,2024-01-13,2,FLA,1,4,NJD,30,18,20,0,68,16,11,9,4,40,30,18,20,0,68,16,11,9,4,40,0,1,36,22,0.490566,0.509434,4,4
2023020657,2024-01-13,2,CAR,3,2,PIT,28,14,8,3,53,35,7,14,2,58,27,13,7,2,49,31,7,13,2,53,1,0,35,40,0.508475,0.491525,10,8
2023020658,2024-01-13,2,CBJ,4,7,SEA,28,10,22,3,63,23,5,7,6,41,27,10,22,3,62,23,5,7,6,41,1,0,34,36,0.508475,0.491525,9,11
2023020659,2024-01-13,2,DET,5,3,LAK,19,8,12,4,43,32,10,16,0,58,19,8,12,4,43,32,10,16,0,58,1,0,30,36,0.655738,0.344262,6,6
2023020660,2024-01-13,2,MTL,1,2,EDM,17,8,9,0,34,30,14,20,1,65,15,8,9,0,32,30,13,20,1,64,1,0,24,41,0.53125,0.46875,10,8
2023020661,2024-01-13,2,TBL,5,1,ANA,33,13,13,2,61,18,7,13,0,38,33,13,13,2,61,18,7,13,0,38,1,0,41,20,0.5,0.5,20,10
2023020662,2024-01-13,2,TOR,3,5,COL,24,11,15,3,53,16,22,18,4,60,24,11,15,3,53,16,22,18,4,60,1,0,29,33,0.490196,0.509804,8,2
2023020663,2024-01-13,2,WPG,0,2,PHI,31,21,20,0,72,32,12,11,1,56,31,21,20,0,72,32,12,11,1,56,0,1,35,36,0.466667,0.533333,4,6
2023020664,2024-01-13,2,CHI,1,3,DAL,33,13,12,1,59,24,11,18,2,55,33,13,12,1,59,24,11,18,2,55,1,0,35,30,0.306452,0.693548,11,9
2023020665,2024-01-13,2,MIN,0,6,ARI,28,13,17,0,58,24,10,9,4,47,28,11,15,0,54,23,9,9,4,45,0,1,38,33,0.561404,0.438596,18,18
2023020666,2024-01-13,2,NSH,3,1,NYI,22,14,24,2,62,20,7,20,1,48,22,14,24,2,62,20,7,20,1,48,0,1,28,25,0.490196,0.509804,4,6
2023020667,2024-01-13,2,STL,3,4,BOS,18,5,8,1,32,30,15,15,3,63,18,5,7,1,31,30,15,14,2,61,0,1,23,35,0.530612,0.469388,8,6
2023020668,2024-01-13,2,VGK,1,3,CGY,30,21,26,1,78,20,14,14,2,50,30,21,26,1,78,20,14,14,2,50,0,1,32,26,0.451613,0.548387,4,4
2023020669,2024-01-14,2,NYR,2,1,WSH,17,9,9,2,37,19,10,24,1,54,17,9,9,2,37,18,9,24,1,52,1,0,31,25,0.421053,0.578947,6,12
2023020670,2024-01-14,2,TOR,2,4,DET,22,14,18,2,56,14,10,14,4,42,22,14,18,2,56,14,10,14,4,42,1,0,30,24,0.607143,0.392857,4,6
2023020671,2024-01-15,2,BOS,3,0,NJD,26,14,13,2,55,28,13,16,0,57,26,14,10,2,52,27,13,16,0,56,1,0,36,31,0.5,0.5,4,10
2023020672,2024-01-15,2,BUF,3,0,SJS,30,13,14,2,59,27,12,16,0,55,30,11,14,2,57,26,12,15,0,53,1,0,35,28,0.482143,0.517857,6,6
2023020673,2024-01-15,2,CBJ,4,3,VAN,32,16,8,3,59,25,9,13,2,49,27,16,8,2,53,20,9,12,2,43,0,1,43,30,0.46,0.54,8,10
2023020674,2024-01-15,2,FLA,4,5,ANA,27,18,13,1,59,18,12,9,4,43,22,15,12,1,50,14,11,9,3,37,1,0,33,26,0.619048,0.380952,16,14
2023020675,2024-01-15,2,CAR,2,5,LAK,17,12,16,2,47,16,11,9,4,40,17,12,16,2,47,16,11,9,4,40,0,1,32,26,0.508772,0.491228,8,10
2023020676,2024-01-15,2,MIN,5,0,NYI,27,8,10,2,47,15,11,9,0,35,27,8,10,2,47,14,11,8,0,33,1,0,40,21,0.47541,0.52459,10,12
2023020677,2024-01-15,2,PIT,3,0,SEA,28,12,13,3,56,17,15,11,0,43,28,12,13,3,56,17,15,11,0,43,1,0,33,22,0.6,0.4,4,4
2023020678,2024-01-15,2,MTL,4,3,COL,29,5,8,2,44,29,13,26,2,70,27,5,7,2,41,29,13,26,1,69,0,1,34,35,0.614286,0.385714,10,6
2023020679,2024-01-15,2,STL,2,4,PHI,26,9,18,1,54,35,14,18,4,71,26,9,18,1,54,35,14,18,4,71,0,1,30,42,0.403846,0.596154,4,6
2023020680,2024-01-15,2,VGK,4,1,NSH,23,12,25,4,64,27,15,19,1,62,22,12,25,3,62,26,15,18,1,60,1,0,29,35,0.627451,0.372549,8,4
2023020681,2024-01-16,2,NYR,5,2,SEA,18,14,9,4,45,29,19,16,0,64,18,14,9,4,45,29,19,16,0,64,1,0,23,31,0.674419,0.325581,4,4
2023020682,2024-01-16,2,OTT,4,7,COL,32,15,24,3,74,22,5,14,6,47,28,15,23,3,69,22,5,14,6,47,1,0,40,34,0.597222,0.402778,10,10
2023020683,2024-01-16,2,WSH,2,0,ANA,24,8,13,2,47,20,15,19,0,54,24,7,12,1,44,19,15,18,0,52,1,0,28,24,0.422222,0.577778,11,9
2023020684,2024-01-16,2,DAL,5,1,LAK,19,14,12,4,49,28,16,18,0,62,19,14,12,4,49,28,16,18,0,62,1,0,28,32,0.508772,0.491228,8,2
2023020685,2024-01-16,2,WPG,4,2,NYI,27,13,8,3,51,30,11,11,2,54,27,13,8,3,51,30,11,11,2,54,1,0,44,37,0.539683,0.460317,4,10
2023020686,2024-01-16,2,CHI,2,1,SJS,19,16,16,2,53,39,19,8,2,68,16,11,16,0,43,32,16,8,1,57,1,0,25,38,0.490909,0.509091,16,20
2023020687,2024-01-16,2,CGY,3,2,ARI,15,7,9,2,33,16,16,17,2,51,13,6,9,2,30,15,14,15,2,46,0,1,30,25,0.592593,0.407407,8,12
2023020688,2024-01-16,2,EDM,4,2,TOR,27,19,21,4,71,21,14,11,2,48,27,19,21,4,71,21,14,11,2,48,0,1,32,27,0.52,0.48,2,2
2023020689,2024-01-17,2,FLA,2,3,DET,29,13,22,1,65,23,6,10,2,41,27,13,19,1,60,22,6,8,2,38,1,0,34,29,0.614035,0.385965,12,10
2023020690,2024-01-17,2,NJD,2,3,MTL,19,20,13,0,52,16,7,11,3,37,19,20,13,0,52,16,7,11,3,37,0,1,30,25,0.622222,0.377778,2,8
2023020691,2024-01-18,2,BUF,3,0,CHI,16,9,16,2,43,9,5,9,0,23,16,9,16,2,43,9,5,9,0,23,1,0,31,19,0.435897,0.564103,10,15
2023020692,2024-01-18,2,BOS,5,2,COL,20,10,20,4,54,28,15,13,2,58,20,10,19,4,53,28,15,13,2,58,1,0,31,32,0.491803,0.508197,4,6
2023020693,2024-01-18,2,OTT,6,2,MTL,28,22,13,6,69,17,11,15,2,45,28,22,13,5,68,17,11,14,2,44,1,0,37,23,0.47619,0.52381,15,11
2023020694,2024-01-18,2,PHI,5,1,DAL,28,11,21,4,64,10,9,19,1,39,28,11,21,3,63,10,9,19,1,39,1,0,43,15,0.5,0.5,4,8
2023020695,2024-01-18,2,TBL,7,3,MIN,23,14,13,4,54,26,11,18,3,58,23,14,13,4,54,26,11,18,3,58,0,1,38,33,0.641509,0.358491,8,10
2023020696,2024-01-18,2,WSH,5,2,STL,14,4,14,3,35,10,8,14,2,34,14,4,14,3,35,10,8,14,2,34,1,0,26,20,0.509804,0.490196,10,8
2023020697,2024-01-18,2,CGY,3,4,TOR,22,17,12,2,53,25,15,13,3,56,22,17,11,2,52,24,15,11,3,53,1,0,26,32,0.460317,0.539683,6,8
2023020698,2024-01-18,2,EDM,4,2,SEA,23,5,9,2,39,17,8,15,2,42,22,5,8,2,37,16,8,13,2,39,0,1,36,27,0.68,0.32,24,23
2023020699,2024-01-18,2,LAK,1,2,NSH,27,18,19,0,64,24,13,13,1,51,27,18,19,0,64,23,13,13,1,50,0,1,34,33,0.551724,0.448276,6,10
2023020700,2024-01-18,2,VAN,2,1,ARI,17,6,6,1,30,19,5,11,1,36,17,6,6,1,30,19,5,11,1,36,1,0,26,21,0.716981,0.283019,11,17
2023020701,2024-01-18,2,VGK,5,1,NYR,17,3,13,3,36,24,15,20,0,59,17,3,13,3,36,24,15,20,0,59,1,0,26,30,0.5,0.5,6,6
2023020702,2024-01-19,2,CAR,4,2,DET,26,14,19,3,62,10,10,9,1,30,26,14,19,3,62,10,10,9,1,30,0,1,30,12,0.557377,0.442623,2,2
2023020703,2024-01-19,2,CBJ,1,4,NJD,27,18,16,1,62,22,7,13,4,46,27,17,16,1,61,22,7,13,4,46,1,0,30,33,0.358491,0.641509,8,6
2023020704,2024-01-19,2,FLA,4,6,MIN,25,19,30,4,78,8,10,6,1,25,25,19,30,4,78,8,10,6,1,25,0,1,35,26,0.474576,0.525424,26,22
2023020705,2024-01-19,2,CHI,4,3,NYI,19,10,18,4,51,26,16,25,3,70,19,10,17,3,49,24,14,25,3,66,0,1,24,30,0.459016,0.540984,6,6
2023020706,2024-01-20,2,BUF,1,3,TBL,23,14,13,1,51,10,13,11,2,36,21,13,13,1,48,10,13,11,2,36,0,1,27,16,0.469388,0.530612,6,4
2023020707,2024-01-20,2,PHI,4,7,COL,28,13,27,4,72,13,5,13,6,37,28,13,27,4,72,13,5,13,6,37,0,1,40,25,0.644068,0.355932,4,6
2023020708,2024-01-20,2,ARI,3,2,NSH,16,18,13,3,50,20,14,14,1,49,16,18,13,3,50,20,14,14,1,49,1,0,24,32,0.526316,0.473684,12,4
2023020709,2024-01-20,2,OTT,1,2,WPG,26,10,16,1,53,19,9,13,2,43,25,10,14,1,50,16,9,13,1,39,0,1,35,29,0.5,0.5,13,13
2023020710,2024-01-20,2,BOS,9,4,MTL,23,6,8,8,45,17,10,12,2,41,23,6,8,8,45,17,10,12,2,41,0,1,36,21,0.509091,0.490909,11,11
2023020711,2024-01-20,2,NJD,2,6,DAL,27,13,15,2,57,25,13,16,4,58,26,11,15,2,54,25,12,16,4,57,0,1,31,36,0.515625,0.484375,22,6
2023020712,2024-01-20,2,VAN,6,4,TOR,13,12,11,4,40,33,10,14,3,60,13,12,11,4,40,33,10,14,3,60,1,0,21,46,0.381818,0.618182,18,14
2023020713,2024-01-20,2,STL,3,0,WSH,21,9,16,1,47,13,7,12,0,32,21,9,16,1,47,13,7,12,0,32,1,0,29,18,0.408163,0.591837,22,20
2023020714,2024-01-20,2,CGY,1,3,EDM,22,7,14,1,44,26,12,9,3,50,17,7,14,1,39,23,12,9,3,47,0,1,27,32,0.535714,0.464286,4,6
2023020715,2024-01-20,2,SJS,5,3,ANA,12,14,20,5,51,26,10,13,2,51,12,14,20,5,51,26,10,13,2,51,1,0,19,34,0.490566,0.509434,10,8
2023020716,2024-01-20,2,VGK,3,2,PIT,21,14,10,3,48,19,11,20,2,52,21,14,10,3,48,19,11,20,2,52,0,1,29,25,0.440678,0.559322,2,8
2023020717,2024-01-20,2,LAK,2,1,NYR,24,9,17,2,52,16,11,13,1,41,24,9,17,2,52,16,11,13,1,41,1,0,26,23,0.56,0.44,6,2
2023020718,2024-01-21,2,PHI,3,5,OTT,17,6,15,1,39,26,14,12,5,57,17,6,14,1,38,25,14,12,5,56,1,0,25,34,0.375,0.625,6,8
2023020719,2024-01-21,2,CAR,2,5,MIN,28,18,20,2,68,11,8,8,5,32,28,17,20,2,67,11,8,8,5,32,1,0,42,19,0.606557,0.393443,4,8
2023020720,2024-01-21,2,DET,2,1,TBL,24,4,14,2,44,17,12,9,1,39,24,4,14,2,44,17,12,9,1,39,0,1,35,28,0.507937,0.492063,6,4
2023020721,2024-01-21,2,NYI,3,2,DAL,23,9,10,3,45,35,12,18,2,67,23,9,10,2,44,35,12,18,2,67,1,0,28,43,0.396552,0.603448,6,0
2023020722,2024-01-21,2,ANA,2,5,NYR,13,3,9,2,27,26,17,26,3,72,13,3,9,2,27,26,17,26,3,72,1,0,18,33,0.52459,0.47541,8,6
2023020723,2024-01-21,2,SEA,1,3,TOR,16,10,19,1,46,19,18,15,3,55,16,10,19,1,46,19,18,15,3,55,0,1,17,26,0.283019,0.716981,11,11
2023020724,2024-01-22,2,BOS,4,1,WPG,13,12,9,3,37,18,12,11,1,42,13,12,9,3,37,18,12,11,1,42,1,0,21,21,0.5,0.5,6,6
2023020725,2024-01-22,2,NJD,6,5,VGK,26,15,14,6,61,25,10,13,5,53,23,11,13,5,52,24,10,12,4,50,0,1,38,32,0.461538,0.538462,2,6
2023020726,2024-01-22,2,NSH,1,4,FLA,20,5,14,1,40,26,10,18,3,57,18,5,14,1,38,26,10,16,3,55,0,1,27,38,0.542373,0.457627,13,15
2023020727,2024-01-22,2,ARI,5,2,PIT,19,13,15,4,51,21,7,16,2,46,17,12,15,4,48,20,7,16,2,45,1,0,26,27,0.378788,0.621212,6,6
2023020728,2024-01-22,2,VAN,2,0,CHI,24,17,10,2,53,20,8,9,0,37,23,17,10,2,52,19,8,9,0,36,1,0,29,31,0.447368,0.552632,10,6
2023020729,2024-01-22,2,LAK,3,4,SJS,45,18,21,2,86,20,9,22,5,56,38,18,21,2,79,18,9,21,3,51,0,1,47,27,0.45283,0.54717,2,6
2023020730,2024-01-23,2,DET,4,5,DAL,24,11,26,1,62,30,8,18,4,60,24,11,26,1,62,30,8,18,4,60,0,1,34,38,0.4,0.6,4,8
2023020731,2024-01-23,2,MTL,1,4,OTT,20,9,14,1,44,19,6,9,3,37,19,8,14,1,42,18,6,7,2,33,0,1,25,28,0.52,0.48,10,10
2023020732,2024-01-23,2,PHI,3,6,TBL,26,19,15,2,62,14,8,21,4,47,25,18,14,1,58,14,8,21,4,47,0,1,32,21,0.557692,0.442308,8,6
2023020733,2024-01-23,2,NYI,2,3,VGK,32,19,16,1,68,18,7,6,2,33,31,19,16,1,67,18,7,6,2,33,0,1,42,27,0.528302,0.471698,6,6
2023020734,2024-01-23,2,MIN,5,3,WSH,21,10,11,5,47,23,8,8,2,41,21,10,11,5,47,23,8,8,2,41,1,0,30,33,0.5,0.5,8,4
2023020735,2024-01-23,2,CGY,3,4,STL,27,9,17,3,56,19,8,15,3,45,27,9,17,3,56,19,8,15,3,45,1,0,35,26,0.526316,0.473684,2,6
2023020736,2024-01-23,2,EDM,4,1,CBJ,17,8,14,3,42,22,11,12,1,46,17,8,14,3,42,22,11,12,1,46,1,0,24,27,0.510204,0.489796,10,6
2023020737,2024-01-23,2,ANA,4,2,BUF,25,9,8,3,45,25,13,17,1,56,24,9,8,3,44,24,13,16,1,54,1,0,36,30,0.509804,0.490196,38,30
2023020738,2024-01-23,2,SJS,3,2,NYR,15,13,15,3,46,25,11,13,2,51,15,12,15,2,44,23,11,12,2,48,0,1,22,31,0.396552,0.603448,6,6
2023020739,2024-01-24,2,FLA,6,2,ARI,28,3,5,5,41,26,10,7,1,44,28,3,5,5,41,26,10,7,1,44,1,0,42,33,0.541667,0.458333,36,30
2023020740,2024-01-24,2,TOR,1,0,WPG,18,10,8,1,37,28,15,18,0,61,17,9,8,0,34,26,15,18,0,59,0,0,30,32,0.648148,0.351852,4,10
2023020741,2024-01-24,2,BOS,2,3,CAR,21,5,6,2,34,27,17,10,1,55,21,5,6,2,34,27,17,10,1,55,0,1,28,33,0.52,0.48,6,8
2023020742,2024-01-24,2,COL,6,2,WSH,23,9,17,3,52,18,20,23,2,63,23,8,17,2,50,18,20,23,1,62,1,0,31,25,0.546875,0.453125,10,8
2023020743,2024-01-24,2,SEA,6,2,CHI,21,8,19,6,54,25,14,16,1,56,21,8,19,6,54,25,14,16,1,56,1,0,28,34,0.507463,0.492537,6,6
2023020744,2024-01-24,2,VAN,3,4,STL,23,18,21,2,64,12,9,15,3,39,22,18,21,2,63,12,8,14,2,36,0,1,32,18,0.520833,0.479167,6,6
2023020745,2024-01-24,2,LAK,3,5,BUF,31,16,11,2,60,26,8,16,5,55,31,16,11,2,60,26,8,16,5,55,1,0,40,37,0.54386,0.45614,8,6
2023020746,2024-01-25,2,CAR,3,2,NJD,17,12,7,2,38,22,9,12,2,45,17,12,7,2,38,22,9,11,2,44,1,0,23,25,0.568627,0.431373,6,8
2023020747,2024-01-25,2,DET,3,0,PHI,9,6,13,2,30,23,12,22,0,57,9,6,13,2,30,23,12,22,0,57,1,0,17,30,0.618182,0.381818,17,19
2023020748,2024-01-25,2,MTL,4,3,NYI,13,4,7,2,26,29,17,12,0,58,13,4,7,1,25,28,16,12,0,56,1,0,26,46,0.48,0.52,15,10
2023020749,2024-01-25,2,OTT,2,3,BOS,29,8,19,0,56,18,6,15,2,41,27,8,18,0,53,16,6,15,1,38,0,1,37,23,0.509091,0.490909,8,18
2023020750,2024-01-25,2,TBL,6,3,ARI,20,8,14,5,47,16,6,17,3,42,20,8,14,5,47,16,6,17,3,42,1,0,37,20,0.44186,0.55814,12,26
2023020751,2024-01-25,2,DAL,4,3,ANA,33,12,16,4,65,17,13,6,3,39,33,11,16,3,63,14,13,6,3,36,1,0,44,21,0.591837,0.408163,2,6
2023020752,2024-01-25,2,MIN,2,3,NSH,14,7,13,0,34,25,11,18,3,57,14,7,13,0,34,25,11,18,3,57,1,0,24,29,0.516667,0.483333,26,20
2023020753,2024-01-25,2,CGY,2,5,CBJ,21,14,12,2,49,18,6,16,3,43,21,14,12,2,49,18,6,16,3,43,0,1,30,32,0.566667,0.433333,19,4
2023020754,2024-01-25,2,EDM,3,0,CHI,29,14,16,2,61,27,8,10,0,45,28,14,16,2,60,26,8,9,0,43,1,0,34,27,0.584906,0.415094,2,4
2023020755,2024-01-26,2,NYR,2,5,VGK,31,16,22,2,71,14,12,10,5,41,31,16,22,2,71,14,12,10,5,41,0,1,38,20,0.491803,0.508197,4,4
2023020756,2024-01-26,2,PIT,2,3,FLA,19,10,17,2,48,23,13,17,2,55,17,9,16,1,43,20,12,17,0,49,1,0,37,31,0.555556,0.444444,6,16
2023020757,2024-01-26,2,COL,5,1,LAK,21,8,13,4,46,17,9,13,0,39,19,5,12,4,40,16,9,13,0,38,1,0,31,27,0.480769,0.519231,14,12
2023020758,2024-01-26,2,SEA,3,4,STL,32,17,19,2,70,12,14,6,2,34,31,16,19,2,68,11,12,6,1,30,0,1,36,18,0.46,0.54,4,4
2023020759,2024-01-27,2,PHI,2,6,BOS,31,10,18,2,61,17,10,7,6,40,31,10,18,2,61,17,10,7,6,40,0,1,37,28,0.584906,0.415094,6,6
2023020760,2024-01-27,2,DAL,5,4,WSH,28,12,19,4,63,18,16,10,3,47,28,12,17,3,60,18,16,10,3,47,0,1,35,28,0.622951,0.377049,4,4
2023020761,2024-01-27,2,EDM,4,1,NSH,16,12,14,2,44,24,17,15,1,57,16,12,14,2,44,24,17,15,1,57,1,0,21,29,0.423077,0.576923,6,6
2023020762,2024-01-27,2,SJS,2,5,BUF,22,19,19,2,62,26,17,11,5,59,21,19,19,2,61,26,17,11,4,58,1,0,26,36,0.550725,0.449275,10,10
2023020763,2024-01-27,2,CAR,3,1,ARI,32,23,26,2,83,9,6,13,1,29,31,23,26,2,82,9,6,13,1,29,0,1,39,11,0.636364,0.363636,4,6
2023020764,2024-01-27,2,DET,5,2,VGK,21,9,10,4,44,25,6,9,2,42,21,9,10,4,44,25,6,9,2,42,1,0,29,30,0.4375,0.5625,4,4
2023020765,2024-01-27,2,OTT,2,7,NYR,26,16,14,1,57,19,8,16,7,50,26,16,14,1,57,19,7,16,5,47,1,0,31,29,0.465517,0.534483,28,14
2023020766,2024-01-27,2,PIT,3,2,MTL,26,20,22,3,71,24,15,5,1,45,26,20,22,2,70,23,14,4,1,42,0,1,33,27,0.610169,0.389831,2,4
2023020767,2024-01-27,2,TBL,6,3,NJD,31,14,13,6,64,18,12,8,3,41,31,14,13,6,64,18,12,8,3,41,1,0,42,24,0.508772,0.491228,2,6
2023020768,2024-01-27,2,WPG,2,4,TOR,20,18,10,2,50,25,7,10,2,44,20,17,9,2,48,25,7,10,2,44,1,0,26,30,0.377778,0.622222,12,14
2023020769,2024-01-27,2,NYI,2,3,FLA,21,15,8,2,46,25,9,18,1,53,20,15,8,2,45,23,8,18,0,49,0,1,23,37,0.462687,0.537313,8,2
2023020770,2024-01-27,2,MIN,2,3,ANA,24,6,15,2,47,15,8,11,3,37,24,6,15,2,47,15,8,11,3,37,1,0,37,25,0.491228,0.508772,4,8
2023020771,2024-01-27,2,CGY,1,0,CHI,27,12,18,0,57,31,11,8,0,50,27,12,18,0,57,31,11,8,0,50,1,0,31,32,0.472727,0.527273,4,4
2023020772,2024-01-27,2,VAN,5,4,CBJ,24,14,14,2,54,17,7,14,2,40,23,12,13,1,49,15,7,14,2,38,0,1,34,29,0.642857,0.357143,19,8
2023020773,2024-01-28,2,STL,4,3,LAK,17,3,10,3,33,26,11,12,2,51,16,3,10,2,31,26,11,12,2,51,0,1,32,33,0.509434,0.490566,2,12
2023020774,2024-01-28,2,SEA,4,2,CBJ,21,10,19,2,52,28,12,12,2,54,21,9,19,2,51,28,12,12,2,54,1,0,26,32,0.590164,0.409836,4,6
2023020775,2024-01-29,2,OTT,4,3,NSH,25,16,13,4,58,19,6,23,3,51,24,15,11,3,53,18,6,22,3,49,0,1,35,28,0.5,0.5,8,8
2023020776,2024-01-30,2,STL,0,1,CBJ,19,13,18,0,50,19,13,16,1,49,19,13,17,0,49,19,13,16,1,49,0,1,21,22,0.510638,0.489362,9,11
2023020777,2024-01-30,2,SJS,2,0,SEA,19,10,11,2,42,29,17,16,0,62,19,10,11,2,42,29,17,16,0,62,1,0,22,32,0.490909,0.509091,7,7
2023020778,2024-01-31,2,DET,2,3,OTT,22,17,15,2,56,17,21,13,3,54,22,17,15,2,56,16,20,13,2,51,1,0,25,25,0.519231,0.480769,6,2
2023020779,2024-01-31,2,NSH,2,4,LAK,31,15,13,2,61,19,7,14,4,44,31,14,13,2,60,19,7,14,4,44,0,1,42,24,0.604167,0.395833,4,8
2023020780,2024-01-31,2,ANA,3,2,SJS,23,16,26,3,68,16,10,9,1,36,21,16,24,2,63,14,7,7,1,29,1,0,34,28,0.545455,0.454545,18,10
2023020781,2024-02-05,2,NYR,2,1,COL,22,13,14,2,51,29,13,13,1,56,22,13,13,1,49,27,12,13,1,53,0,1,29,33,0.555556,0.444444,8,4
2023020782,2024-02-05,2,TOR,2,3,NYI,31,17,21,1,70,20,18,17,3,58,31,17,21,0,69,20,18,17,3,58,0,1,36,29,0.5,0.5,11,11
2023020783,2024-02-06,2,BOS,1,4,CGY,18,11,14,0,43,22,14,16,2,54,15,11,14,0,40,20,12,16,1,49,0,1,22,29,0.553191,0.446809,24,25
2023020784,2024-02-06,2,BUF,1,2,DAL,32,10,21,0,63,17,11,9,1,38,32,10,21,0,63,17,11,9,1,38,0,1,48,30,0.402439,0.597561,10,8
2023020785,2024-02-06,2,CAR,2,3,VAN,22,18,19,0,59,16,11,10,1,38,22,18,19,0,59,16,11,10,1,38,1,0,24,19,0.490566,0.509434,6,4
2023020786,2024-02-06,2,FLA,1,2,PHI,19,22,23,0,64,22,20,11,2,55,19,21,23,0,63,21,20,11,2,54,1,0,21,25,0.422222,0.577778,4,6
2023020787,2024-02-06,2,NJD,5,3,COL,21,9,19,5,54,29,10,18,3,60,21,9,19,5,54,28,10,16,1,55,0,1,31,38,0.629032,0.370968,8,8
2023020788,2024-02-06,2,PIT,3,0,WPG,19,10,12,1,42,22,12,20,0,54,19,10,12,1,42,22,12,20,0,54,1,0,27,23,0.617021,0.382979,4,5
2023020789,2024-02-06,2,WSH,2,5,MTL,32,12,18,2,64,19,7,5,4,35,30,12,18,1,61,19,7,5,3,34,0,1,39,26,0.491525,0.508475,6,8
2023020790,2024-02-06,2,VGK,3,1,EDM,21,5,18,3,47,26,21,27,0,74,20,5,18,3,46,26,21,27,0,74,0,1,26,31,0.471698,0.528302,2,4
2023020791,2024-02-07,2,NYR,3,1,TBL,19,13,8,3,43,16,16,22,1,55,19,13,8,3,43,16,16,22,1,55,1,0,24,18,0.5,0.5,2,4
2023020792,2024-02-07,2,TOR,5,4,DAL,22,10,11,2,45,22,19,22,3,66,22,10,11,2,45,22,19,22,2,65,1,0,31,31,0.453125,0.546875,8,6
2023020793,2024-02-07,2,CHI,1,2,MIN,18,10,16,1,45,17,12,13,2,44,18,10,16,1,45,17,12,13,2,44,0,1,21,25,0.561404,0.438596,9,9
2023020794,2024-02-08,2,BOS,4,0,VAN,17,9,5,2,33,15,11,11,0,37,15,9,5,2,31,15,9,10,0,34,1,0,24,17,0.425926,0.574074,10,10
2023020795,2024-02-08,2,FLA,4,2,WSH,30,14,24,3,71,13,10,18,1,42,30,14,24,3,71,12,10,18,1,41,0,1,41,23,0.481481,0.518519,8,12
2023020796,2024-02-08,2,NJD,3,5,CGY,33,9,12,2,56,25,6,15,5,51,33,9,12,2,56,25,6,15,5,51,1,0,40,30,0.52459,0.47541,6,4
2023020797,2024-02-08,2,PHI,4,1,WPG,13,4,15,3,35,20,15,21,1,57,13,4,15,3,35,20,15,21,1,57,1,0,21,29,0.576923,0.423077,11,13
2023020798,2024-02-08,2,NYI,6,2,TBL,10,6,11,5,32,12,13,19,1,45,10,6,11,5,32,12,13,19,1,45,1,0,24,20,0.416667,0.583333,4,8
2023020799,2024-02-08,2,CAR,5,2,COL,10,15,16,4,45,22,11,11,2,46,10,15,16,4,45,20,10,9,0,39,1,0,27,27,0.555556,0.444444,34,12
2023020800,2024-02-08,2,ARI,2,3,VGK,20,22,22,2,66,29,7,17,3,56,20,22,22,2,66,29,7,17,3,56,0,1,22,34,0.604167,0.395833,2,2
2023020801,2024-02-09,2,MIN,3,2,PIT,18,14,8,2,42,22,9,13,1,45,17,13,8,1,39,22,9,13,1,45,1,0,30,36,0.459016,0.540984,14,14
2023020802,2024-02-09,2,CHI,3,4,NYR,25,8,13,3,49,26,3,12,4,45,25,8,12,3,48,22,3,11,3,39,1,0,31,35,0.607143,0.392857,8,6
2023020803,2024-02-09,2,ANA,3,5,EDM,21,3,10,1,35,24,14,12,4,54,21,3,10,1,35,24,14,12,4,54,1,0,27,32,0.470588,0.529412,4,4
2023020804,2024-02-10,2,BUF,1,3,STL,26,15,16,1,58,19,11,12,2,44,23,15,15,1,54,19,10,12,2,43,0,1,34,26,0.559322,0.440678,6,8
2023020805,2024-02-10,2,DET,4,3,VAN,18,4,12,3,37,14,8,17,3,42,17,4,12,2,35,14,8,17,3,42,1,0,28,31,0.407407,0.592593,19,24
2023020806,2024-02-10,2,MTL,2,3,DAL,12,8,13,2,35,23,9,13,3,48,12,8,13,2,35,23,9,13,3,48,1,0,20,38,0.431373,0.568627,12,8
2023020807,2024-02-10,2,NYI,2,5,CGY,31,15,19,2,67,17,16,16,4,53,31,15,19,2,67,17,16,16,4,53,0,1,36,24,0.5,0.5,6,6
2023020808,2024-02-10,2,BOS,0,3,WSH,11,6,10,0,27,18,5,9,2,34,11,6,10,0,27,18,5,9,2,34,0,1,18,29,0.44186,0.55814,17,8
2023020809,2024-02-10,2,FLA,4,0,COL,34,24,24,2,84,32,11,13,0,56,34,24,24,2,84,32,11,13,0,56,1,0,41,34,0.618182,0.381818,2,4
2023020810,2024-02-10,2,CAR,1,0,NJD,25,11,23,1,60,26,9,11,0,46,23,11,22,0,56,22,9,10,0,41,0,0,32,34,0.545455,0.454545,10,6
2023020811,2024-02-10,2,CBJ,2,4,TBL,26,15,15,1,57,28,11,14,2,55,26,15,15,1,57,28,11,14,2,55,0,1,35,37,0.45283,0.54717,15,15
2023020812,2024-02-10,2,OTT,5,3,TOR,21,16,15,5,57,32,16,17,3,68,21,16,15,5,57,32,16,17,3,68,0,1,32,35,0.543478,0.456522,0,19
2023020813,2024-02-10,2,PHI,3,2,SEA,29,9,18,1,57,13,4,20,2,39,29,9,18,1,57,13,4,20,2,39,1,0,38,19,0.491803,0.508197,6,8
2023020814,2024-02-10,2,WPG,2,1,PIT,28,8,18,2,56,31,12,10,1,54,28,8,18,2,56,31,12,10,1,54,1,0,31,36,0.395349,0.604651,6,2
2023020815,2024-02-10,2,NSH,5,4,ARI,25,11,18,3,57,26,5,13,2,46,23,10,17,2,52,23,5,12,2,42,1,0,37,31,0.533333,0.466667,10,12
2023020816,2024-02-10,2,LAK,4,0,EDM,16,7,6,3,32,19,14,19,0,52,15,5,6,3,29,17,12,15,0,44,1,0,26,26,0.483333,0.516667,12,8
2023020817,2024-02-11,2,MTL,2,7,STL,27,7,12,2,48,22,5,6,4,37,27,7,12,1,47,22,5,6,4,37,0,1,32,36,0.54,0.46,29,38
2023020818,2024-02-11,2,WSH,2,3,VAN,28,18,18,2,66,19,10,21,3,53,25,14,18,2,59,17,10,19,2,48,1,0,33,29,0.411765,0.588235,6,4
2023020819,2024-02-12,2,NJD,3,1,SEA,21,9,8,2,40,21,13,16,1,51,21,9,8,2,40,21,13,16,1,51,1,0,37,28,0.6,0.4,6,10
2023020820,2024-02-12,2,NYR,2,0,CGY,28,14,21,2,65,22,12,14,0,48,23,13,20,2,58,20,11,14,0,45,1,0,31,29,0.590909,0.409091,10,12
2023020821,2024-02-12,2,PHI,5,3,ARI,22,10,12,5,49,17,13,10,3,43,19,8,12,3,42,14,12,10,3,39,0,1,34,23,0.585714,0.414286,8,14
2023020822,2024-02-12,2,VGK,3,5,MIN,17,7,10,2,36,17,13,15,4,49,17,7,10,2,36,17,13,15,4,49,1,0,30,29,0.423729,0.576271,6,10
2023020823,2024-02-13,2,BOS,2,3,TBL,29,16,20,2,67,16,13,10,2,41,22,14,20,2,58,14,11,10,1,36,0,1,38,25,0.509091,0.490909,6,12
2023020824,2024-02-13,2,BUF,7,0,LAK,16,12,9,6,43,26,18,25,0,69,16,12,9,6,43,26,18,25,0,69,1,0,24,33,0.387755,0.612245,6,4
2023020825,2024-02-13,2,MTL,5,0,ANA,20,11,13,3,47,11,14,14,0,39,20,11,13,3,47,11,14,14,0,39,1,0,38,13,0.509804,0.490196,33,29
2023020826,2024-02-13,2,OTT,6,3,CBJ,18,7,11,3,39,32,16,17,3,68,18,7,11,3,39,32,16,17,3,68,0,1,30,40,0.442623,0.557377,12,14
2023020827,2024-02-13,2,TOR,4,1,STL,22,17,12,4,55,13,10,14,1,38,22,17,12,4,55,13,10,14,1,38,1,0,32,15,0.591837,0.408163,4,4
2023020828,2024-02-13,2,WSH,3,6,COL,22,17,16,2,57,23,10,13,5,51,20,17,16,2,55,23,10,13,5,51,0,1,27,37,0.514706,0.485294,16,6
2023020829,2024-02-13,2,NYI,1,2,SEA,25,10,15,0,50,29,12,28,2,71,20,9,15,0,44,27,11,27,1,66,0,1,27,30,0.666667,0.333333,4,8
2023020830,2024-02-13,2,DAL,4,2,CAR,19,7,11,4,41,31,28,30,2,91,19,7,11,4,41,31,28,30,2,91,1,0,23,34,0.473684,0.526316,2,2
2023020831,2024-02-13,2,NSH,2,4,NJD,23,11,14,1,49,40,19,27,4,90,21,11,14,1,47,39,19,27,3,88,1,0,32,47,0.490566,0.509434,6,6
2023020832,2024-02-13,2,CHI,2,4,VAN,15,8,9,1,33,25,14,10,4,53,15,8,9,1,33,25,14,10,4,53,0,1,24,38,0.5,0.5,13,13
2023020833,2024-02-13,2,EDM,8,4,DET,28,9,13,8,58,28,14,13,2,57,28,9,13,8,58,28,14,13,2,57,1,0,36,38,0.606557,0.393443,6,0
2023020834,2024-02-14,2,PIT,2,5,FLA,19,12,15,2,48,14,10,15,4,43,16,11,15,2,44,14,10,14,4,42,0,1,27,23,0.519231,0.480769,6,10
2023020835,2024-02-14,2,WPG,1,0,SJS,36,19,23,1,79,16,9,14,0,39,36,19,23,1,79,16,9,14,0,39,1,0,39,17,0.615385,0.384615,2,4
2023020836,2024-02-14,2,ARI,1,3,MIN,21,17,18,1,57,26,11,11,2,50,21,17,18,1,57,26,11,11,2,50,0,1,26,43,0.5,0.5,10,6
2023020837,2024-02-15,2,BOS,1,4,SEA,33,14,15,1,63,19,11,13,3,46,33,14,15,1,63,19,11,13,3,46,1,0,37,26,0.478261,0.521739,4,4
2023020838,2024-02-15,2,BUF,0,4,FLA,34,10,8,0,52,22,12,12,3,49,34,10,8,0,52,22,12,12,3,49,0,1,45,30,0.561404,0.438596,6,14
2023020839,2024-02-15,2,NJD,1,2,LAK,17,12,11,0,40,22,13,19,0,54,16,11,11,0,38,21,12,17,0,50,0,1,27,29,0.431818,0.568182,10,12
2023020840,2024-02-15,2,NYR,7,4,MTL,22,7,8,5,42,25,6,17,3,51,22,7,8,5,42,25,6,17,3,51,0,1,31,36,0.617647,0.382353,10,8
2023020841,2024-02-15,2,OTT,1,5,ANA,23,15,12,1,51,13,10,9,3,35,21,14,11,1,47,13,8,9,3,33,0,1,34,20,0.457627,0.542373,8,12
2023020842,2024-02-15,2,TBL,6,3,COL,25,10,17,6,58,26,6,14,2,48,25,10,17,6,58,26,6,14,2,48,0,1,39,31,0.569444,0.430556,6,4
2023020843,2024-02-15,2,TOR,4,3,PHI,19,12,15,3,49,24,7,15,1,47,19,12,15,2,48,22,7,14,1,44,0,1,28,32,0.561404,0.438596,15,25
2023020844,2024-02-15,2,STL,6,3,EDM,12,13,11,4,40,28,9,15,2,54,11,13,11,4,39,28,9,15,2,54,1,0,30,38,0.580645,0.419355,11,21
2023020845,2024-02-15,2,CHI,1,4,PIT,21,6,7,1,35,23,10,13,3,49,21,6,7,1,35,23,10,13,3,49,0,1,28,27,0.361702,0.638298,2,4
2023020846,2024-02-15,2,CGY,3,6,SJS,24,20,16,3,63,24,8,17,5,54,21,15,16,3,55,22,8,17,5,52,1,0,34,31,0.532258,0.467742,10,12
2023020847,2024-02-15,2,NSH,2,9,DAL,24,11,15,2,52,30,10,10,7,57,24,11,15,2,52,30,10,10,7,57,0,1,29,41,0.557377,0.442623,16,4
2023020848,2024-02-15,2,VAN,4,1,DET,16,10,14,4,44,22,12,8,1,43,16,10,14,4,44,20,11,8,1,40,1,0,21,28,0.555556,0.444444,12,6
2023020849,2024-02-16,2,ARI,1,5,CAR,27,7,9,1,44,21,15,14,4,54,27,7,9,1,44,20,15,14,4,53,0,1,31,30,0.254237,0.745763,4,8
2023020850,2024-02-17,2,DAL,3,4,EDM,17,7,17,1,42,18,10,14,2,44,17,7,17,1,42,18,10,14,2,44,1,0,27,24,0.492537,0.507463,8,6
2023020851,2024-02-17,2,CHI,3,2,OTT,16,10,16,3,45,36,15,19,1,71,16,10,16,3,45,36,15,19,1,71,1,0,22,42,0.533333,0.466667,4,2
2023020852,2024-02-17,2,CGY,0,5,DET,27,16,25,0,68,14,7,20,3,44,26,15,24,0,65,10,7,17,3,37,0,1,38,21,0.402778,0.597222,16,16
2023020853,2024-02-17,2,BOS,4,5,LAK,24,9,11,3,47,26,12,14,4,56,23,9,10,3,45,25,12,14,3,54,1,0,32,35,0.642857,0.357143,11,15
2023020854,2024-02-17,2,MIN,2,3,BUF,24,11,9,1,45,20,9,6,3,38,23,10,9,1,43,18,8,6,2,34,0,1,32,28,0.5,0.5,6,8
2023020855,2024-02-17,2,STL,2,5,NSH,26,12,14,1,53,26,8,13,4,51,26,12,14,1,53,26,8,13,4,51,0,1,37,33,0.396226,0.603774,8,8
2023020856,2024-02-17,2,TBL,2,9,FLA,21,18,16,1,56,18,5,11,6,40,19,17,16,1,53,17,4,11,6,38,1,0,30,30,0.482143,0.517857,90,90
2023020857,2024-02-17,2,MTL,3,4,WSH,24,14,15,2,55,25,15,27,3,70,24,14,15,2,55,25,15,27,3,70,0,1,31,34,0.576271,0.423729,2,6
2023020858,2024-02-17,2,TOR,9,2,ANA,17,11,11,5,44,17,11,15,1,44,14,11,10,5,40,16,9,15,1,41,1,0,32,21,0.555556,0.444444,15,29
2023020859,2024-02-17,2,NJD,6,3,PHI,29,7,17,6,59,40,17,17,2,76,27,7,16,6,56,34,17,17,2,70,1,0,40,48,0.6,0.4,8,12
2023020860,2024-02-17,2,VAN,2,4,WPG,22,12,16,2,52,19,6,6,2,33,22,12,16,2,52,19,6,6,2,33,1,0,37,28,0.482143,0.517857,25,15
2023020861,2024-02-17,2,SJS,3,4,CBJ,26,12,16,2,56,33,19,13,4,69,26,11,15,2,54,32,18,13,4,67,1,0,31,41,0.52381,0.47619,6,8
2023020862,2024-02-17,2,VGK,1,3,CAR,27,12,14,1,54,25,13,23,2,63,27,12,14,1,54,25,13,23,2,63,1,0,30,28,0.525424,0.474576,0,4
2023020863,2024-02-18,2,NYI,5,6,NYR,33,13,12,3,61,21,10,16,3,50,33,13,12,2,60,20,10,16,2,48,0,1,41,38,0.681818,0.318182,17,11
2023020864,2024-02-18,2,COL,4,3,ARI,18,9,11,4,42,12,6,9,2,29,15,9,11,4,39,11,6,9,2,28,1,0,37,30,0.569231,0.430769,14,10
2023020865,2024-02-18,2,PIT,1,2,LAK,19,10,12,0,41,25,14,16,1,56,19,10,12,0,41,25,14,16,1,56,1,0,30,34,0.610169,0.389831,6,10
2023020866,2024-02-19,2,BUF,3,4,ANA,26,16,16,2,60,10,5,9,4,28,24,15,15,2,56,10,5,8,4,27,1,0,37,14,0.413043,0.586957,4,6
2023020867,2024-02-19,2,BOS,4,3,DAL,29,14,12,5,60,47,18,19,4,88,22,13,11,3,49,39,14,18,3,74,1,0,30,46,0.477612,0.522388,9,9
2023020868,2024-02-19,2,STL,2,4,TOR,14,13,26,1,54,22,9,8,2,41,14,13,26,1,54,22,9,8,2,41,0,1,21,29,0.47541,0.52459,4,4
2023020869,2024-02-19,2,MIN,10,7,VAN,11,12,18,6,47,13,16,25,6,60,11,12,18,6,47,13,16,25,6,60,0,1,27,24,0.481481,0.518519,8,14
2023020870,2024-02-19,2,SEA,3,4,DET,33,14,18,2,67,25,14,16,4,59,32,14,17,2,65,25,13,16,3,57,0,1,41,32,0.446429,0.553571,2,4
2023020871,2024-02-19,2,ARI,3,6,EDM,19,18,19,2,58,19,11,11,5,46,19,18,19,2,58,17,11,10,5,43,0,1,25,26,0.42,0.58,6,6
2023020872,2024-02-19,2,CGY,6,3,WPG,25,15,16,5,61,23,8,10,1,42,25,15,16,5,61,23,8,10,1,42,1,0,34,31,0.403846,0.596154,6,4
2023020873,2024-02-19,2,SJS,0,4,VGK,24,9,26,0,59,17,11,17,3,48,24,9,26,0,59,17,11,17,3,48,0,1,29,26,0.466667,0.533333,30,2
2023020874,2024-02-19,2,CAR,6,3,CHI,28,15,15,5,63,10,6,10,1,27,28,15,15,5,63,10,6,10,1,27,1,0,42,17,0.54717,0.45283,8,8
2023020875,2024-02-19,2,TBL,2,4,OTT,23,16,29,2,70,22,12,23,4,61,23,15,28,2,68,22,12,23,3,60,0,1,25,28,0.515152,0.484848,9,7
2023020876,2024-02-20,2,FLA,3,2,OTT,28,10,26,3,67,23,10,7,2,42,27,10,26,2,65,22,10,7,2,41,1,0,34,30,0.442623,0.557377,4,6
2023020877,2024-02-20,2,NYR,3,1,DAL,15,10,11,3,39,31,7,19,0,57,15,10,11,2,38,30,7,19,0,56,1,0,26,42,0.55,0.45,8,8
2023020878,2024-02-20,2,PIT,4,5,NYI,32,10,11,4,57,21,4,14,5,44,32,10,11,4,57,21,4,14,4,43,1,0,41,33,0.578125,0.421875,4,6
2023020879,2024-02-20,2,WSH,6,2,NJD,19,13,16,5,53,29,15,11,2,57,19,13,16,5,53,29,15,11,2,57,1,0,26,39,0.37931,0.62069,4,2
2023020880,2024-02-20,2,WPG,6,3,MIN,19,16,13,4,52,27,20,11,1,59,19,16,13,4,52,27,20,11,1,59,1,0,30,39,0.467742,0.532258,18,18
2023020881,2024-02-20,2,COL,3,1,VAN,15,8,11,3,37,21,6,15,1,43,15,8,11,3,37,21,6,15,1,43,0,1,27,25,0.375,0.625,4,6
2023020882,2024-02-20,2,VGK,3,5,NSH,15,5,7,2,29,29,15,17,5,66,14,5,7,2,28,28,15,17,5,65,0,1,26,40,0.448276,0.551724,8,8
2023020883,2024-02-20,2,LAK,5,1,CBJ,29,10,8,3,50,23,8,16,1,48,29,10,8,3,50,23,8,16,1,48,1,0,35,33,0.526316,0.473684,6,4
2023020884,2024-02-21,2,MTL,2,3,BUF,20,20,14,2,56,15,5,16,1,37,20,20,14,2,56,13,5,16,1,35,1,0,31,23,0.653061,0.346939,10,10
2023020885,2024-02-21,2,CHI,1,3,PHI,18,11,19,1,49,29,15,20,3,67,18,11,19,1,49,29,15,20,3,67,0,1,22,33,0.5,0.5,5,9
2023020886,2024-02-21,2,ANA,4,7,CBJ,24,8,10,4,46,18,8,10,6,42,24,8,10,2,44,18,8,10,6,42,0,1,31,27,0.531915,0.468085,13,17
2023020887,2024-02-21,2,ARI,3,6,TOR,16,17,17,2,52,21,9,11,4,45,16,16,17,2,51,18,6,9,3,36,0,1,26,36,0.483333,0.516667,14,10
2023020888,2024-02-21,2,EDM,5,6,BOS,30,22,21,5,78,27,14,8,5,54,30,22,21,5,78,25,13,8,4,50,0,1,42,36,0.478873,0.521127,9,11
2023020889,2024-02-22,2,CAR,1,0,FLA,26,10,17,1,54,33,8,10,0,51,26,10,17,1,54,33,8,10,0,51,1,0,29,45,0.391304,0.608696,6,6
2023020890,2024-02-22,2,DET,2,1,COL,23,12,9,1,45,26,16,18,1,61,22,12,9,0,43,24,16,18,1,59,0,1,30,31,0.530612,0.469388,6,8
2023020891,2024-02-22,2,NJD,1,5,NYR,27,14,22,1,64,10,6,6,4,26,27,14,22,1,64,10,6,6,3,25,0,1,40,18,0.576271,0.423729,17,20
2023020892,2024-02-22,2,OTT,4,1,DAL,21,16,7,3,47,13,11,24,1,49,21,16,7,3,47,13,11,24,1,49,1,0,30,15,0.611111,0.388889,4,10
2023020893,2024-02-22,2,PIT,4,1,MTL,22,16,11,3,52,27,17,16,1,61,22,15,11,3,51,27,16,15,1,59,0,1,27,31,0.518519,0.481481,8,6
2023020894,2024-02-22,2,TBL,3,5,WSH,25,10,11,3,49,15,8,10,5,38,25,10,11,3,49,15,8,10,5,38,0,1,32,24,0.438596,0.561404,8,6
2023020895,2024-02-22,2,STL,4,0,NYI,15,6,7,3,31,21,4,4,0,29,14,5,7,2,28,19,3,4,0,26,1,0,25,38,0.423077,0.576923,12,12
2023020896,2024-02-22,2,CGY,3,2,BOS,25,19,11,3,58,27,10,14,2,53,23,18,11,2,54,22,10,13,2,47,1,0,30,34,0.472727,0.527273,6,2
2023020897,2024-02-22,2,SEA,5,2,VAN,23,11,11,4,49,14,9,12,2,37,23,11,11,4,49,14,9,12,2,37,0,1,31,21,0.483333,0.516667,13,11
2023020898,2024-02-22,2,VGK,3,7,TOR,22,10,22,3,57,35,11,21,7,74,22,10,22,3,57,35,11,21,7,74,0,1,26,42,0.54902,0.45098,4,2
2023020899,2024-02-22,2,LAK,1,4,NSH,22,13,17,0,52,14,7,10,4,35,22,13,17,0,52,14,7,10,4,35,0,1,28,21,0.563636,0.436364,8,8
2023020900,2024-02-23,2,CBJ,1,2,BUF,20,12,12,0,44,28,10,10,2,50,18,12,11,0,41,27,9,10,2,48,1,0,26,37,0.469388,0.530612,10,6
2023020901,2024-02-23,2,CHI,2,3,WPG,31,10,20,2,63,23,10,10,3,46,30,10,20,2,62,23,9,10,2,44,0,1,35,31,0.5,0.5,6,6
2023020902,2024-02-23,2,EDM,2,4,MIN,37,20,17,0,74,12,17,18,4,51,37,20,17,0,74,12,17,18,4,51,0,1,43,20,0.678571,0.321429,8,4
2023020903,2024-02-24,2,NJD,4,3,MTL,14,10,17,3,44,23,14,11,3,51,14,10,17,3,44,23,14,11,3,51,0,1,24,26,0.603774,0.396226,0,4
2023020904,2024-02-24,2,NYI,2,4,TBL,24,7,10,1,42,14,15,19,3,51,24,7,10,1,42,14,15,19,3,51,0,1,34,21,0.490566,0.509434,6,10
2023020905,2024-02-24,2,PHI,1,2,NYR,35,19,18,1,73,19,8,16,2,45,33,19,18,1,71,16,6,14,1,37,0,1,40,24,0.633333,0.366667,15,13
2023020906,2024-02-24,2,FLA,3,2,WSH,22,7,21,2,52,18,19,9,0,46,19,6,19,1,45,15,16,9,0,40,1,0,29,24,0.578947,0.421053,15,13
2023020907,2024-02-24,2,CAR,1,2,DAL,17,20,24,1,62,12,5,12,2,31,17,20,24,1,62,12,5,12,2,31,0,1,21,16,0.388889,0.611111,8,4
2023020908,2024-02-24,2,COL,3,4,TOR,23,18,24,2,67,25,5,13,2,45,23,18,24,2,67,25,5,13,2,45,1,0,29,30,0.478261,0.521739,4,2
2023020909,2024-02-24,2,DET,6,1,STL,25,14,11,5,55,18,10,4,1,33,25,14,11,5,55,18,10,4,1,33,1,0,34,23,0.509434,0.490566,4,6
2023020910,2024-02-24,2,OTT,4,3,VGK,29,15,19,3,66,27,13,20,2,62,19,13,18,2,52,22,12,17,2,53,0,1,33,29,0.612245,0.387755,6,8
2023020911,2024-02-24,2,VAN,3,2,BOS,34,23,19,2,78,16,10,11,2,39,34,21,19,2,76,16,10,11,2,39,0,1,39,25,0.594203,0.405797,8,4
2023020912,2024-02-24,2,EDM,3,6,CGY,30,9,26,2,67,22,7,9,5,43,29,9,26,2,66,18,6,8,5,37,0,1,35,31,0.5,0.5,46,34
2023020913,2024-02-24,2,SEA,2,5,MIN,19,14,16,2,51,18,5,5,3,31,18,12,13,2,45,18,5,5,2,30,1,0,32,31,0.484375,0.515625,21,19
2023020914,2024-02-24,2,SJS,2,4,NSH,18,7,14,2,41,26,15,17,3,61,18,7,14,2,41,26,15,17,3,61,0,1,25,35,0.465517,0.534483,6,4
2023020915,2024-02-24,2,LAK,3,2,ANA,46,22,12,2,82,21,19,17,1,58,43,20,12,0,75,19,18,17,0,54,0,1,50,24,0.678571,0.321429,6,10
2023020916,2024-02-25,2,NJD,1,4,TBL,17,11,21,0,49,20,14,8,4,46,17,11,20,0,48,20,14,8,4,46,0,1,19,27,0.571429,0.428571,6,8
2023020917,2024-02-25,2,PIT,7,6,PHI,22,13,21,5,61,13,15,14,4,46,21,13,21,5,60,13,14,14,4,45,0,1,32,21,0.47619,0.52381,10,8
2023020918,2024-02-25,2,BUF,3,2,CAR,28,21,27,2,78,28,22,20,1,71,24,20,27,1,72,24,20,20,1,65,0,1,32,32,0.37037,0.62963,4,4
2023020919,2024-02-25,2,CBJ,4,2,NYR,34,16,13,3,66,29,16,23,2,70,34,16,13,3,66,29,16,23,2,70,1,0,41,40,0.441176,0.558824,9,11
2023020920,2024-02-25,2,CHI,2,3,DET,32,12,13,1,58,28,12,24,3,67,29,11,13,1,54,27,12,22,2,63,0,1,36,31,0.428571,0.571429,0,2
2023020921,2024-02-25,2,WPG,4,3,ARI,28,8,15,2,53,27,13,13,2,55,28,8,15,1,52,26,13,13,2,54,1,0,32,32,0.537037,0.462963,9,11
2023020922,2024-02-25,2,ANA,2,4,NSH,23,11,19,2,55,16,12,18,4,50,23,11,19,2,55,16,12,18,4,50,0,1,31,29,0.462963,0.537037,13,11
2023020923,2024-02-26,2,WSH,6,3,OTT,12,14,10,4,40,16,7,26,3,52,12,14,10,4,40,16,7,26,3,52,1,0,20,21,0.490566,0.509434,2,6
2023020924,2024-02-26,2,DAL,2,3,NYI,26,12,25,1,64,23,11,16,3,53,25,11,25,1,62,23,11,15,2,51,0,1,32,28,0.517241,0.482759,6,2
2023020925,2024-02-26,2,EDM,4,2,LAK,25,10,15,3,53,32,12,9,2,55,25,10,15,3,53,32,12,9,2,55,0,1,31,40,0.517241,0.482759,4,6
2023020926,2024-02-26,2,SEA,4,3,BOS,23,12,20,3,58,29,12,15,2,58,20,10,19,2,51,25,11,15,2,53,0,1,27,32,0.396552,0.603448,2,10
2023020927,2024-02-27,2,DET,8,3,WSH,18,10,11,6,45,15,19,21,2,57,18,10,11,6,45,15,19,21,2,57,1,0,31,21,0.645833,0.354167,4,6
2023020928,2024-02-27,2,FLA,3,2,BUF,26,8,12,1,47,22,17,11,1,51,25,8,12,1,46,21,16,11,1,49,0,1,37,30,0.605634,0.394366,12,14
2023020929,2024-02-27,2,MTL,4,2,ARI,15,8,13,4,40,29,14,24,2,69,15,8,13,4,40,29,14,24,2,69,1,0,21,38,0.574468,0.425532,6,0
2023020930,2024-02-27,2,PHI,6,2,TBL,24,8,10,6,48,16,11,24,2,53,24,8,10,5,47,15,11,24,1,51,1,0,31,22,0.462687,0.537313,4,6
2023020931,2024-02-27,2,TOR,2,6,VGK,24,15,24,2,65,19,11,13,6,49,24,15,24,2,65,19,11,13,6,49,0,1,30,32,0.535714,0.464286,8,2
2023020932,2024-02-27,2,MIN,2,3,CAR,22,10,9,2,43,17,7,23,3,50,21,9,8,2,40,16,7,23,3,49,1,0,30,28,0.355932,0.644068,6,8
2023020933,2024-02-27,2,NSH,4,1,OTT,28,14,22,3,67,23,5,13,0,41,28,14,22,3,67,23,5,13,0,41,1,0,36,25,0.5625,0.4375,9,11
2023020934,2024-02-27,2,WPG,4,2,STL,27,10,15,4,56,30,16,14,2,62,27,10,14,4,55,30,15,14,2,61,1,0,32,38,0.366667,0.633333,13,11
2023020935,2024-02-27,2,CGY,4,2,LAK,29,12,20,4,65,18,5,12,2,37,29,12,20,4,65,18,5,12,2,37,0,1,37,23,0.509434,0.490566,6,6
2023020936,2024-02-27,2,COL,5,1,DAL,18,8,11,4,41,27,12,11,1,51,18,8,11,4,41,27,12,11,1,51,0,1,27,34,0.490196,0.509804,4,4
2023020937,2024-02-27,2,VAN,3,2,PIT,21,9,7,1,38,15,4,4,1,24,21,9,7,1,38,15,4,4,1,24,1,0,35,40,0.5,0.5,10,8
2023020938,2024-02-27,2,SJS,1,2,NJD,18,6,8,1,33,14,5,5,2,26,18,6,8,1,33,14,5,5,2,26,1,0,31,44,0.45283,0.54717,4,2
2023020939,2024-02-28,2,NYR,4,1,CBJ,25,12,19,3,59,29,10,25,1,65,25,12,18,3,58,27,10,25,0,62,1,0,30,31,0.545455,0.454545,9,11
2023020940,2024-02-28,2,EDM,3,2,STL,31,13,25,2,71,30,10,8,1,49,29,13,24,1,67,26,10,6,1,43,0,1,36,34,0.525424,0.474576,6,4
2023020941,2024-02-29,2,BOS,5,4,VGK,21,10,18,4,53,29,15,15,3,62,21,10,18,4,53,29,15,15,3,62,1,0,32,36,0.454545,0.545455,4,4
2023020942,2024-02-29,2,CBJ,2,4,CAR,18,12,12,1,43,26,14,24,4,68,18,12,12,1,43,25,13,23,4,65,0,1,22,33,0.392857,0.607143,4,6
2023020943,2024-02-29,2,DET,3,5,NYI,18,16,19,3,56,17,10,10,4,41,18,16,19,3,56,17,9,10,4,40,0,1,25,27,0.444444,0.555556,6,4
2023020944,2024-02-29,2,FLA,4,3,MTL,25,17,16,3,61,17,14,9,3,43,22,15,16,1,54,14,12,8,2,36,1,0,35,31,0.5625,0.4375,10,12
2023020945,2024-02-29,2,TBL,2,3,BUF,21,10,9,1,41,16,7,20,1,44,21,10,9,1,41,15,7,20,1,43,1,0,23,23,0.574468,0.425532,6,6
2023020946,2024-02-29,2,TOR,4,2,ARI,20,14,17,4,55,29,15,27,1,72,20,14,17,4,55,29,15,27,1,72,1,0,26,32,0.5,0.5,5,17
2023020947,2024-02-29,2,DAL,4,1,WPG,24,19,17,4,64,24,12,11,0,47,24,19,17,4,64,24,12,11,0,47,1,0,36,26,0.587302,0.412698,2,4
2023020948,2024-02-29,2,NSH,6,1,MIN,21,10,10,5,46,29,7,8,1,45,21,8,10,5,44,27,7,8,1,43,0,1,31,34,0.473684,0.526316,15,13
2023020949,2024-02-29,2,CHI,0,5,COL,24,4,10,0,38,26,16,18,4,64,24,4,10,0,38,26,16,18,4,64,0,1,24,33,0.574468,0.425532,7,7
2023020950,2024-02-29,2,SEA,2,0,PIT,21,5,10,1,37,26,7,22,0,55,21,5,10,1,37,26,7,22,0,55,1,0,28,33,0.509434,0.490566,6,8
2023020951,2024-02-29,2,VAN,1,5,LAK,19,14,21,0,54,14,7,8,4,33,18,14,21,0,53,13,7,8,4,32,0,1,24,20,0.471698,0.528302,6,8
2023020952,2024-02-29,2,SJS,4,6,ANA,19,12,14,1,46,18,13,12,3,46,18,12,14,1,45,18,13,12,3,46,1,0,28,30,0.535211,0.464789,12,14
2023020953,2024-03-01,2,OTT,3,5,ARI,29,11,12,2,54,21,13,14,3,51,29,11,12,2,54,20,11,14,3,48,0,1,37,30,0.523077,0.476923,12,10
2023020954,2024-03-01,2,WSH,5,2,PHI,13,7,11,4,35,16,16,19,1,52,13,7,11,4,35,16,16,19,1,52,0,1,21,23,0.47541,0.52459,10,10
2023020955,2024-03-01,2,ANA,4,3,NJD,16,6,9,4,35,46,13,19,1,79,16,6,9,4,35,46,13,19,1,79,1,0,23,55,0.464789,0.535211,13,19
2023020956,2024-03-02,2,CAR,3,5,WPG,26,16,10,2,54,18,7,8,4,37,26,16,10,2,54,18,7,8,4,37,1,0,35,32,0.590909,0.409091,10,8
2023020957,2024-03-02,2,NYI,5,1,BOS,19,6,10,4,39,19,8,10,1,38,17,6,10,4,37,18,8,9,1,36,1,0,26,23,0.615385,0.384615,6,8
2023020958,2024-03-02,2,SEA,1,2,EDM,19,11,21,0,51,19,13,12,2,46,19,11,21,0,51,19,13,12,2,46,0,1,25,24,0.56,0.44,4,6
2023020959,2024-03-02,2,NSH,5,1,COL,27,18,20,3,68,23,7,12,1,43,27,16,20,3,66,23,7,12,1,43,1,0,35,26,0.531915,0.468085,4,8
2023020960,2024-03-02,2,BUF,7,2,VGK,28,19,28,4,79,21,9,10,1,41,28,19,28,4,79,21,9,10,1,41,1,0,35,24,0.459016,0.540984,9,7
2023020961,2024-03-02,2,DET,0,4,FLA,15,10,10,0,35,23,12,20,2,57,15,9,9,0,33,16,9,19,2,46,0,1,21,37,0.480769,0.519231,40,30
2023020962,2024-03-02,2,PHI,4,2,OTT,27,8,10,4,49,16,11,21,2,50,26,8,10,3,47,16,11,19,2,48,1,0,40,26,0.425926,0.574074,12,10
2023020963,2024-03-02,2,TBL,4,3,MTL,26,15,13,4,58,29,10,16,4,59,22,14,12,2,50,24,8,16,3,51,0,1,29,31,0.508772,0.491228,9,9
2023020964,2024-03-02,2,TOR,4,3,NYR,31,19,11,5,66,27,18,10,4,59,29,18,8,3,58,19,16,9,3,47,0,1,34,35,0.581081,0.418919,11,13
2023020965,2024-03-02,2,CHI,2,5,CBJ,23,8,15,2,48,21,11,19,5,56,23,8,15,2,48,20,11,19,5,55,0,1,28,31,0.530612,0.469388,4,6
2023020966,2024-03-02,2,DAL,3,2,SJS,31,17,20,3,71,24,17,14,3,58,24,16,17,1,58,18,15,13,2,48,0,1,38,23,0.671875,0.328125,6,10
2023020967,2024-03-02,2,STL,3,1,MIN,15,5,7,2,29,18,19,21,1,59,15,5,7,2,29,18,19,21,1,59,1,0,27,22,0.428571,0.571429,4,14
2023020968,2024-03-02,2,CGY,4,3,PIT,14,15,19,3,51,22,12,11,2,47,13,15,19,3,50,22,11,10,2,45,0,1,20,30,0.385965,0.614035,10,10
2023020969,2024-03-03,2,WSH,2,5,ARI,12,8,10,0,30,16,12,23,3,54,12,8,10,0,30,14,12,23,3,52,0,1,26,28,0.457627,0.542373,22,14
2023020970,2024-03-03,2,LAK,5,1,NJD,15,13,11,4,43,25,13,17,1,56,15,13,11,4,43,25,13,17,1,56,0,1,23,31,0.52381,0.47619,4,6
2023020971,2024-03-03,2,BUF,2,5,WPG,15,8,20,1,44,26,8,23,5,62,15,8,20,1,44,26,8,23,5,62,1,0,19,35,0.491803,0.508197,4,4
2023020972,2024-03-03,2,MIN,4,3,SJS,24,12,16,3,55,9,9,12,1,31,24,12,16,3,55,9,9,12,1,31,0,1,32,15,0.557692,0.442308,4,8
2023020973,2024-03-03,2,ANA,1,2,VAN,15,13,15,1,44,27,7,19,2,55,15,13,15,1,44,27,7,19,2,55,0,1,18,31,0.372093,0.627907,4,2
2023020974,2024-03-03,2,EDM,6,1,PIT,27,8,17,6,58,19,14,8,1,42,27,8,17,6,58,19,13,8,1,41,1,0,37,23,0.574074,0.425926,4,6
2023020975,2024-03-04,2,CBJ,6,3,VGK,21,8,15,6,50,36,11,15,3,65,21,8,15,6,50,36,11,15,3,65,1,0,33,39,0.451613,0.548387,2,4
2023020976,2024-03-04,2,NYR,2,4,FLA,16,9,14,0,39,22,9,12,3,46,16,9,14,0,39,22,9,12,3,46,1,0,28,30,0.457627,0.542373,6,8
2023020977,2024-03-04,2,PHI,1,2,STL,34,13,18,2,67,21,8,26,3,58,27,11,18,1,57,18,8,24,1,51,1,0,42,25,0.509091,0.490909,6,4
2023020978,2024-03-04,2,TOR,1,4,BOS,22,12,10,1,45,14,5,10,3,32,22,12,10,1,45,14,5,10,3,32,0,1,33,27,0.530612,0.469388,4,8
2023020979,2024-03-04,2,COL,5,0,CHI,29,6,12,4,51,25,8,14,0,47,29,6,12,4,51,25,8,14,0,47,1,0,37,37,0.522388,0.477612,8,4
2023020980,2024-03-04,2,CGY,2,4,SEA,24,13,20,1,58,22,4,20,3,49,22,12,18,1,53,22,4,18,3,47,0,1,37,30,0.527778,0.472222,32,23
2023020981,2024-03-05,2,BOS,1,2,EDM,23,6,7,1,37,17,14,28,2,61,23,6,7,1,37,17,12,28,1,58,1,0,25,26,0.425532,0.574468,4,4
2023020982,2024-03-05,2,NJD,3,5,FLA,18,12,17,2,49,24,9,14,4,51,17,12,16,2,47,24,9,14,4,51,0,1,24,31,0.521739,0.478261,4,6
2023020983,2024-03-05,2,PIT,5,3,CBJ,21,8,24,3,56,32,18,21,2,73,21,8,24,3,56,32,18,21,2,73,1,0,31,35,0.567164,0.432836,2,6
2023020984,2024-03-05,2,NYI,4,2,STL,29,16,19,4,68,18,4,13,2,37,29,16,19,4,68,18,4,13,2,37,0,1,33,21,0.682927,0.317073,2,0
2023020985,2024-03-05,2,NSH,3,4,MTL,18,10,14,3,45,23,8,17,4,52,18,10,14,3,45,23,8,17,3,51,1,0,28,30,0.538462,0.461538,9,9
2023020986,2024-03-05,2,WPG,3,4,SEA,29,15,16,3,63,20,9,11,2,42,29,15,16,3,63,20,9,11,2,42,0,1,33,24,0.553191,0.446809,2,4
2023020987,2024-03-05,2,ARI,2,5,CHI,32,8,14,2,56,20,9,15,1,45,32,8,14,2,56,20,9,16,1,46,0,1,39,32,0.491803,0.508197,10,4
2023020988,2024-03-05,2,LAK,1,2,VAN,21,9,12,1,43,25,12,19,2,58,21,9,12,1,43,25,12,19,1,57,1,0,24,31,0.355932,0.644068,4,2
2023020989,2024-03-05,2,SJS,6,7,DAL,12,8,13,4,37,32,18,18,5,73,11,8,12,4,35,31,16,16,4,67,1,0,20,40,0.486486,0.513514,6,8
2023020990,2024-03-06,2,TOR,2,1,BUF,24,9,8,2,43,19,13,17,1,50,23,7,8,1,39,16,11,16,1,44,1,0,27,25,0.607843,0.392157,4,2
2023020991,2024-03-06,2,COL,7,2,DET,35,12,22,5,74,24,4,11,1,40,34,12,22,5,73,24,3,11,1,39,0,1,54,29,0.528571,0.471429,10,18
2023020992,2024-03-06,2,ANA,2,1,OTT,11,10,13,2,36,25,15,17,1,58,11,10,11,2,34,23,13,16,1,53,0,1,16,30,0.4,0.6,8,10
2023020993,2024-03-07,2,BOS,4,1,TOR,16,13,7,2,38,21,14,15,0,50,16,13,7,2,38,21,14,15,0,50,1,0,25,29,0.396552,0.603448,24,26
2023020994,2024-03-07,2,CAR,4,1,MTL,30,21,20,4,75,20,8,5,1,34,30,21,19,3,73,19,8,5,1,33,0,1,39,25,0.6,0.4,12,10
2023020995,2024-03-07,2,CBJ,4,2,EDM,29,10,17,4,60,26,11,10,1,48,29,10,17,4,60,26,11,10,1,48,1,0,34,31,0.45283,0.54717,13,9
2023020996,2024-03-07,2,FLA,1,2,PHI,26,7,27,1,61,23,14,18,2,57,24,6,27,1,58,23,14,17,2,56,0,1,30,26,0.54717,0.45283,4,4
2023020997,2024-03-07,2,NJD,4,1,STL,28,10,14,3,55,16,14,11,1,42,28,10,14,3,55,16,14,11,1,42,1,0,33,24,0.47541,0.52459,6,4
2023020998,2024-03-07,2,PIT,0,6,WSH,24,6,15,0,45,18,11,9,4,42,24,6,15,0,45,18,11,9,4,42,0,1,39,29,0.483871,0.516129,15,13
2023020999,2024-03-07,2,TBL,3,6,CGY,15,10,20,3,48,15,7,8,6,36,14,10,19,3,46,15,7,7,6,35,0,1,22,24,0.698113,0.301887,10,10
2023021000,2024-03-07,2,NSH,4,2,BUF,20,21,12,2,55,21,1,15,2,39,20,21,12,2,55,21,1,15,2,39,1,0,24,28,0.542373,0.457627,6,6
2023021001,2024-03-07,2,ARI,0,1,MIN,14,6,14,0,34,15,10,13,0,38,14,6,14,0,34,15,10,13,0,38,0,1,25,28,0.481481,0.518519,34,26
2023021002,2024-03-07,2,VGK,0,2,VAN,4,2,4,0,10,6,1,3,1,11,4,2,4,0,10,6,1,3,1,11,0,1,28,35,0.491803,0.508197,8,4
2023021003,2024-03-07,2,LAK,0,0,OTT,0,0,0,0,0,1,0,1,0,2,0,0,0,0,0,1,0,1,0,2,0,1,35,31,0.5,0.5,10,2
2023021004,2024-03-07,2,SJS,0,1,NYI,3,1,2,0,6,1,0,1,1,3,3,1,2,0,6,1,0,1,1,3,0,1,25,33,0.453125,0.546875,6,4
2023021005,2024-03-08,2,ARI,4,0,DET,18,13,12,3,46,26,16,13,0,55,18,13,12,3,46,26,16,13,0,55,1,0,24,28,0.520833,0.479167,2,4
2023021006,2024-03-08,2,COL,2,1,MIN,27,11,22,1,61,23,24,9,1,57,26,11,22,1,60,23,23,9,1,56,1,0,40,30,0.5,0.5,8,8
2023021007,2024-03-08,2,ANA,2,6,DAL,18,8,15,1,42,22,11,12,3,48,18,8,15,1,42,22,11,12,3,48,0,1,27,36,0.483333,0.516667,10,8
2023021008,2024-03-08,2,SEA,0,3,WPG,16,16,19,0,51,29,14,6,3,52,16,16,19,0,51,29,14,6,3,52,0,1,17,32,0.5,0.5,0,2
2023021009,2024-03-09,2,BUF,3,2,EDM,24,14,11,3,52,27,13,7,2,49,19,13,11,1,44,24,13,7,1,45,0,1,27,32,0.204082,0.795918,6,2
2023021010,2024-03-09,2,CBJ,1,2,NSH,28,9,14,1,52,41,6,9,2,58,28,9,14,1,52,41,6,9,2,58,0,1,34,49,0.402985,0.597015,6,4
2023021011,2024-03-09,2,NJD,2,4,CAR,19,14,11,2,46,20,18,9,3,50,18,14,11,2,45,20,18,9,3,50,0,1,25,26,0.474576,0.525424,10,12
2023021012,2024-03-09,2,BOS,5,1,PIT,16,14,8,4,42,33,8,20,1,62,16,14,8,4,42,33,8,20,1,62,1,0,23,39,0.552239,0.447761,2,4
2023021013,2024-03-09,2,FLA,5,1,CGY,23,18,19,4,64,29,16,9,0,54,20,17,17,3,57,27,16,8,0,51,1,0,31,35,0.627451,0.372549,12,6
2023021014,2024-03-09,2,MTL,2,3,TOR,27,6,12,1,46,24,6,15,3,48,26,6,12,1,45,21,6,15,3,45,1,0,31,27,0.528302,0.471698,6,10
2023021015,2024-03-09,2,SJS,2,1,OTT,16,16,15,0,47,24,19,16,0,59,16,16,15,0,47,24,19,16,0,59,1,0,21,32,0.385965,0.614035,6,8
2023021016,2024-03-09,2,TBL,7,0,PHI,10,11,15,4,40,20,13,16,0,49,10,11,15,4,40,20,13,16,0,49,1,0,26,25,0.436364,0.563636,21,43
2023021017,2024-03-09,2,WSH,4,1,CHI,15,6,7,3,31,20,13,12,1,46,15,6,7,3,31,20,13,12,1,46,1,0,26,32,0.44,0.56,8,8
2023021018,2024-03-09,2,NYR,4,0,STL,24,20,15,1,60,21,9,10,0,40,22,19,15,1,57,21,9,9,0,39,1,0,39,26,0.520833,0.479167,4,12
2023021019,2024-03-09,2,VAN,5,0,WPG,30,12,8,4,54,21,9,8,0,38,30,12,8,4,54,21,9,8,0,38,1,0,37,22,0.561404,0.438596,2,4
2023021020,2024-03-09,2,VGK,5,3,DET,22,15,24,5,66,18,8,15,2,43,22,15,24,5,66,18,8,15,2,43,1,0,36,26,0.375,0.625,8,6
2023021021,2024-03-09,2,LAK,1,4,DAL,19,17,7,1,44,24,10,13,3,50,18,16,7,1,42,23,10,13,3,49,1,0,25,35,0.55,0.45,12,10
2023021022,2024-03-10,2,PIT,0,4,EDM,34,11,15,0,60,28,11,13,4,56,33,11,15,0,59,26,8,12,4,50,0,1,41,42,0.571429,0.428571,25,17
2023021023,2024-03-10,2,MIN,4,3,NSH,26,5,12,3,46,23,14,20,2,59,26,5,12,2,45,22,13,19,2,56,1,0,33,30,0.454545,0.545455,14,14
2023021024,2024-03-10,2,CAR,7,2,CGY,27,20,21,7,75,12,12,11,2,37,27,20,21,7,75,12,12,11,2,37,1,0,40,20,0.533333,0.466667,11,7
2023021025,2024-03-10,2,CHI,7,4,ARI,25,16,13,5,59,27,9,9,4,49,25,16,13,5,59,27,9,9,3,48,0,1,41,36,0.568966,0.431034,9,15
2023021026,2024-03-10,2,ANA,1,6,NYI,18,9,12,1,40,11,10,10,5,36,16,9,12,1,38,10,10,9,5,34,0,1,23,19,0.44898,0.55102,12,6
2023021027,2024-03-11,2,BOS,1,5,STL,32,13,10,1,56,14,8,7,4,33,32,13,10,1,56,14,8,7,4,33,0,1,37,22,0.413043,0.586957,6,6
2023021028,2024-03-11,2,NYR,3,1,NJD,16,12,11,3,42,15,13,10,1,39,16,12,11,3,42,14,13,9,1,37,1,0,26,20,0.682927,0.317073,21,18
2023021029,2024-03-11,2,WPG,3,0,WSH,25,22,17,3,67,21,8,14,0,43,25,22,17,3,67,21,8,14,0,43,1,0,29,23,0.636364,0.363636,4,4
2023021030,2024-03-11,2,LAK,3,0,NYI,18,12,12,3,45,21,6,13,0,40,18,11,11,3,43,20,6,13,0,39,1,0,25,26,0.384615,0.615385,10,6
2023021031,2024-03-12,2,BUF,7,3,DET,24,7,13,7,51,18,14,8,2,42,24,7,13,7,51,18,14,8,2,42,1,0,39,24,0.438596,0.561404,8,8
2023021032,2024-03-12,2,CAR,0,1,NYR,26,15,22,0,63,20,17,13,1,51,26,15,22,0,63,20,17,13,1,51,0,1,28,24,0.519231,0.480769,4,2
2023021033,2024-03-12,2,MTL,3,0,CBJ,19,13,6,2,40,29,16,30,0,75,17,13,6,2,38,27,15,29,0,71,1,0,23,41,0.468085,0.531915,10,8
2023021034,2024-03-12,2,OTT,2,1,PIT,36,9,13,2,60,33,13,13,1,60,30,8,12,1,51,32,12,13,1,58,1,0,39,35,0.541667,0.458333,9,11
2023021035,2024-03-12,2,PHI,3,2,SJS,24,12,6,2,44,17,11,10,0,38,22,12,6,2,42,16,11,10,0,37,1,0,41,29,0.666667,0.333333,12,10
2023021036,2024-03-12,2,DAL,3,4,FLA,20,11,9,2,42,22,9,9,1,41,20,11,9,2,42,22,9,9,1,41,1,0,30,30,0.548387,0.451613,8,10
2023021037,2024-03-12,2,MIN,4,1,ARI,22,19,10,3,54,19,9,12,1,41,22,19,10,3,54,19,9,12,1,41,1,0,31,23,0.622951,0.377049,4,8
2023021038,2024-03-12,2,CHI,7,2,ANA,13,9,21,3,46,23,9,12,1,45,13,9,21,3,46,21,8,12,1,42,0,1,31,29,0.653846,0.346154,45,43
2023021039,2024-03-12,2,CGY,2,6,COL,21,10,16,2,49,27,9,17,5,58,21,10,16,2,49,27,9,17,5,58,0,1,27,38,0.367647,0.632353,8,6
2023021040,2024-03-12,2,SEA,4,5,VGK,23,10,22,4,59,23,14,23,4,64,21,9,22,4,56,21,12,22,3,58,1,0,30,34,0.454545,0.545455,6,4
2023021041,2024-03-13,2,STL,3,1,LAK,25,12,8,3,48,37,13,18,1,69,21,12,8,3,44,36,13,18,1,68,1,0,30,41,0.467742,0.532258,4,4
2023021042,2024-03-13,2,WPG,2,4,NSH,20,10,7,1,38,31,10,11,4,56,20,10,7,1,38,31,10,11,4,56,0,1,29,38,0.521739,0.478261,6,6
2023021043,2024-03-13,2,EDM,7,2,WSH,25,4,12,4,45,19,9,10,1,39,25,4,12,4,45,19,9,10,1,39,1,0,37,25,0.581818,0.418182,8,8
2023021044,2024-03-13,2,VAN,3,4,COL,15,5,3,3,26,27,15,21,2,65,14,5,3,3,25,27,15,20,2,64,1,0,21,34,0.571429,0.428571,13,11
2023021045,2024-03-14,2,BUF,4,0,NYI,26,7,10,3,46,15,9,9,0,33,26,7,10,3,46,15,9,9,0,33,1,0,37,21,0.545455,0.454545,13,13
2023021046,2024-03-14,2,CAR,4,0,FLA,22,17,13,4,56,18,1,10,0,29,22,17,13,4,56,18,1,10,0,29,1,0,35,21,0.566038,0.433962,14,18
2023021047,2024-03-14,2,CBJ,2,3,OTT,29,18,21,2,70,28,13,26,4,71,27,18,21,1,67,27,13,26,2,68,1,0,37,37,0.596491,0.403509,6,6
2023021048,2024-03-14,2,DET,1,4,ARI,22,7,16,0,45,21,13,19,3,56,22,7,16,0,45,21,13,19,3,56,0,1,29,27,0.619048,0.380952,6,10
2023021049,2024-03-14,2,MTL,1,2,BOS,15,9,17,1,42,14,15,16,2,47,15,9,17,1,42,13,15,15,1,44,0,1,19,24,0.5,0.5,8,6
2023021050,2024-03-14,2,PHI,2,6,TOR,22,15,8,0,45,16,11,13,6,46,22,15,8,0,45,16,11,13,6,46,0,1,28,27,0.442857,0.557143,18,16
2023021051,2024-03-14,2,PIT,6,3,SJS,23,9,20,6,58,28,21,19,3,71,22,9,15,6,52,28,21,19,3,71,1,0,31,32,0.571429,0.428571,6,6
2023021052,2024-03-14,2,TBL,6,3,NYR,21,6,21,5,53,23,11,14,3,51,21,6,19,4,50,21,11,13,3,48,0,1,28,28,0.517857,0.482143,6,6
2023021053,2024-03-14,2,DAL,2,6,NJD,29,16,24,2,71,13,7,7,6,33,29,16,24,2,71,13,7,7,6,33,1,0,37,20,0.571429,0.428571,0,6
2023021054,2024-03-14,2,MIN,2,0,ANA,24,6,12,2,44,16,11,16,0,43,24,6,12,2,44,16,11,16,0,43,1,0,31,16,0.545455,0.454545,2,4
2023021055,2024-03-14,2,CGY,4,1,VGK,28,13,20,4,65,20,7,24,1,52,28,13,20,4,65,20,7,24,1,52,0,1,37,29,0.492754,0.507246,6,4
2023021056,2024-03-14,2,SEA,1,2,WSH,18,7,17,0,42,19,13,13,1,46,18,7,17,0,42,19,13,13,1,46,0,1,24,23,0.56,0.44,8,6
2023021057,2024-03-15,2,WPG,6,0,ANA,29,17,14,3,63,16,9,10,0,35,29,17,14,2,62,16,9,10,0,35,1,0,38,21,0.74,0.26,20,20
2023021058,2024-03-15,2,CHI,0,5,LAK,16,6,16,0,38,26,13,12,4,55,16,6,16,0,38,26,13,12,4,55,0,1,28,37,0.474576,0.525424,6,8
2023021059,2024-03-16,2,DET,4,1,BUF,20,11,9,4,44,24,12,14,0,50,20,11,9,4,44,24,12,14,0,50,0,1,26,26,0.537037,0.462963,4,4
2023021060,2024-03-16,2,NYI,3,4,OTT,26,6,22,2,56,21,12,13,2,48,24,6,22,2,54,19,12,13,2,46,1,0,33,30,0.459016,0.540984,6,6
2023021061,2024-03-16,2,PIT,4,7,NYR,27,16,16,3,62,17,12,8,5,42,27,16,16,3,62,17,12,8,5,42,1,0,37,28,0.576923,0.423077,6,6
2023021062,2024-03-16,2,ARI,4,1,NJD,23,8,13,3,47,37,12,21,1,71,23,8,13,3,47,37,12,21,1,71,1,0,32,38,0.428571,0.571429,9,9
2023021063,2024-03-16,2,FLA,3,5,TBL,27,8,13,1,49,9,8,5,4,26,27,8,12,1,48,9,7,4,4,24,0,1,50,16,0.457143,0.542857,29,28
2023021064,2024-03-16,2,BOS,6,5,PHI,18,12,17,5,52,21,4,16,5,46,18,11,16,4,49,21,4,16,5,46,0,1,30,29,0.5,0.5,10,8
2023021065,2024-03-16,2,CBJ,4,2,SJS,14,9,16,4,43,33,9,20,2,64,14,9,16,4,43,33,9,20,2,64,1,0,20,41,0.548387,0.451613,6,4
2023021066,2024-03-16,2,CGY,5,2,MTL,20,3,18,3,44,33,13,22,2,70,20,3,18,3,44,33,13,22,2,70,1,0,28,38,0.333333,0.666667,8,8
2023021067,2024-03-16,2,TOR,4,5,CAR,25,9,8,4,46,31,18,12,3,64,19,6,7,4,36,28,16,12,2,58,1,0,40,40,0.515625,0.484375,10,8
2023021068,2024-03-16,2,DAL,4,1,LAK,25,6,13,3,47,27,9,17,1,54,25,6,13,3,47,27,9,17,1,54,1,0,29,28,0.484375,0.515625,2,4
2023021069,2024-03-16,2,STL,3,2,MIN,35,16,17,3,71,22,9,32,3,66,33,12,17,1,63,19,7,29,2,57,1,0,37,24,0.631579,0.368421,9,13
2023021070,2024-03-16,2,EDM,2,3,COL,30,10,18,2,60,40,15,25,3,83,26,10,17,2,55,37,14,25,2,78,0,1,34,43,0.633333,0.366667,7,7
2023021071,2024-03-16,2,SEA,1,4,NSH,20,16,17,0,53,23,14,12,3,52,20,16,17,0,53,23,14,12,3,52,0,1,24,30,0.471698,0.528302,6,4
2023021072,2024-03-16,2,VAN,1,2,WSH,18,18,27,1,64,21,10,10,2,43,18,18,27,1,64,21,10,10,2,43,1,0,22,24,0.653061,0.346939,2,2
2023021073,2024-03-17,2,NYR,5,2,NYI,25,17,22,5,69,23,14,13,1,51,24,17,22,5,68,22,14,13,1,50,0,1,31,27,0.56,0.44,6,2
2023021074,2024-03-17,2,VGK,3,1,NJD,28,9,16,3,56,18,13,19,1,51,28,9,16,3,56,18,13,19,1,51,0,1,37,21,0.480769,0.519231,4,4
2023021075,2024-03-17,2,CBJ,1,6,WPG,25,10,21,1,57,19,7,10,6,42,24,10,21,1,56,19,7,10,6,42,0,1,31,27,0.542373,0.457627,4,6
2023021076,2024-03-17,2,CHI,5,2,SJS,22,9,12,5,48,25,15,21,2,63,21,8,12,5,46,25,15,20,2,62,0,1,31,27,0.543478,0.456522,2,6
2023021077,2024-03-17,2,OTT,2,7,CAR,26,11,11,2,50,27,15,13,6,61,26,11,11,2,50,27,15,13,6,61,0,1,32,38,0.509804,0.490196,6,4
2023021078,2024-03-17,2,PIT,6,3,DET,26,17,12,5,60,21,13,18,2,54,26,17,12,5,60,21,13,18,2,54,1,0,38,28,0.491228,0.508772,4,8
2023021079,2024-03-17,2,STL,4,2,ANA,17,11,14,1,43,22,10,13,2,47,17,11,14,1,43,22,10,13,2,47,0,1,27,28,0.666667,0.333333,4,12
2023021080,2024-03-18,2,CGY,2,5,WSH,30,15,22,2,69,24,6,25,3,58,30,15,22,2,69,24,6,25,3,58,0,1,36,33,0.521739,0.478261,6,6
2023021081,2024-03-18,2,SEA,2,6,BUF,27,7,17,1,52,22,12,10,6,50,27,7,17,1,52,22,12,10,6,50,1,0,34,30,0.392157,0.607843,4,10
2023021082,2024-03-19,2,BOS,6,2,OTT,16,11,15,4,46,19,11,15,1,46,16,11,14,4,45,17,11,15,1,44,1,0,26,31,0.672414,0.327586,10,16
2023021083,2024-03-19,2,DET,4,3,CBJ,17,7,15,3,42,30,11,14,2,57,16,7,15,2,40,30,11,14,2,57,0,1,26,35,0.555556,0.444444,4,16
2023021084,2024-03-19,2,NJD,5,2,PIT,26,19,14,3,62,33,6,17,2,58,26,19,14,3,62,33,6,17,2,58,1,0,38,38,0.491525,0.508475,4,6
2023021085,2024-03-19,2,NYR,2,4,WPG,36,11,16,1,64,20,6,13,3,42,35,9,16,1,61,19,6,13,3,41,0,1,41,27,0.5,0.5,6,4
2023021086,2024-03-19,2,PHI,4,3,TOR,20,10,7,4,41,23,15,37,2,77,20,10,7,4,41,23,15,37,2,77,1,0,30,30,0.384615,0.615385,11,9
2023021087,2024-03-19,2,NYI,1,4,CAR,29,8,13,1,51,27,10,18,3,58,29,8,13,1,51,27,10,18,3,58,0,1,31,34,0.404762,0.595238,7,7
2023021088,2024-03-19,2,NSH,8,2,SJS,25,11,13,8,57,18,8,21,2,49,25,11,13,8,57,18,8,21,2,49,1,0,40,20,0.666667,0.333333,2,4
2023021089,2024-03-19,2,STL,3,4,COL,26,16,13,3,58,29,11,14,3,57,26,16,13,3,58,29,11,14,3,57,0,1,33,35,0.525424,0.474576,6,6
2023021090,2024-03-19,2,EDM,3,2,MTL,15,3,17,2,37,19,13,18,2,52,15,3,17,2,37,19,13,17,1,50,1,0,32,25,0.411765,0.588235,11,15
2023021091,2024-03-19,2,ANA,0,4,MIN,21,6,10,0,37,16,7,7,3,33,21,6,10,0,37,16,7,7,3,33,0,1,27,32,0.333333,0.666667,10,6
2023021092,2024-03-19,2,LAK,6,2,CHI,18,9,10,5,42,17,14,19,1,51,18,9,10,5,42,17,14,19,1,51,1,0,24,24,0.592593,0.407407,8,2
2023021093,2024-03-19,2,VAN,3,2,BUF,21,11,14,2,48,12,13,20,2,47,20,10,13,2,45,12,13,20,1,46,1,0,34,17,0.592593,0.407407,10,12
2023021094,2024-03-19,2,VGK,3,5,TBL,20,13,14,3,50,14,4,11,3,32,20,13,14,3,50,14,4,11,3,32,1,0,27,21,0.477273,0.522727,8,6
2023021095,2024-03-20,2,WSH,3,7,TOR,17,16,21,2,56,19,11,11,6,47,17,16,21,2,56,19,11,11,6,47,0,1,21,29,0.482143,0.517857,10,2
2023021096,2024-03-20,2,DAL,5,2,ARI,23,11,15,5,54,21,11,11,2,45,23,11,15,5,54,21,11,11,2,45,0,1,33,25,0.568627,0.431373,2,14
2023021097,2024-03-20,2,LAK,6,0,MIN,14,6,11,4,35,25,13,12,0,50,14,6,11,4,35,24,12,11,0,47,1,0,27,31,0.433962,0.566038,75,79
2023021098,2024-03-21,2,BOS,2,5,NYR,16,6,7,2,31,18,14,20,5,57,16,6,7,2,31,18,14,20,5,57,1,0,26,31,0.48,0.52,2,6
2023021099,2024-03-21,2,CAR,3,2,PHI,26,10,27,3,66,25,15,17,2,59,24,10,27,2,63,25,13,17,2,57,1,0,33,32,0.440678,0.559322,6,4
2023021100,2024-03-21,2,DET,6,3,NYI,16,6,7,6,35,24,11,13,2,50,16,6,7,6,35,24,11,13,2,50,1,0,24,36,0.424242,0.575758,8,4
2023021101,2024-03-21,2,FLA,0,3,NSH,30,10,13,0,53,31,8,15,2,56,30,10,13,0,53,31,8,15,2,56,0,1,33,37,0.473684,0.526316,16,14
2023021102,2024-03-21,2,NJD,4,1,WPG,28,9,9,1,47,16,10,14,1,41,28,9,9,1,47,16,10,14,1,41,1,0,41,19,0.639344,0.360656,8,8
2023021103,2024-03-21,2,OTT,2,5,STL,29,15,16,1,61,18,3,7,5,33,29,15,16,1,61,18,3,7,5,33,0,1,39,27,0.529412,0.470588,4,6
2023021104,2024-03-21,2,EDM,8,3,BUF,30,10,20,7,67,19,5,14,3,41,30,10,20,7,67,19,5,14,3,41,0,1,39,29,0.596491,0.403509,6,4
2023021105,2024-03-21,2,ANA,4,0,CHI,14,13,13,3,43,25,5,10,0,40,14,13,13,3,43,23,5,10,0,38,1,0,25,29,0.583333,0.416667,14,22
2023021106,2024-03-21,2,VAN,4,1,MTL,18,15,19,4,56,13,8,11,1,33,18,15,19,4,56,13,8,11,1,33,1,0,25,17,0.46,0.54,8,10
2023021107,2024-03-21,2,VGK,3,1,SEA,27,13,8,2,50,14,6,22,0,42,27,13,8,2,50,14,6,22,0,42,1,0,37,22,0.607843,0.392157,6,10
2023021108,2024-03-21,2,SJS,1,4,TBL,19,7,17,1,44,14,9,9,3,35,19,6,17,1,43,13,8,9,3,33,0,1,22,21,0.479167,0.520833,8,8
2023021109,2024-03-22,2,WSH,7,6,CAR,19,13,21,4,57,26,19,15,5,65,15,10,20,3,48,18,13,12,4,47,0,1,25,31,0.56,0.44,6,12
2023021110,2024-03-22,2,DAL,4,2,PIT,19,12,14,3,48,19,11,16,2,48,19,12,14,3,48,19,11,16,2,48,0,1,23,22,0.372881,0.627119,4,4
2023021111,2024-03-22,2,COL,6,1,CBJ,39,10,25,5,79,23,14,12,1,50,39,10,25,5,79,23,14,12,1,50,0,1,50,24,0.5625,0.4375,5,11
2023021112,2024-03-22,2,ARI,2,1,SEA,19,11,8,2,40,26,16,17,1,60,18,11,7,1,37,24,15,17,1,57,0,1,26,28,0.481481,0.518519,11,9
2023021113,2024-03-23,2,NYI,6,3,WPG,33,11,16,6,66,28,25,12,3,68,33,11,16,6,66,28,25,12,3,68,1,0,39,35,0.59322,0.40678,7,7
2023021114,2024-03-23,2,PHI,3,2,BOS,26,14,9,2,51,15,11,15,2,43,26,14,9,2,51,15,11,15,2,43,1,0,29,20,0.471698,0.528302,4,6
2023021115,2024-03-23,2,MIN,4,5,STL,28,17,11,4,60,20,12,10,5,47,27,17,11,4,59,20,12,10,4,46,0,1,34,27,0.453125,0.546875,4,4
2023021116,2024-03-23,2,NSH,1,0,DET,28,14,16,1,59,19,11,15,0,45,27,13,14,1,55,18,11,15,0,44,1,0,32,22,0.481481,0.518519,13,9
2023021117,2024-03-23,2,NJD,2,5,OTT,16,5,10,2,33,15,11,5,4,35,16,5,10,2,33,14,11,5,3,33,0,1,20,25,0.555556,0.444444,15,13
2023021118,2024-03-23,2,TOR,6,3,EDM,19,7,7,5,38,29,13,26,1,69,19,7,7,5,38,29,13,26,1,69,1,0,29,39,0.473684,0.526316,17,23
2023021119,2024-03-23,2,NYR,4,3,FLA,29,7,17,4,57,25,8,11,4,48,24,6,16,2,48,20,6,9,3,38,0,1,37,30,0.472727,0.527273,4,6
2023021120,2024-03-23,2,VAN,4,2,CGY,20,16,8,3,47,21,14,19,2,56,20,16,8,3,47,21,14,19,2,56,1,0,26,24,0.592593,0.407407,4,6
2023021121,2024-03-23,2,LAK,4,3,TBL,12,6,18,4,40,17,18,19,1,55,12,6,18,3,39,17,18,19,1,55,1,0,23,24,0.431373,0.568627,6,6
2023021122,2024-03-23,2,SJS,4,5,CHI,26,10,20,2,58,23,13,13,5,54,26,10,20,2,58,23,13,13,4,53,1,0,30,31,0.54386,0.45614,9,13
2023021123,2024-03-23,2,VGK,4,2,CBJ,42,15,23,3,83,19,8,11,2,40,42,15,23,3,83,19,8,11,2,40,0,1,47,22,0.48,0.52,2,4
2023021124,2024-03-24,2,WSH,3,0,WPG,14,10,11,2,37,23,19,15,0,57,14,10,11,2,37,23,19,15,0,57,1,0,19,27,0.527273,0.472727,4,6
2023021125,2024-03-24,2,COL,5,4,PIT,23,13,17,5,58,28,14,15,4,61,23,13,17,4,57,28,14,15,4,61,0,1,30,34,0.438596,0.561404,4,4
2023021126,2024-03-24,2,NYI,0,4,NJD,27,10,14,0,51,20,6,20,3,49,25,9,13,0,47,20,5,19,3,47,0,1,36,30,0.438596,0.561404,28,29
2023021127,2024-03-24,2,CAR,2,1,TOR,32,11,14,1,58,25,15,11,1,52,32,11,14,1,58,25,15,11,1,52,1,0,43,33,0.564516,0.435484,8,6
2023021128,2024-03-24,2,OTT,5,3,EDM,11,7,9,2,29,29,12,10,1,52,11,7,9,2,29,29,12,10,1,52,0,1,16,36,0.462963,0.537037,6,8
2023021129,2024-03-24,2,PHI,1,4,FLA,27,14,20,0,61,10,4,6,3,23,27,14,20,0,61,10,4,6,3,23,0,1,33,15,0.479167,0.520833,6,12
2023021130,2024-03-24,2,ARI,2,4,DAL,21,11,12,2,46,24,16,17,4,61,21,11,12,2,46,24,15,16,4,59,0,1,28,35,0.409836,0.590164,8,10
2023021131,2024-03-24,2,ANA,2,3,TBL,22,6,14,2,44,23,11,14,3,51,22,6,14,2,44,21,11,13,2,47,1,0,32,27,0.45283,0.54717,6,8
2023021132,2024-03-24,2,CGY,1,4,BUF,28,17,23,0,68,23,11,16,4,54,28,17,23,0,68,23,11,16,4,54,0,1,33,29,0.627451,0.372549,2,4
2023021133,2024-03-24,2,SEA,1,5,MTL,30,16,16,1,63,11,9,11,4,35,29,15,16,1,61,11,9,11,4,35,0,1,37,17,0.472727,0.527273,4,8
2023021134,2024-03-25,2,STL,1,2,VGK,27,5,14,1,47,26,10,16,2,54,25,5,14,1,45,26,10,16,1,53,0,1,32,34,0.555556,0.444444,9,9
2023021135,2024-03-25,2,VAN,2,3,LAK,18,19,13,2,52,14,9,6,3,32,18,19,13,2,52,14,9,6,2,31,0,1,23,19,0.5,0.5,4,4
2023021136,2024-03-26,2,FLA,3,4,BOS,14,16,19,3,52,11,6,8,3,28,13,15,19,3,50,11,6,8,3,28,1,0,21,21,0.490196,0.509804,19,17
2023021137,2024-03-26,2,NYR,6,5,PHI,18,12,14,4,48,34,17,17,4,72,18,12,13,3,46,34,17,17,4,72,0,1,27,42,0.546875,0.453125,6,2
2023021138,2024-03-26,2,PIT,4,1,CAR,15,10,8,4,37,35,26,21,1,83,15,10,8,4,37,35,26,21,1,83,1,0,22,39,0.527027,0.472973,9,9
2023021139,2024-03-26,2,TOR,3,6,NJD,38,13,11,3,65,17,8,7,6,38,38,13,11,3,65,17,8,7,6,38,1,0,45,25,0.510638,0.489362,4,4
2023021140,2024-03-26,2,WSH,4,3,DET,24,13,13,4,54,23,15,17,2,57,23,11,13,3,50,23,15,17,2,57,1,0,30,33,0.378788,0.621212,4,4
2023021141,2024-03-26,2,NSH,5,4,VGK,26,14,17,4,61,30,7,20,4,61,26,14,17,3,60,30,7,20,4,61,0,1,35,35,0.471698,0.528302,4,4
2023021142,2024-03-26,2,WPG,3,4,EDM,19,7,9,3,38,37,3,12,3,55,17,7,8,3,35,36,3,12,2,53,1,0,25,42,0.491525,0.508475,18,20
2023021143,2024-03-26,2,CHI,3,1,CGY,20,5,4,2,31,33,16,21,1,71,20,5,4,2,31,33,16,21,1,71,1,0,27,39,0.382979,0.617021,4,4
2023021144,2024-03-26,2,COL,1,2,MTL,25,16,21,1,63,21,8,10,2,41,25,16,21,1,63,21,8,10,2,41,1,0,28,27,0.45614,0.54386,6,6
2023021145,2024-03-26,2,ARI,6,2,CBJ,25,20,14,3,62,19,10,11,0,40,25,20,14,3,62,19,10,11,0,40,0,1,35,27,0.351852,0.648148,23,19
2023021146,2024-03-26,2,SEA,4,0,ANA,25,9,20,2,56,10,19,11,0,40,25,9,20,2,56,10,19,11,0,40,1,0,36,12,0.627451,0.372549,2,10
2023021147,2024-03-26,2,SJS,3,6,DAL,17,14,14,2,47,28,17,16,4,65,17,14,14,2,47,28,17,16,4,65,0,1,20,41,0.461538,0.538462,13,11
2023021148,2024-03-27,2,BUF,2,6,OTT,30,18,17,2,67,31,11,9,6,57,29,18,17,2,66,30,11,9,5,55,0,1,36,42,0.4,0.6,10,10
2023021149,2024-03-27,2,TBL,3,1,BOS,27,9,16,3,55,18,4,11,1,34,27,9,16,3,55,18,4,11,1,34,1,0,31,24,0.55102,0.44898,9,7
2023021150,2024-03-28,2,CAR,4,0,DET,25,19,9,3,56,20,11,14,0,45,25,19,9,3,56,20,11,14,0,45,1,0,33,24,0.509434,0.490566,4,4
2023021151,2024-03-28,2,FLA,2,3,NYI,22,10,24,2,58,16,7,3,3,29,22,10,24,2,58,16,7,3,3,29,1,0,28,24,0.490196,0.509804,12,2
2023021152,2024-03-28,2,MTL,4,1,PHI,12,12,13,3,40,22,7,18,1,48,11,10,12,2,35,18,6,17,1,42,1,0,17,30,0.491228,0.508772,14,10
2023021153,2024-03-28,2,OTT,2,0,CHI,30,12,15,1,58,17,10,13,0,40,30,12,15,1,58,17,10,13,0,40,1,0,34,19,0.613636,0.386364,4,4
2023021154,2024-03-28,2,PIT,3,2,CBJ,26,14,10,1,51,15,12,17,2,46,26,14,10,1,51,15,12,17,2,46,0,1,36,19,0.604167,0.395833,4,10
2023021155,2024-03-28,2,TOR,5,1,WSH,37,11,14,5,67,21,9,20,1,51,37,11,14,5,67,21,9,20,1,51,1,0,48,24,0.636364,0.363636,4,2
2023021156,2024-03-28,2,MIN,3,1,SJS,19,10,18,3,50,25,9,19,1,54,19,10,18,3,50,25,9,19,1,54,1,0,32,27,0.428571,0.571429,2,4
2023021157,2024-03-28,2,STL,5,3,CGY,11,12,9,4,36,23,12,18,2,55,11,12,9,4,36,23,12,18,2,55,1,0,19,28,0.633333,0.366667,11,11
2023021158,2024-03-28,2,WPG,1,4,VGK,27,15,15,1,58,21,11,6,4,42,27,15,15,1,58,21,11,6,4,42,0,1,40,27,0.387097,0.612903,24,22
2023021159,2024-03-28,2,COL,2,3,NYR,37,16,22,2,77,20,15,15,3,53,30,16,21,2,69,18,14,15,1,48,1,0,40,25,0.539683,0.460317,6,4
2023021160,2024-03-28,2,EDM,4,1,LAK,14,8,17,3,42,32,7,18,1,58,13,8,15,2,38,30,6,18,1,55,1,0,20,32,0.425926,0.574074,6,6
2023021161,2024-03-28,2,ARI,8,4,NSH,28,12,14,7,61,33,16,16,2,67,28,12,14,7,61,33,16,16,2,67,0,1,40,37,0.508475,0.491525,9,11
2023021162,2024-03-28,2,SEA,4,2,ANA,12,4,6,1,23,16,11,11,0,38,12,4,6,1,23,16,11,11,0,38,1,0,28,23,0.470588,0.529412,13,27
2023021163,2024-03-28,2,VAN,1,3,DAL,22,13,16,1,52,23,18,16,1,58,20,12,16,1,49,22,16,16,1,55,0,1,28,34,0.553191,0.446809,12,8
2023021164,2024-03-29,2,BUF,5,2,NJD,31,12,12,5,60,26,15,17,2,60,31,12,12,5,60,26,15,17,2,60,0,1,36,30,0.339623,0.660377,6,0
2023021165,2024-03-30,2,FLA,3,2,DET,31,23,25,3,82,21,9,4,0,34,29,21,25,1,76,18,5,4,0,27,0,1,38,22,0.438596,0.561404,16,6
2023021166,2024-03-30,2,MIN,1,2,VGK,26,10,12,0,48,20,10,20,2,52,21,10,12,0,43,19,9,19,1,48,1,0,33,31,0.603774,0.396226,16,15
2023021167,2024-03-30,2,EDM,6,1,ANA,28,21,13,5,67,21,8,13,0,42,28,21,13,5,67,21,8,13,0,42,1,0,37,22,0.637931,0.362069,4,6
2023021168,2024-03-30,2,ARI,5,8,NYR,21,10,14,4,49,23,8,10,7,48,21,10,14,4,49,23,8,10,7,48,0,1,32,32,0.546875,0.453125,0,6
2023021169,2024-03-30,2,COL,7,4,NSH,25,6,19,4,54,26,11,14,4,55,24,6,19,4,53,26,11,13,4,54,0,1,42,35,0.529412,0.470588,10,13
2023021170,2024-03-30,2,BUF,0,3,TOR,24,9,11,0,44,15,6,8,3,32,24,9,11,0,44,15,6,8,3,32,0,1,34,22,0.32,0.68,70,62
2023021171,2024-03-30,2,CBJ,4,3,PIT,28,16,22,4,70,26,14,15,4,59,25,13,19,2,59,22,12,15,3,52,1,0,37,33,0.45,0.55,4,8
2023021172,2024-03-30,2,MTL,0,3,CAR,21,12,11,0,44,24,15,19,1,59,21,12,11,0,44,24,15,19,1,59,0,1,26,30,0.433333,0.566667,4,6
2023021173,2024-03-30,2,PHI,1,5,CHI,24,15,15,1,55,17,7,10,4,38,23,15,15,1,54,17,7,10,4,38,0,1,31,24,0.608696,0.391304,21,13
2023021174,2024-03-30,2,TBL,4,1,NYI,33,14,20,3,70,27,16,18,1,62,33,14,20,3,70,27,16,18,1,62,0,1,40,28,0.571429,0.428571,4,4
2023021175,2024-03-30,2,WPG,2,3,OTT,20,12,19,1,52,16,15,11,2,44,20,12,19,1,52,16,15,11,2,44,1,0,30,27,0.480769,0.519231,10,10
2023021176,2024-03-30,2,WSH,2,3,BOS,14,8,22,3,47,24,12,18,5,59,11,8,22,1,42,21,12,18,2,53,0,1,20,29,0.509091,0.490909,4,8
2023021177,2024-03-30,2,STL,0,4,SJS,33,23,22,0,78,11,8,8,4,31,33,23,22,0,78,10,7,8,4,29,0,1,35,20,0.610169,0.389831,6,4
2023021178,2024-03-30,2,CGY,4,2,LAK,21,12,23,1,57,15,13,15,0,43,21,12,23,1,57,15,13,15,0,43,1,0,35,18,0.54717,0.45283,8,12
2023021179,2024-03-30,2,SEA,0,3,DAL,15,10,16,0,41,20,16,19,2,57,15,10,16,0,41,20,16,19,2,57,0,1,17,30,0.385965,0.614035,15,4
2023021180,2024-03-31,2,VAN,3,2,ANA,21,14,14,1,50,17,15,11,2,45,21,14,14,1,50,17,15,11,2,45,1,0,30,22,0.65,0.35,8,12
2023021181,2024-04-01,2,CBJ,4,1,COL,14,9,17,4,44,35,10,10,1,56,14,9,16,4,43,35,10,10,1,56,1,0,25,46,0.442623,0.557377,8,4
2023021182,2024-04-01,2,NYR,2,5,PIT,22,13,16,2,53,13,14,11,5,43,22,13,16,2,53,13,14,11,5,43,0,1,30,20,0.571429,0.428571,10,10
2023021183,2024-04-01,2,PHI,3,4,NYI,26,11,26,3,66,21,11,20,4,56,26,11,26,3,66,21,11,20,3,55,1,0,34,27,0.471698,0.528302,4,4
2023021184,2024-04-01,2,TBL,2,4,DET,27,11,19,0,57,18,10,13,4,45,27,11,19,0,57,18,10,13,4,45,0,1,36,32,0.492063,0.507937,6,6
2023021185,2024-04-01,2,TOR,6,4,FLA,14,10,5,6,35,20,16,11,4,51,14,10,5,6,35,20,16,11,4,51,1,0,23,30,0.508475,0.491525,8,6
2023021186,2024-04-01,2,STL,3,2,EDM,19,7,5,2,33,33,7,14,2,56,18,7,5,1,31,30,6,12,2,50,0,1,29,38,0.561404,0.438596,11,15
2023021187,2024-04-01,2,WPG,4,3,LAK,26,10,13,4,53,25,13,17,3,58,26,10,13,4,53,25,13,17,3,58,1,0,32,28,0.615385,0.384615,0,2
2023021188,2024-04-01,2,SJS,2,4,SEA,24,17,20,1,62,24,14,14,4,56,24,17,20,1,62,24,14,14,4,56,0,1,26,32,0.574074,0.425926,4,4
2023021189,2024-04-02,2,BUF,6,2,WSH,28,11,16,4,59,16,13,19,1,49,28,11,16,4,59,16,13,19,1,49,0,1,35,26,0.438596,0.561404,6,4
2023021190,2024-04-02,2,MTL,5,3,FLA,26,8,13,3,50,22,12,14,3,51,26,8,13,3,50,21,10,14,3,48,0,1,38,40,0.363636,0.636364,26,40
2023021191,2024-04-02,2,NJD,3,6,PIT,19,10,14,2,45,10,12,18,5,45,19,10,14,2,45,10,12,18,5,45,0,1,26,21,0.482759,0.517241,6,8
2023021192,2024-04-02,2,NYI,2,1,CHI,26,13,15,1,55,17,7,13,1,38,26,13,15,1,55,17,7,13,1,38,0,1,29,19,0.617021,0.382979,7,9
2023021193,2024-04-02,2,MIN,3,2,OTT,14,6,5,3,28,27,12,19,0,58,14,6,5,3,28,27,12,19,0,58,1,0,19,32,0.283019,0.716981,8,10
2023021194,2024-04-02,2,NSH,0,3,BOS,28,14,21,0,63,24,9,10,2,45,28,14,21,0,63,24,9,10,2,45,0,1,31,32,0.660377,0.339623,4,8
2023021195,2024-04-02,2,CGY,3,5,ANA,20,12,15,2,49,24,13,17,4,58,20,12,15,2,49,24,13,17,4,58,0,1,24,29,0.58209,0.41791,2,4
2023021196,2024-04-02,2,VGK,6,3,VAN,15,9,11,4,39,21,8,19,2,50,15,9,10,4,38,19,7,18,2,46,1,0,30,30,0.433333,0.566667,8,21
2023021197,2024-04-03,2,TOR,1,4,TBL,23,14,16,0,53,16,8,12,4,40,22,14,13,0,49,15,8,12,4,39,0,1,29,25,0.546875,0.453125,13,15
2023021198,2024-04-03,2,NYR,4,3,NJD,29,14,13,3,59,14,7,14,3,38,29,14,13,3,59,14,7,14,3,38,1,0,41,20,0.442623,0.557377,78,88
2023021199,2024-04-03,2,DAL,5,0,EDM,21,20,9,4,54,27,9,22,0,58,21,20,9,4,54,27,9,22,0,58,1,0,32,35,0.535714,0.464286,8,16
2023021200,2024-04-03,2,ARI,1,2,VAN,15,15,16,0,46,23,25,10,1,59,15,15,16,0,46,23,25,10,1,59,0,1,21,33,0.409836,0.590164,11,11
2023021201,2024-04-03,2,LAK,5,2,SEA,15,5,13,4,37,17,6,16,1,40,15,5,13,4,37,16,6,16,1,39,1,0,27,23,0.479167,0.520833,10,28
2023021202,2024-04-04,2,CAR,1,4,BOS,24,24,19,0,67,21,7,11,4,43,24,24,19,0,67,21,7,11,4,43,0,1,29,28,0.607843,0.392157,13,11
2023021203,2024-04-04,2,CBJ,2,4,NYI,23,5,14,1,43,30,21,19,3,73,23,5,14,1,43,30,21,19,3,73,0,1,27,41,0.392857,0.607143,6,2
2023021204,2024-04-04,2,MTL,4,7,TBL,20,9,19,4,52,20,6,12,5,43,20,9,19,4,52,20,6,12,5,43,1,0,30,35,0.40625,0.59375,16,14
2023021205,2024-04-04,2,OTT,0,6,FLA,24,8,14,0,46,22,9,16,5,52,24,8,14,0,46,21,9,15,5,50,0,1,30,31,0.543478,0.456522,6,14
2023021206,2024-04-04,2,WSH,1,4,PIT,25,15,20,0,60,13,9,7,4,33,25,15,20,0,60,13,9,7,4,33,0,1,31,24,0.444444,0.555556,4,8
2023021207,2024-04-04,2,MIN,2,5,COL,33,11,14,1,59,31,15,15,4,65,33,11,14,1,59,30,15,15,4,64,0,1,46,36,0.484848,0.515152,4,8
2023021208,2024-04-04,2,NSH,6,3,STL,19,8,13,3,43,35,13,10,2,60,19,7,12,3,41,30,13,10,2,55,1,0,31,47,0.55,0.45,16,10
2023021209,2024-04-04,2,WPG,5,2,CGY,28,6,7,3,44,25,11,14,1,51,28,6,7,3,44,25,11,14,1,51,0,1,45,33,0.588235,0.411765,4,21
2023021210,2024-04-04,2,SJS,1,2,LAK,12,6,9,1,28,20,6,11,2,39,12,6,9,1,28,20,6,11,2,39,0,1,16,27,0.489796,0.510204,15,13
2023021211,2024-04-05,2,BUF,4,2,PHI,15,16,19,4,54,28,21,17,2,68,14,14,18,3,49,27,21,17,2,67,1,0,19,34,0.306122,0.693878,6,2
2023021212,2024-04-05,2,CAR,4,2,WSH,33,21,18,2,74,13,6,6,2,27,33,21,18,2,74,13,6,6,2,27,0,1,45,16,0.596774,0.403226,6,8
2023021213,2024-04-05,2,DET,3,4,NYR,24,6,14,2,46,25,12,13,3,53,24,6,14,2,46,25,12,13,3,53,0,1,34,38,0.575758,0.424242,8,8
2023021214,2024-04-05,2,EDM,6,2,COL,29,7,8,6,50,17,11,11,2,41,29,7,8,6,50,17,11,11,2,41,1,0,47,24,0.661017,0.338983,6,10
2023021215,2024-04-05,2,ANA,1,3,SEA,13,7,12,1,33,20,20,14,2,56,13,7,12,1,33,20,20,14,2,56,0,1,17,27,0.468085,0.531915,12,4
2023021216,2024-04-05,2,ARI,7,4,VGK,24,8,20,7,59,17,9,10,4,40,24,8,20,7,59,17,9,10,4,40,1,0,32,24,0.523077,0.476923,8,4
2023021217,2024-04-06,2,PIT,5,4,TBL,21,15,19,5,60,21,9,20,2,52,21,15,19,5,60,21,9,20,2,52,1,0,28,34,0.576271,0.423729,8,4
2023021218,2024-04-06,2,BOS,3,2,FLA,20,5,9,2,36,21,11,23,2,57,15,4,9,1,29,18,9,20,1,48,0,1,29,30,0.596774,0.403226,10,14
2023021219,2024-04-06,2,MIN,2,4,WPG,18,8,9,1,36,20,10,10,4,44,18,8,9,1,36,20,10,10,4,44,0,1,27,25,0.425532,0.574468,4,8
2023021220,2024-04-06,2,CHI,3,2,DAL,14,3,12,2,31,40,13,25,2,80,14,3,12,2,31,40,13,25,2,80,1,0,17,44,0.416667,0.583333,8,6
2023021221,2024-04-06,2,SJS,3,2,STL,14,4,5,1,24,22,14,6,1,43,14,4,5,0,23,20,14,5,1,40,1,0,25,36,0.563636,0.436364,42,30
2023021222,2024-04-06,2,CBJ,6,2,PHI,24,17,19,5,65,33,17,13,2,65,24,17,19,5,65,33,17,13,2,65,1,0,33,39,0.5,0.5,4,6
2023021223,2024-04-06,2,MTL,2,4,TOR,23,18,21,1,63,23,13,15,4,55,23,18,21,1,63,23,12,14,4,53,0,1,26,30,0.508772,0.491228,9,9
2023021224,2024-04-06,2,OTT,3,4,NJD,25,19,22,1,67,22,15,22,4,63,25,19,22,1,67,22,14,22,4,62,0,1,28,27,0.433333,0.566667,11,15
2023021225,2024-04-06,2,NYI,2,0,NSH,26,8,8,2,44,35,17,28,0,80,26,8,8,2,44,35,17,28,0,80,1,0,30,42,0.590909,0.409091,6,2
2023021226,2024-04-06,2,CGY,2,4,EDM,30,13,17,0,60,18,7,10,2,37,29,13,17,0,59,17,5,10,2,34,0,1,35,27,0.446154,0.553846,14,14
2023021227,2024-04-06,2,LAK,6,3,VAN,23,9,6,3,41,29,8,22,2,61,23,9,6,3,41,29,8,22,2,61,1,0,29,42,0.518519,0.481481,6,18
2023021228,2024-04-07,2,DET,3,1,BUF,17,14,9,2,42,36,14,27,0,77,17,14,9,2,42,36,14,27,0,77,1,0,24,38,0.5,0.5,18,18
2023021229,2024-04-07,2,CHI,0,4,MIN,24,9,15,0,48,30,11,12,3,56,24,9,15,0,48,30,11,12,3,56,0,1,24,37,0.68,0.32,4,0
2023021230,2024-04-07,2,CAR,3,0,CBJ,26,14,15,2,57,22,14,8,0,44,26,14,15,2,57,22,14,8,0,44,1,0,35,23,0.654545,0.345455,2,8
2023021231,2024-04-07,2,SJS,2,5,ARI,20,12,11,1,44,17,6,14,4,41,18,12,10,1,41,15,5,14,4,38,0,1,27,28,0.530612,0.469388,18,14
2023021232,2024-04-07,2,WSH,2,3,OTT,13,14,10,2,39,15,21,24,3,63,13,14,10,2,39,15,21,24,2,62,1,0,22,21,0.381818,0.618182,6,8
2023021233,2024-04-07,2,NJD,2,3,NSH,25,13,8,2,48,31,13,15,2,61,20,13,7,2,42,28,13,15,1,57,1,0,25,35,0.444444,0.555556,8,4
2023021234,2024-04-07,2,NYR,5,2,MTL,35,17,15,3,70,25,13,8,2,48,35,17,15,3,70,25,13,8,2,48,0,1,46,28,0.581818,0.418182,2,6
2023021235,2024-04-07,2,ANA,5,6,STL,34,12,11,5,62,21,8,12,4,45,28,11,11,5,55,18,6,10,3,37,0,1,38,31,0.465517,0.534483,8,6
2023021236,2024-04-07,2,COL,4,7,DAL,30,12,28,3,73,28,15,15,4,62,30,12,28,3,73,28,15,15,4,62,1,0,38,37,0.416667,0.583333,6,4
2023021237,2024-04-08,2,TOR,3,2,PIT,18,13,18,2,51,21,20,11,2,54,18,13,18,1,50,21,18,10,2,51,0,1,23,33,0.508772,0.491228,10,4
2023021238,2024-04-08,2,VAN,4,3,VGK,19,7,12,2,40,17,10,18,1,46,19,7,12,2,40,17,10,18,1,46,0,1,30,23,0.480769,0.519231,8,6
2023021239,2024-04-09,2,BOS,1,4,CAR,19,3,7,1,30,18,15,9,3,45,18,3,7,1,29,18,13,9,3,43,0,1,23,26,0.5,0.5,6,8
2023021240,2024-04-09,2,DET,1,2,WSH,38,10,26,1,75,20,11,22,2,55,38,10,26,1,75,20,11,22,2,55,0,1,43,23,0.52,0.48,2,4
2023021241,2024-04-09,2,FLA,2,0,OTT,13,4,15,1,33,22,14,11,0,47,13,4,15,1,33,22,14,11,0,47,1,0,30,26,0.478261,0.521739,16,20
2023021242,2024-04-09,2,MTL,9,3,PHI,20,13,24,9,66,32,20,19,3,74,20,12,24,9,65,31,20,19,3,73,1,0,30,36,0.460317,0.539683,6,2
2023021243,2024-04-09,2,NJD,2,5,TOR,14,9,10,1,34,26,11,21,5,63,14,9,10,1,34,26,11,21,5,63,0,1,20,39,0.54,0.46,6,4
2023021244,2024-04-09,2,NYI,4,2,NYR,21,11,6,4,42,29,19,33,0,81,20,11,6,4,41,29,19,33,0,81,1,0,28,33,0.5,0.5,6,14
2023021245,2024-04-09,2,TBL,5,2,CBJ,25,8,14,4,51,28,13,17,1,59,25,8,14,4,51,28,13,17,1,59,1,0,33,32,0.55,0.45,4,4
2023021246,2024-04-09,2,DAL,3,2,BUF,20,12,9,3,44,17,9,20,2,48,20,12,9,3,44,17,9,20,2,48,0,1,24,21,0.547945,0.452055,16,4
2023021247,2024-04-09,2,NSH,3,4,WPG,34,10,15,3,62,15,8,12,3,38,34,10,15,3,62,14,7,12,2,35,1,0,48,22,0.526316,0.473684,11,13
2023021248,2024-04-09,2,COL,5,2,MIN,19,8,12,4,43,8,8,11,0,27,19,8,12,4,43,8,8,11,0,27,1,0,32,22,0.472727,0.527273,10,8
2023021249,2024-04-09,2,ANA,3,1,LAK,19,7,10,3,39,31,18,9,1,59,19,7,10,3,39,31,18,9,1,59,0,1,27,37,0.265306,0.734694,4,6
2023021250,2024-04-09,2,SEA,5,0,ARI,20,8,15,4,47,38,14,18,0,70,20,8,15,4,47,37,14,18,0,69,1,0,25,39,0.57377,0.42623,4,8
2023021251,2024-04-09,2,SJS,2,3,CGY,17,8,5,2,32,30,14,25,1,70,16,8,5,2,31,29,13,25,1,68,1,0,22,41,0.517857,0.482143,6,8
2023021252,2024-04-10,2,STL,5,2,CHI,19,12,16,5,52,15,8,11,2,36,17,11,16,5,49,14,7,11,1,33,1,0,26,20,0.533333,0.466667,8,10
2023021253,2024-04-10,2,EDM,5,1,VGK,17,17,15,4,53,16,19,19,0,54,17,17,15,4,53,16,19,19,0,54,1,0,25,18,0.509434,0.490566,0,6
2023021254,2024-04-10,2,VAN,3,4,ARI,18,23,19,2,62,10,11,6,4,31,16,23,19,2,60,9,11,6,3,29,0,1,26,18,0.655172,0.344828,10,8
2023021255,2024-04-11,2,BUF,4,2,WSH,13,13,19,4,49,22,19,17,2,60,13,13,19,4,49,22,19,17,2,60,1,0,17,24,0.295455,0.704545,12,12
2023021256,2024-04-11,2,FLA,4,0,CBJ,39,13,16,4,72,24,3,8,0,35,39,13,16,4,72,24,3,8,0,35,1,0,46,25,0.434783,0.565217,2,4
2023021257,2024-04-11,2,NYR,1,4,PHI,18,11,16,0,45,18,7,6,4,35,17,11,13,0,41,16,7,6,4,33,0,1,25,26,0.58,0.42,12,12
2023021258,2024-04-11,2,PIT,6,5,DET,16,8,15,5,44,20,12,14,5,51,15,8,14,4,41,19,12,14,5,50,1,0,27,30,0.449275,0.550725,8,6
2023021259,2024-04-11,2,TBL,2,3,OTT,18,7,12,2,39,15,16,20,3,54,13,4,11,2,30,12,14,20,2,48,0,1,26,27,0.596774,0.403226,20,12
2023021260,2024-04-11,2,TOR,5,6,NJD,23,16,19,5,63,12,9,15,3,39,23,16,19,5,63,12,9,15,3,39,1,0,32,20,0.517241,0.482759,23,11
2023021261,2024-04-11,2,NYI,3,2,MTL,26,18,19,3,66,11,6,12,2,31,26,17,18,2,63,11,6,12,2,31,0,1,31,14,0.541667,0.458333,5,13
2023021262,2024-04-11,2,DAL,0,3,WPG,23,16,17,0,56,20,12,7,3,42,23,16,17,0,56,20,12,7,3,42,0,1,24,24,0.612245,0.387755,4,4
2023021263,2024-04-11,2,SEA,1,3,SJS,41,15,29,1,86,20,11,6,3,40,41,15,29,1,86,20,11,6,3,40,0,1,50,23,0.459016,0.540984,4,6
2023021264,2024-04-11,2,LAK,4,1,CGY,19,14,12,3,48,22,13,14,1,50,19,14,12,3,48,22,13,14,1,50,1,0,30,23,0.509804,0.490196,6,12
2023021265,2024-04-12,2,STL,2,5,CAR,26,7,14,1,48,33,13,19,5,70,25,6,14,1,46,30,12,19,4,65,1,0,31,42,0.509091,0.490909,6,6
2023021266,2024-04-12,2,CHI,1,5,NSH,21,8,11,0,40,32,11,12,2,57,20,8,10,0,38,31,11,11,2,55,0,1,26,40,0.4,0.6,8,10
2023021267,2024-04-12,2,EDM,2,3,ARI,37,16,18,2,73,22,10,10,3,45,36,16,17,2,71,20,10,9,2,41,0,1,41,28,0.654545,0.345455,4,2
2023021268,2024-04-12,2,ANA,3,6,CGY,17,13,13,3,46,17,18,23,3,61,17,13,13,3,46,17,17,22,2,58,0,1,22,27,0.490909,0.509091,12,6
2023021269,2024-04-12,2,VGK,7,2,MIN,23,9,12,4,48,20,7,16,1,44,23,9,12,4,48,20,7,16,1,44,1,0,30,27,0.522727,0.477273,6,8
2023021270,2024-04-13,2,NYR,3,2,NYI,37,18,20,3,78,33,15,13,2,63,36,16,20,1,73,27,13,13,2,55,1,0,43,36,0.551724,0.448276,10,2
2023021271,2024-04-13,2,DAL,3,1,SEA,22,11,13,2,48,20,13,11,1,45,21,11,13,2,47,20,13,11,1,45,1,0,30,27,0.555556,0.444444,6,6
2023021272,2024-04-13,2,COL,0,7,WPG,27,21,18,0,66,18,11,14,5,48,27,21,18,0,66,18,11,14,5,48,0,1,30,26,0.711538,0.288462,6,2
2023021273,2024-04-13,2,FLA,3,2,BUF,30,14,22,2,68,22,3,4,1,30,30,14,21,1,66,21,2,4,1,28,0,1,42,29,0.637931,0.362069,4,9
2023021274,2024-04-13,2,PHI,1,0,NJD,16,11,8,0,35,18,8,23,0,49,16,11,8,0,35,18,8,23,0,49,1,0,21,20,0.47619,0.52381,2,6
2023021275,2024-04-13,2,WSH,4,2,TBL,22,5,15,3,45,30,8,14,2,54,22,5,15,3,45,30,8,14,2,54,1,0,34,34,0.5,0.5,7,11
2023021276,2024-04-13,2,OTT,5,4,MTL,31,16,16,2,65,22,11,16,2,51,26,15,15,1,57,17,8,15,2,42,0,1,44,25,0.5,0.5,6,12
2023021277,2024-04-13,2,TOR,4,5,DET,17,14,18,2,51,22,5,7,3,37,17,14,18,2,51,22,5,7,3,37,1,0,36,32,0.411765,0.588235,6,8
2023021278,2024-04-13,2,NSH,6,4,CBJ,28,16,4,4,52,31,11,19,4,65,28,16,4,4,52,30,11,19,4,64,0,1,37,37,0.485714,0.514286,7,11
2023021279,2024-04-13,2,PIT,4,6,BOS,23,11,23,2,59,18,16,15,5,54,23,11,23,2,59,18,16,15,5,54,0,1,32,31,0.46875,0.53125,6,4
2023021280,2024-04-13,2,EDM,1,3,VAN,27,11,19,1,58,22,9,8,3,42,27,11,19,1,58,22,9,8,3,42,0,1,33,27,0.464286,0.535714,4,4
2023021281,2024-04-13,2,LAK,3,1,ANA,21,12,12,2,47,21,7,2,1,31,21,12,11,2,46,21,5,2,0,28,1,0,28,29,0.682927,0.317073,6,10
2023021282,2024-04-13,2,SJS,2,6,MIN,23,5,16,2,46,31,13,14,5,63,23,5,16,2,46,30,13,13,5,61,0,1,29,38,0.523077,0.476923,4,6
2023021283,2024-04-14,2,STL,4,1,SEA,20,12,14,4,50,17,15,19,1,52,20,12,14,4,50,17,15,19,1,52,0,1,28,20,0.58,0.42,6,2
2023021284,2024-04-14,2,VGK,4,3,COL,23,11,17,2,53,19,8,10,3,40,23,11,17,2,53,19,8,10,3,40,0,1,30,24,0.683333,0.316667,4,8
2023021285,2024-04-14,2,CHI,2,4,CAR,12,5,7,2,26,28,18,17,2,65,12,5,7,2,26,28,18,17,2,65,1,0,16,34,0.566038,0.433962,6,6
2023021286,2024-04-14,2,CGY,6,5,ARI,23,7,10,5,45,27,12,19,4,62,23,7,10,5,45,27,12,19,4,62,0,1,31,35,0.606061,0.393939,11,11
2023021287,2024-04-15,2,DET,5,4,MTL,25,18,35,5,83,17,7,11,4,39,24,15,34,4,77,14,7,9,4,34,0,1,35,21,0.480769,0.519231,0,2
2023021288,2024-04-15,2,NJD,1,4,NYI,20,6,20,1,47,14,11,9,3,37,20,6,20,1,47,14,11,9,3,37,0,1,24,19,0.52,0.48,2,6
2023021289,2024-04-15,2,PIT,4,2,NSH,24,15,17,3,59,28,11,14,2,55,23,15,17,3,58,27,11,13,2,53,1,0,38,30,0.6,0.4,4,20
2023021290,2024-04-15,2,TBL,2,4,BUF,28,14,10,2,54,25,10,11,3,49,28,14,10,2,54,25,10,11,3,49,0,1,33,34,0.540984,0.459016,4,4
2023021291,2024-04-15,2,WSH,2,0,BOS,22,21,13,2,58,16,8,13,0,37,22,21,13,2,58,16,8,13,0,37,1,0,25,16,0.444444,0.555556,0,2
2023021292,2024-04-15,2,NYR,4,0,OTT,22,10,11,3,46,23,11,20,0,54,22,10,11,3,46,23,11,20,0,54,1,0,34,25,0.469388,0.530612,4,6
2023021293,2024-04-15,2,EDM,9,2,SJS,30,18,19,9,76,18,10,9,2,39,30,18,19,9,76,18,10,9,2,39,1,0,38,21,0.584906,0.415094,2,0
2023021294,2024-04-15,2,LAK,1,3,MIN,20,11,17,1,49,22,9,15,2,48,20,11,17,1,49,22,9,15,2,48,0,1,24,28,0.44,0.56,6,8
2023021295,2024-04-16,2,BOS,1,3,OTT,29,10,15,0,54,17,5,9,2,33,26,10,15,0,51,17,5,9,2,33,0,1,35,20,0.651163,0.348837,6,6
2023021296,2024-04-16,2,CBJ,6,3,CAR,15,6,11,6,38,22,15,10,2,49,15,6,11,6,38,22,15,10,2,49,1,0,25,41,0.5,0.5,10,4
2023021297,2024-04-16,2,FLA,5,2,TOR,19,4,8,5,36,21,10,12,1,44,19,4,8,5,36,21,10,12,1,44,0,1,42,26,0.5625,0.4375,14,16
2023021298,2024-04-16,2,MTL,4,5,DET,27,11,10,4,52,37,14,16,5,72,23,10,9,4,46,33,14,15,4,66,1,0,33,40,0.54902,0.45098,0,6
2023021299,2024-04-16,2,PHI,1,2,WSH,25,15,33,1,74,15,11,27,2,55,25,15,33,1,74,15,11,27,2,55,0,1,28,18,0.482759,0.517241,0,2
2023021300,2024-04-16,2,WPG,4,3,SEA,19,9,6,3,37,17,7,15,3,42,19,9,6,3,37,17,7,15,3,42,1,0,24,23,0.6,0.4,2,8
2023021301,2024-04-16,2,VGK,3,1,CHI,31,12,19,3,65,22,9,11,1,43,31,12,19,3,65,22,9,11,1,43,1,0,37,23,0.701754,0.298246,2,2
2023021302,2024-04-16,2,VAN,4,1,CGY,23,13,10,3,49,35,9,15,1,60,22,13,10,3,48,35,9,14,1,59,1,0,31,40,0.473684,0.526316,20,20
2023021303,2024-04-17,2,NYI,5,4,PIT,21,15,12,3,51,38,14,24,2,78,21,15,12,3,51,37,14,24,2,77,1,0,32,44,0.408451,0.591549,4,6
2023021304,2024-04-17,2,TBL,6,4,TOR,22,10,12,5,49,25,11,14,4,54,22,10,12,5,49,25,11,14,4,54,1,0,32,38,0.54902,0.45098,8,10
2023021305,2024-04-17,2,DAL,2,1,STL,30,20,17,2,69,23,11,10,1,45,27,20,17,1,65,19,10,10,1,40,0,1,37,26,0.612245,0.387755,2,6
2023021306,2024-04-17,2,ARI,5,2,EDM,17,7,6,4,34,25,16,14,2,57,17,7,6,4,34,25,16,14,2,57,1,0,24,30,0.383333,0.616667,4,4
2023021307,2024-04-18,2,MIN,3,4,SEA,15,8,12,1,36,16,14,17,1,48,15,8,12,1,36,16,14,17,1,48,1,0,24,27,0.411765,0.588235,6,8
2023021308,2024-04-18,2,WPG,4,2,VAN,13,10,8,4,35,15,8,19,1,43,13,10,8,4,35,15,8,19,1,43,0,1,26,20,0.5,0.5,8,10
2023021309,2024-04-18,2,CGY,5,1,SJS,28,16,16,5,65,14,19,13,0,46,28,16,16,5,65,14,19,13,0,46,1,0,37,17,0.418605,0.581395,11,9
2023021310,2024-04-18,2,COL,5,1,EDM,15,13,17,4,49,23,12,12,0,47,15,13,17,4,49,23,12,12,0,47,1,0,27,26,0.327273,0.672727,4,8
2023021311,2024-04-18,2,VGK,1,4,ANA,24,11,19,0,54,17,8,14,2,41,24,11,19,0,54,17,8,14,2,41,0,1,33,23,0.622222,0.377778,2,6
2023021312,2024-04-18,2,LAK,5,4,CHI,28,21,11,3,63,7,6,6,3,22,28,21,11,2,62,7,6,6,3,22,0,1,35,13,0.638298,0.361702,2,8
2023030111,2024-04-21,3,FLA,3,2,TBL,21,9,20,2,52,14,23,13,1,51,21,9,20,2,52,14,23,13,1,51,1,0,28,19,0.538462,0.461538,4,6
2023030112,2024-04-23,3,FLA,3,2,TBL,28,12,19,2,61,15,10,11,1,37,27,10,18,2,57,14,10,10,1,35,1,0,37,23,0.565217,0.434783,12,8
2023030113,2024-04-25,3,TBL,3,5,FLA,22,14,18,3,57,23,11,14,5,53,21,12,18,3,54,22,10,14,5,51,0,1,29,31,0.559322,0.440678,2,10
2023030114,2024-04-27,3,TBL,6,3,FLA,20,16,15,3,54,20,11,18,3,52,17,16,14,1,48,20,11,17,3,51,1,0,32,25,0.542373,0.457627,8,16
2023030115,2024-04-29,3,FLA,6,1,TBL,20,7,11,5,43,29,16,18,1,64,17,6,11,4,38,29,16,17,1,63,1,0,39,32,0.54386,0.45614,8,10
2023030121,2024-04-20,3,BOS,5,1,TOR,14,5,11,3,33,28,14,10,1,53,14,5,11,3,33,28,14,10,1,53,1,0,25,36,0.574074,0.425926,8,12
2023030122,2024-04-22,3,BOS,2,3,TOR,26,14,10,1,51,23,11,17,2,53,23,12,10,1,46,23,11,16,2,52,1,0,29,34,0.454545,0.545455,10,10
2023030123,2024-04-24,3,TOR,2,4,BOS,22,7,17,2,48,23,9,20,2,54,22,7,17,2,48,21,9,20,2,52,1,0,30,34,0.553571,0.446429,6,10
2023030124,2024-04-27,3,TOR,1,3,BOS,21,13,24,1,59,14,14,4,2,34,20,13,23,1,57,14,14,4,2,34,0,1,25,22,0.607143,0.392857,8,8
2023030125,2024-04-30,3,BOS,1,2,TOR,26,16,9,1,52,25,13,20,2,60,24,15,9,1,49,25,12,20,2,59,0,1,28,33,0.377358,0.622642,10,6
2023030126,2024-05-02,3,TOR,2,1,BOS,21,11,11,2,45,21,18,27,1,67,21,11,11,2,45,21,18,27,1,67,1,0,26,23,0.62963,0.37037,2,6
2023030127,2024-05-04,3,BOS,2,1,TOR,27,16,22,2,67,24,9,19,1,53,27,16,22,2,67,24,9,19,1,53,0,1,32,31,0.447368,0.552632,2,4
2023030131,2024-04-21,3,NYR,4,1,WSH,21,15,16,4,56,17,7,15,1,40,20,15,15,4,54,17,7,15,1,40,1,0,31,21,0.548387,0.451613,20,26
2023030132,2024-04-23,3,NYR,4,3,WSH,15,9,13,1,38,20,11,18,1,50,15,9,13,1,38,20,11,18,1,50,0,1,28,25,0.584906,0.415094,10,12
2023030133,2024-04-26,3,WSH,1,3,NYR,20,4,16,1,41,13,8,13,1,35,20,4,16,1,41,13,8,13,1,35,1,0,30,22,0.411765,0.588235,10,14
2023030134,2024-04-28,3,WSH,2,4,NYR,20,15,23,2,60,18,10,14,1,43,20,15,23,2,60,18,10,14,1,43,0,1,25,23,0.5,0.5,8,4
2023030141,2024-04-20,3,CAR,3,1,NYI,21,23,20,2,66,29,9,12,1,51,21,23,20,2,66,29,9,12,1,51,1,0,26,34,0.586207,0.413793,4,6
2023030142,2024-04-22,3,CAR,5,3,NYI,31,25,33,4,93,8,8,7,2,25,31,24,32,4,91,5,7,7,1,20,0,1,39,12,0.594203,0.405797,43,83
2023030143,2024-04-25,3,NYI,2,3,CAR,27,15,17,2,61,17,17,22,3,59,25,15,17,2,59,16,16,21,3,56,0,1,31,22,0.604167,0.395833,4,4
2023030144,2024-04-27,3,NYI,3,2,CAR,28,23,16,2,69,40,24,19,0,83,28,23,16,2,69,40,24,19,0,83,0,1,35,44,0.676056,0.323944,12,8
2023030145,2024-04-30,3,CAR,6,3,NYI,27,15,18,5,65,17,18,13,2,50,27,15,18,4,64,17,18,13,2,50,1,0,38,24,0.594203,0.405797,8,2
2023030151,2024-04-22,3,DAL,3,4,VGK,22,12,20,3,57,11,15,17,2,45,22,12,20,3,57,11,15,17,2,45,0,1,29,15,0.55,0.45,4,4
2023030152,2024-04-24,3,DAL,1,3,VGK,20,27,18,0,65,20,13,18,3,54,17,26,18,0,61,15,13,16,3,47,1,0,21,26,0.514286,0.485714,6,6
2023030153,2024-04-27,3,VGK,2,3,DAL,31,6,26,1,64,36,28,32,3,99,30,6,26,0,62,36,28,32,3,99,0,1,34,46,0.493506,0.506494,6,4
2023030154,2024-04-29,3,VGK,2,4,DAL,31,21,22,2,76,19,14,13,3,49,31,21,22,2,76,19,14,13,3,49,1,0,34,32,0.470588,0.529412,6,4
2023030155,2024-05-01,3,DAL,3,2,VGK,16,11,15,1,43,22,13,16,1,52,16,11,15,1,43,22,13,16,1,52,0,1,25,27,0.553191,0.446809,6,8
2023030156,2024-05-03,3,VGK,2,0,DAL,26,15,20,2,63,20,12,18,0,50,26,15,20,2,63,20,12,18,0,50,1,0,30,23,0.538462,0.461538,2,4
2023030157,2024-05-05,3,DAL,2,1,VGK,22,17,20,2,61,20,13,22,1,56,22,17,20,2,61,20,13,22,1,56,1,0,24,23,0.490566,0.509434,2,2
2023030161,2024-04-21,3,WPG,7,6,COL,13,11,10,6,40,38,15,27,4,84,13,10,10,6,39,38,14,26,4,82,0,1,23,46,0.551724,0.448276,6,6
2023030162,2024-04-23,3,WPG,2,5,COL,25,11,14,2,52,20,16,17,5,58,24,10,13,2,49,19,16,17,5,57,1,0,30,32,0.519231,0.480769,10,10
2023030163,2024-04-26,3,COL,6,2,WPG,25,7,17,3,52,21,17,16,1,55,25,7,17,3,52,21,17,16,1,55,1,0,40,24,0.393443,0.606557,15,23
2023030164,2024-04-28,3,COL,5,1,WPG,29,10,14,3,56,22,14,17,1,54,29,10,14,3,56,22,14,17,1,54,1,0,35,27,0.5,0.5,8,8
2023030165,2024-04-30,3,WPG,3,6,COL,31,12,25,2,70,25,8,21,6,60,31,12,25,2,70,25,8,21,6,60,1,0,36,32,0.597015,0.402985,2,4
2023030171,2024-04-21,3,VAN,4,2,NSH,15,17,12,4,48,18,11,11,1,41,15,17,12,4,48,18,11,11,1,41,0,1,21,24,0.5625,0.4375,8,4
2023030172,2024-04-23,3,VAN,1,4,NSH,13,30,20,1,64,7,7,5,4,23,13,30,20,1,64,7,7,5,4,23,0,1,18,16,0.58,0.42,8,8
2023030173,2024-04-26,3,NSH,1,2,VAN,25,6,23,1,55,8,9,10,0,27,25,6,23,1,55,7,9,9,0,25,0,1,30,12,0.633333,0.366667,10,14
2023030174,2024-04-28,3,NSH,3,4,VAN,26,12,12,3,53,15,14,11,4,44,23,11,11,1,46,13,14,11,4,42,0,1,30,21,0.444444,0.555556,6,6
2023030175,2024-04-30,3,VAN,1,2,NSH,19,17,16,1,53,19,10,18,1,48,19,17,16,1,53,19,10,18,1,48,1,0,20,22,0.385965,0.614035,8,4
2023030176,2024-05-03,3,NSH,0,1,VAN,23,18,11,0,52,27,7,24,1,59,22,18,11,0,51,27,7,24,1,59,0,1,28,29,0.440678,0.559322,2,8
2023030181,2024-04-22,3,EDM,7,4,LAK,30,12,13,4,59,28,11,21,4,64,30,12,13,4,59,28,11,21,4,64,1,0,45,37,0.555556,0.444444,4,8
2023030182,2024-04-24,3,EDM,4,5,LAK,17,10,21,3,51,17,12,21,5,55,17,10,21,3,51,17,12,21,5,55,0,1,31,26,0.508197,0.491803,6,6
2023030183,2024-04-26,3,LAK,1,6,EDM,19,13,14,1,47,21,3,10,3,37,18,13,14,1,46,22,3,10,3,38,0,1,28,40,0.491803,0.508197,47,45
2023030184,2024-04-28,3,LAK,0,1,EDM,33,22,19,0,74,12,7,15,0,34,33,22,19,0,74,12,7,15,0,34,0,1,33,13,0.458333,0.541667,2,2
2023030185,2024-05-01,3,EDM,4,3,LAK,14,7,8,3,32,16,10,24,3,53,14,7,8,3,32,16,10,24,3,53,1,0,26,21,0.413793,0.586207,4,12
2023030211,2024-05-06,3,FLA,1,5,BOS,32,12,26,1,71,21,12,10,5,48,32,12,26,1,71,21,12,10,5,48,1,0,39,29,0.586667,0.413333,24,18
2023030212,2024-05-08,3,FLA,6,1,BOS,19,13,15,4,51,10,5,11,1,27,19,13,15,4,51,10,5,10,1,26,0,1,33,15,0.481481,0.518519,71,77
2023030213,2024-05-10,3,BOS,2,6,FLA,10,10,13,2,35,19,11,13,2,45,10,10,13,2,35,19,11,13,2,45,0,1,17,33,0.47619,0.52381,12,4
2023030214,2024-05-12,3,BOS,2,3,FLA,12,10,8,1,31,26,16,10,2,54,12,10,8,1,31,26,16,10,2,54,1,0,18,41,0.491525,0.508475,12,8
2023030215,2024-05-14,3,FLA,1,2,BOS,19,8,23,1,51,21,9,10,2,42,19,8,22,1,50,21,8,10,2,41,0,1,29,28,0.53125,0.46875,8,10
2023030216,2024-05-17,3,BOS,1,2,FLA,22,6,19,1,48,22,15,19,2,58,20,6,18,1,45,21,15,18,2,56,1,0,23,28,0.615385,0.384615,8,6
2023030221,2024-05-05,3,NYR,4,3,CAR,17,8,13,2,40,18,16,27,3,64,17,8,12,2,39,17,16,27,3,63,1,0,23,25,0.469388,0.530612,12,8
2023030222,2024-05-07,3,NYR,4,3,CAR,29,11,36,2,78,43,24,26,3,96,26,11,36,2,75,42,22,26,2,92,1,0,39,57,0.468085,0.531915,12,16
2023030223,2024-05-09,3,CAR,2,3,NYR,32,17,14,2,65,15,12,7,2,36,30,17,14,2,63,14,12,5,2,33,1,0,47,25,0.609375,0.390625,14,16
2023030224,2024-05-11,3,CAR,4,3,NYR,26,20,14,3,63,20,17,16,3,56,25,20,14,3,62,20,17,15,3,55,1,0,31,25,0.511111,0.488889,4,6
2023030225,2024-05-13,3,NYR,1,4,CAR,15,8,20,0,43,21,13,21,4,59,15,8,20,0,43,21,13,21,4,59,1,0,21,28,0.666667,0.333333,6,6
2023030226,2024-05-16,3,CAR,3,5,NYR,31,13,14,2,60,19,24,17,4,64,31,13,14,2,60,19,24,17,4,64,1,0,36,24,0.5,0.5,4,2
2023030231,2024-05-07,3,DAL,3,4,COL,14,13,23,2,52,20,16,26,2,64,14,12,22,2,50,20,16,26,2,64,1,0,22,26,0.597015,0.402985,6,10
2023030232,2024-05-09,3,DAL,5,3,COL,20,9,23,2,54,23,8,15,3,49,19,9,22,2,52,22,8,15,3,48,1,0,32,31,0.492754,0.507246,8,12
2023030233,2024-05-11,3,COL,1,4,DAL,24,16,19,1,60,15,7,13,4,39,22,16,19,1,58,15,7,12,4,38,0,1,29,23,0.5,0.5,8,10
2023030234,2024-05-13,3,COL,1,5,DAL,24,16,26,1,67,20,13,11,3,47,24,14,26,1,65,18,13,11,3,45,0,1,25,34,0.507937,0.492063,6,6
2023030235,2024-05-15,3,DAL,3,5,COL,18,17,7,2,44,22,15,14,3,54,18,17,7,2,44,22,15,14,3,54,1,0,26,27,0.547945,0.452055,6,8
2023030236,2024-05-17,3,COL,1,2,DAL,29,18,36,0,83,33,26,35,2,96,29,18,36,0,83,33,26,35,2,96,1,0,30,38,0.465753,0.534247,2,2
2023030241,2024-05-08,3,VAN,5,4,EDM,15,15,9,5,44,12,13,13,3,41,15,15,9,4,43,12,12,13,3,40,0,1,24,18,0.634615,0.365385,4,8
2023030242,2024-05-10,3,VAN,3,4,EDM,16,10,8,2,36,24,19,18,3,64,15,10,7,1,33,24,18,18,2,62,1,0,19,31,0.522388,0.477612,10,10
2023030243,2024-05-12,3,EDM,3,4,VAN,33,15,22,1,71,11,9,5,2,27,30,14,22,1,67,11,9,5,2,27,1,0,45,18,0.424242,0.575758,8,12
2023030244,2024-05-14,3,EDM,3,2,VAN,22,12,16,2,52,15,17,18,2,52,22,12,16,2,52,15,17,18,2,52,1,0,30,21,0.468085,0.531915,6,4
2023030245,2024-05-16,3,VAN,3,2,EDM,23,12,14,3,52,18,13,15,2,48,19,10,12,3,44,17,13,13,2,45,0,1,35,23,0.571429,0.428571,12,10
2023030246,2024-05-18,3,EDM,5,1,VAN,19,15,15,5,54,12,20,10,1,43,19,15,15,5,54,12,20,10,1,43,1,0,27,15,0.483333,0.516667,30,28
2023030247,2024-05-20,3,VAN,2,3,EDM,11,19,22,2,54,17,7,7,2,33,11,19,22,2,54,17,7,7,2,33,0,1,17,29,0.553571,0.446429,4,6
2023030311,2024-05-22,3,NYR,0,3,FLA,19,18,16,0,53,22,16,16,3,57,19,18,16,0,53,22,16,16,3,57,0,1,24,27,0.483333,0.516667,6,4
2023030312,2024-05-24,3,NYR,2,1,FLA,21,18,22,2,63,24,17,28,0,69,21,18,22,2,63,22,17,28,0,67,1,0,30,27,0.521739,0.478261,8,12
2023030313,2024-05-26,3,FLA,4,5,NYR,26,23,32,2,83,15,2,15,4,36,26,23,32,2,83,15,2,15,4,36,1,0,37,23,0.554217,0.445783,4,12
2023030314,2024-05-28,3,FLA,3,2,NYR,27,16,28,1,72,12,9,7,1,29,27,16,28,1,72,12,9,7,1,29,0,1,40,23,0.523077,0.476923,6,8
2023030315,2024-05-30,3,NYR,2,3,FLA,20,19,16,1,56,29,13,18,3,63,20,19,16,1,56,29,13,18,3,63,1,0,27,37,0.603448,0.396552,8,8
2023030316,2024-06-01,3,FLA,2,1,NYR,29,9,13,2,53,22,25,24,1,72,29,9,13,2,53,22,25,24,1,72,1,0,34,24,0.528302,0.471698,2,2
2023030321,2024-05-23,3,DAL,2,3,EDM,23,13,22,2,60,29,18,27,3,77,23,13,22,2,60,29,18,27,3,77,0,1,33,38,0.556962,0.443038,2,10
2023030322,2024-05-25,3,DAL,3,1,EDM,20,13,11,3,47,28,12,19,1,60,20,13,11,3,47,28,12,19,1,60,1,0,25,29,0.490909,0.509091,4,4
2023030323,2024-05-27,3,EDM,3,5,DAL,21,17,21,3,62,17,10,16,5,48,20,17,21,3,61,17,10,16,5,48,1,0,30,22,0.482143,0.517857,4,6
2023030324,2024-05-29,3,EDM,5,2,DAL,20,13,14,4,51,18,9,17,2,46,20,13,14,4,51,18,9,17,2,46,0,1,29,22,0.52459,0.47541,4,2
2023030325,2024-05-31,3,DAL,1,3,EDM,15,13,22,1,51,21,15,23,1,60,15,13,22,1,51,21,15,23,1,60,0,1,20,26,0.509804,0.490196,6,4
2023030326,2024-06-02,3,EDM,2,1,DAL,8,5,8,0,21,29,16,18,1,64,8,5,8,0,21,29,16,18,1,64,1,0,10,34,0.433962,0.566038,6,4
2023030411,2024-06-08,3,FLA,3,0,EDM,14,8,13,3,38,26,14,15,0,55,14,8,13,3,38,26,14,15,0,55,1,0,18,32,0.596491,0.403509,10,8
2023030412,2024-06-10,3,FLA,4,1,EDM,20,9,15,3,47,17,6,13,1,37,18,4,15,3,40,14,5,13,0,32,0,1,29,19,0.544118,0.455882,12,45
2023030413,2024-06-13,3,EDM,3,4,FLA,25,12,11,3,51,19,13,11,4,47,24,11,11,3,49,18,12,11,3,44,0,1,35,23,0.47541,0.52459,6,10
2023030414,2024-06-15,3,EDM,8,1,FLA,15,7,10,6,38,20,13,24,1,58,15,7,10,6,38,20,13,24,1,58,1,0,35,33,0.532258,0.467742,8,12
2023030415,2024-06-18,3,FLA,3,5,EDM,27,16,21,3,67,15,2,8,2,27,24,16,18,3,61,13,2,7,2,24,0,1,32,24,0.596774,0.403226,12,8
2023030416,2024-06-21,3,EDM,5,1,FLA,12,12,10,5,39,16,10,19,1,46,11,12,10,5,38,15,10,16,1,42,1,0,21,21,0.526316,0.473684,18,16
2023030417,2024-06-24,3,FLA,2,1,EDM,16,16,14,2,48,21,14,16,1,52,16,16,14,2,48,21,14,16,1,52,1,0,21,24,0.474576,0.525424,2,4
