gameId,gameDate,gameType,Team Home,Score Home,Score Away,Team Away,Shot Home EV,Miss Home EV,Block Home EV,Goal Home EV,CF EV,Shot Away EV,Miss Away EV,Block Away EV,Goal Away EV,CA EV,Shot Home 5v5,Miss Home 5v5,Block Home 5v5,Goal Home 5V5,CF 5v5,Shot Away 5v5,Miss Away 5v5,Block Away 5v5,Goal Away 5v5,CA 5v5,First Goal Home,First Goal Away,SOG Home,SOG Away,Faceoff Home,Faceoff Away,Pim Home,Pim Away
2021020001,2021-10-12,2,TBL,2,6,PIT,25,11,14,2,52,29,12,10,6,57,25,11,14,2,52,29,12,10,6,57,0,1,28,35,0.507246,0.492754,2,2
2021020002,2021-10-12,2,VGK,4,3,SEA,18,13,11,4,46,25,13,15,3,56,18,13,11,4,46,24,13,15,3,55,1,0,30,31,0.52,0.48,8,8
2021020003,2021-10-13,2,TOR,2,1,MTL,23,19,11,1,54,24,6,11,1,42,23,19,11,1,54,24,6,11,1,42,0,1,30,32,0.58209,0.41791,8,6
2021020004,2021-10-13,2,WSH,5,1,NYR,16,10,7,1,34,15,8,12,0,35,16,10,6,1,33,12,8,12,0,32,1,0,27,24,0.392157,0.607843,16,18
2021020005,2021-10-13,2,COL,4,2,CHI,25,12,18,4,59,25,6,14,1,46,23,10,17,4,54,23,6,14,1,44,1,0,36,34,0.436364,0.563636,12,12
2021020006,2021-10-13,2,EDM,3,2,VAN,27,9,16,1,53,27,4,11,1,43,27,6,16,1,50,24,4,10,1,39,1,0,34,38,0.641509,0.358491,25,11
2021020007,2021-10-14,2,BUF,5,1,MTL,20,12,6,2,40,21,4,10,1,36,20,12,6,2,40,21,4,10,1,36,1,0,36,31,0.52459,0.47541,8,12
2021020008,2021-10-14,2,OTT,3,2,TOR,29,12,14,2,57,35,8,11,0,54,29,12,13,2,56,33,8,10,0,51,1,0,36,48,0.457627,0.542373,10,8
2021020009,2021-10-14,2,DET,6,7,TBL,14,4,6,5,29,29,8,7,4,48,12,3,5,4,24,27,7,6,3,43,1,0,26,48,0.464286,0.535714,26,20
2021020010,2021-10-14,2,FLA,5,4,PIT,28,8,10,5,51,24,11,15,2,52,25,7,9,4,45,22,9,13,2,46,1,0,39,47,0.542857,0.457143,18,12
2021020011,2021-10-14,2,NYR,2,3,DAL,24,14,18,2,58,19,9,11,2,41,24,13,18,2,57,18,9,11,1,39,0,1,33,26,0.5,0.5,6,10
2021020012,2021-10-14,2,CAR,6,3,NYI,27,12,19,4,62,23,10,10,3,46,26,12,19,4,61,21,10,10,3,44,0,1,41,28,0.552239,0.447761,6,10
2021020013,2021-10-14,2,CBJ,8,2,ARI,17,7,8,6,38,31,16,16,1,64,17,7,7,5,36,31,16,16,1,64,1,0,26,38,0.55,0.45,22,20
2021020014,2021-10-14,2,NSH,3,4,SEA,21,6,12,2,41,21,3,11,2,37,21,6,11,2,40,20,3,9,2,34,1,0,30,26,0.557143,0.442857,11,11
2021020015,2021-10-13,2,ANA,4,1,WPG,10,7,3,2,22,20,12,11,1,44,10,7,3,2,22,18,12,10,1,41,1,0,22,34,0.471698,0.528302,24,14
2021020016,2021-10-14,2,LAK,6,2,VGK,39,15,20,4,78,22,6,11,2,41,39,15,20,4,78,22,6,11,2,41,0,1,47,25,0.492308,0.507692,7,9
2021020017,2021-10-15,2,NJD,4,3,CHI,21,14,7,4,46,18,8,12,1,39,21,14,7,3,45,18,8,11,1,38,1,0,29,27,0.482143,0.517857,10,4
2021020018,2021-10-15,2,PHI,4,5,VAN,23,13,13,3,52,32,5,15,4,56,20,12,12,3,47,26,5,14,2,47,1,0,35,39,0.625,0.375,8,6
2021020019,2021-10-15,2,ANA,1,2,MIN,17,9,10,0,36,32,15,13,1,61,17,9,10,0,36,32,15,13,1,61,1,0,29,43,0.538462,0.461538,25,23
2021020020,2021-10-16,2,BOS,3,1,DAL,31,6,6,3,46,15,8,4,1,28,31,6,6,2,45,15,7,3,1,26,1,0,40,28,0.467742,0.532258,14,8
2021020021,2021-10-16,2,BUF,2,1,ARI,30,9,9,2,50,17,8,7,2,34,28,7,9,0,44,14,7,6,1,28,0,1,33,21,0.575,0.425,4,4
2021020022,2021-10-16,2,TOR,3,1,OTT,17,16,18,3,54,19,14,9,0,42,17,16,18,3,54,19,14,9,0,42,1,0,29,21,0.649123,0.350877,4,6
2021020023,2021-10-16,2,MTL,1,3,NYR,24,5,14,1,44,17,7,9,2,35,24,5,14,1,44,17,7,9,2,35,0,1,32,24,0.607143,0.392857,8,6
2021020024,2021-10-16,2,DET,3,1,VAN,16,2,10,2,30,35,11,19,1,66,13,2,9,2,26,30,10,14,1,55,1,0,21,41,0.548387,0.451613,26,24
2021020025,2021-10-16,2,FLA,5,1,NYI,24,14,21,5,64,21,10,10,0,41,22,14,21,5,62,20,9,10,0,39,1,0,29,30,0.433333,0.566667,12,6
2021020026,2021-10-16,2,PIT,5,2,CHI,19,7,8,5,39,12,5,13,1,31,19,7,8,5,39,12,5,13,1,31,1,0,26,20,0.459459,0.540541,8,6
2021020027,2021-10-16,2,WSH,1,2,TBL,25,7,13,1,46,22,14,16,2,54,24,5,12,1,42,21,13,16,1,51,1,0,33,24,0.482143,0.517857,2,8
2021020028,2021-10-16,2,CBJ,2,1,SEA,23,12,21,2,58,19,11,15,1,46,22,12,19,1,54,18,11,14,1,44,0,1,25,20,0.537037,0.462963,2,0
2021020029,2021-10-16,2,NSH,2,3,CAR,26,6,10,2,44,25,11,7,3,46,26,6,10,2,44,25,11,7,3,46,0,1,40,32,0.5,0.5,8,8
2021020030,2021-10-16,2,COL,3,5,STL,25,16,15,3,59,18,7,8,4,37,25,15,15,2,57,18,7,8,4,37,0,1,32,28,0.515625,0.484375,9,11
2021020031,2021-10-16,2,EDM,5,2,CGY,22,7,4,3,36,33,11,12,1,57,18,6,4,3,31,31,11,11,1,54,1,0,33,47,0.507246,0.492754,12,10
2021020032,2021-10-16,2,LAK,2,3,MIN,25,10,13,1,49,24,7,5,3,39,25,10,13,1,49,24,7,5,3,39,1,0,31,30,0.510204,0.489796,4,10
2021020033,2021-10-16,2,SJS,4,3,WPG,18,10,12,1,41,16,6,19,2,43,17,9,11,1,38,15,6,19,2,42,0,1,31,23,0.588235,0.411765,13,17
2021020034,2021-10-17,2,OTT,3,2,DAL,22,9,11,1,43,30,9,16,2,57,22,9,11,1,43,30,9,16,2,57,0,1,27,34,0.438596,0.561404,9,11
2021020035,2021-10-18,2,TOR,1,2,NYR,32,15,10,1,58,19,11,11,2,43,28,13,10,1,52,16,11,10,1,38,0,1,41,23,0.759259,0.240741,6,6
2021020036,2021-10-18,2,PHI,6,1,SEA,20,8,6,6,40,17,5,7,1,30,19,7,6,6,38,17,5,5,1,28,1,0,27,24,0.615385,0.384615,40,46
2021020037,2021-10-18,2,CGY,2,3,ANA,34,11,14,2,61,23,14,5,2,44,33,11,14,2,60,21,12,4,1,38,1,0,43,27,0.538462,0.461538,9,11
2021020038,2021-10-18,2,ARI,4,7,STL,15,13,5,3,36,20,8,6,6,40,15,13,5,3,36,19,8,6,6,39,1,0,26,33,0.509091,0.490909,18,16
2021020039,2021-10-19,2,BUF,5,2,VAN,27,7,8,5,47,26,2,5,2,35,27,7,8,5,47,26,2,5,2,35,0,1,43,34,0.520833,0.479167,6,6
2021020040,2021-10-19,2,MTL,0,5,SJS,16,12,15,0,43,13,5,9,3,30,16,12,15,0,43,13,5,9,3,30,0,1,21,25,0.38,0.62,10,6
2021020041,2021-10-19,2,DET,4,1,CBJ,35,9,5,4,53,20,12,7,0,39,35,9,4,4,52,20,12,7,0,39,1,0,45,23,0.492063,0.507937,8,8
2021020042,2021-10-19,2,TBL,1,4,FLA,21,8,6,1,36,22,6,11,3,42,21,8,6,1,36,22,6,11,3,42,0,1,31,32,0.609375,0.390625,6,12
2021020043,2021-10-19,2,NJD,4,2,SEA,23,10,7,4,44,21,10,12,1,44,23,10,7,4,44,21,9,12,1,43,1,0,33,29,0.487179,0.512821,35,41
2021020044,2021-10-19,2,PIT,1,2,DAL,29,13,16,2,60,29,7,8,3,47,21,12,15,1,49,22,5,8,1,36,0,1,28,29,0.416667,0.583333,2,2
2021020045,2021-10-19,2,WSH,6,3,COL,28,11,11,6,56,17,6,10,1,34,27,11,11,6,55,16,4,10,1,31,1,0,40,27,0.551724,0.448276,10,8
2021020046,2021-10-19,2,CHI,1,4,NYI,30,8,16,1,55,18,7,11,4,40,30,8,16,1,55,18,7,11,4,40,0,1,40,29,0.428571,0.571429,9,11
2021020047,2021-10-19,2,NSH,2,1,LAK,25,13,15,1,54,22,8,11,1,42,24,13,15,1,53,22,8,11,1,42,0,1,31,26,0.596491,0.403509,4,4
2021020048,2021-10-19,2,MIN,6,5,WPG,34,7,15,3,59,19,7,17,3,46,32,7,15,3,57,16,7,15,3,41,0,1,44,30,0.606557,0.393443,19,17
2021020049,2021-10-19,2,EDM,6,5,ANA,25,8,13,4,50,28,9,16,5,58,24,8,12,4,48,27,9,15,5,56,0,1,37,36,0.580645,0.419355,4,12
2021020050,2021-10-20,2,PHI,6,3,BOS,18,5,15,4,42,35,9,22,3,69,18,5,15,4,42,35,9,22,3,69,1,0,25,40,0.52,0.48,2,4
2021020051,2021-10-20,2,VGK,1,3,STL,39,8,12,1,60,30,6,16,3,55,38,8,12,1,59,30,5,14,3,52,1,0,43,38,0.418182,0.581818,6,4
2021020052,2021-10-21,2,MTL,1,4,CAR,22,9,16,0,47,27,11,6,3,47,22,9,16,0,47,25,10,6,3,44,0,1,28,33,0.44898,0.55102,4,12
2021020053,2021-10-21,2,OTT,1,2,SJS,25,19,18,1,63,18,7,16,1,42,18,19,17,1,55,18,5,15,1,39,1,0,31,24,0.527273,0.472727,10,10
2021020054,2021-10-21,2,DET,0,3,CGY,32,12,6,0,50,23,6,12,3,44,32,12,6,0,50,23,6,12,3,44,0,1,33,29,0.489362,0.510638,9,11
2021020055,2021-10-21,2,FLA,4,1,COL,27,7,15,3,52,30,2,12,1,45,26,7,15,3,51,29,2,12,1,44,1,0,38,31,0.596774,0.403226,6,10
2021020056,2021-10-21,2,NJD,1,4,WSH,23,10,14,0,47,21,13,9,4,47,22,10,13,0,45,20,13,9,4,46,0,1,26,27,0.4375,0.5625,8,4
2021020057,2021-10-21,2,CBJ,3,2,NYI,24,8,10,2,44,28,11,10,2,51,23,7,10,1,41,26,10,10,2,48,0,1,32,36,0.5,0.5,6,8
2021020058,2021-10-21,2,CHI,1,4,VAN,21,7,13,0,41,13,10,11,3,37,21,7,13,0,41,13,10,11,3,37,0,1,30,25,0.448276,0.551724,13,13
2021020059,2021-10-21,2,NSH,1,3,NYR,23,10,8,1,42,18,12,4,3,37,23,10,8,1,42,18,12,4,3,37,0,1,29,30,0.546875,0.453125,10,8
2021020060,2021-10-21,2,WPG,5,1,ANA,17,9,11,4,41,33,6,13,0,52,17,9,11,4,41,33,6,13,0,52,0,1,27,39,0.48,0.52,6,4
2021020061,2021-10-21,2,ARI,1,5,EDM,24,7,8,1,40,22,13,14,2,51,24,7,8,1,40,22,13,14,2,51,0,1,28,31,0.436364,0.563636,4,18
2021020062,2021-10-22,2,BUF,1,4,BOS,30,10,19,1,60,19,6,6,3,34,30,10,19,1,60,19,6,6,3,34,0,1,36,26,0.369565,0.630435,4,8
2021020063,2021-10-22,2,TOR,3,5,SJS,25,15,15,3,58,22,6,9,5,42,25,15,15,3,58,22,6,9,5,42,0,1,33,31,0.52381,0.47619,6,4
2021020064,2021-10-22,2,DAL,3,2,LAK,14,10,13,1,38,31,10,15,1,57,10,9,11,0,30,25,8,14,1,48,0,1,23,45,0.466667,0.533333,23,10
2021020065,2021-10-22,2,VGK,3,5,EDM,31,15,13,3,62,19,8,11,4,42,31,15,13,3,62,19,8,11,4,42,1,0,39,33,0.462687,0.537313,6,6
2021020066,2021-10-23,2,MTL,6,1,DET,16,11,22,5,54,20,7,14,0,41,16,11,22,5,54,20,7,14,0,41,0,1,24,27,0.479167,0.520833,6,8
2021020067,2021-10-23,2,OTT,2,3,NYR,24,9,12,2,47,14,8,15,2,39,22,9,12,1,44,13,8,15,1,37,1,0,28,26,0.6,0.4,20,20
2021020068,2021-10-23,2,TBL,3,4,COL,23,17,6,5,51,18,9,8,5,40,21,11,4,3,39,12,7,7,2,28,0,1,32,27,0.523077,0.476923,14,8
2021020069,2021-10-23,2,NJD,2,1,BUF,35,16,13,1,65,24,9,8,0,41,33,15,13,0,61,24,8,7,0,39,0,1,39,25,0.66,0.34,6,8
2021020070,2021-10-23,2,PHI,2,4,FLA,21,8,11,0,40,22,16,9,2,49,21,8,11,0,40,22,16,8,2,48,0,1,29,31,0.587302,0.412698,14,8
2021020071,2021-10-23,2,PIT,7,1,TOR,20,5,6,6,37,20,9,15,1,45,20,5,6,6,37,20,9,15,1,45,1,0,33,29,0.639344,0.360656,13,17
2021020072,2021-10-23,2,WSH,3,4,CGY,18,11,18,2,49,19,8,17,2,46,15,11,17,2,45,18,8,17,1,44,0,1,25,27,0.491525,0.508475,6,8
2021020073,2021-10-23,2,CBJ,1,5,CAR,21,8,12,0,41,20,7,9,2,38,21,8,12,0,41,20,7,9,2,38,0,1,28,33,0.436364,0.563636,12,8
2021020074,2021-10-23,2,STL,7,3,LAK,24,7,12,2,45,27,11,5,3,46,22,7,11,2,42,27,10,3,3,43,0,1,40,35,0.530303,0.469697,8,14
2021020075,2021-10-23,2,MIN,4,3,ANA,24,5,17,4,50,17,7,16,2,42,20,5,17,2,44,14,6,12,2,34,0,1,36,24,0.5,0.5,10,12
2021020076,2021-10-23,2,WPG,6,4,NSH,19,8,11,4,42,19,18,17,2,56,19,8,11,4,42,19,18,17,2,56,0,1,29,30,0.627119,0.372881,13,11
2021020077,2021-10-23,2,ARI,0,3,NYI,25,12,16,0,53,20,9,14,2,45,24,12,15,0,51,20,9,12,2,43,0,1,26,24,0.464286,0.535714,9,7
2021020078,2021-10-23,2,SEA,2,4,VAN,25,17,7,2,51,19,13,13,3,48,25,16,7,2,50,19,13,13,3,48,1,0,31,26,0.389831,0.610169,8,4
2021020079,2021-10-24,2,BOS,4,3,SJS,25,12,6,3,46,17,6,11,3,37,24,12,6,3,45,17,6,11,3,37,1,0,34,26,0.516129,0.483871,11,13
2021020080,2021-10-24,2,CHI,3,6,DET,15,10,12,2,39,26,4,8,5,43,12,9,12,2,35,25,4,7,5,41,0,1,35,37,0.527273,0.472727,16,12
2021020081,2021-10-24,2,MIN,2,5,NSH,25,9,12,2,48,15,10,6,3,34,24,9,12,2,47,15,10,6,3,34,0,1,35,29,0.457143,0.542857,12,10
2021020082,2021-10-24,2,VGK,0,2,NYI,36,14,19,0,69,20,13,7,2,42,36,14,19,0,69,20,13,7,2,42,0,1,42,26,0.553571,0.446429,4,4
2021020083,2021-10-25,2,BUF,5,1,TBL,16,10,8,5,39,33,15,17,1,66,15,10,8,5,38,32,15,17,1,65,1,0,25,36,0.54902,0.45098,6,4
2021020084,2021-10-25,2,OTT,5,7,WSH,26,8,11,4,49,23,10,16,7,56,26,8,11,4,49,23,10,15,7,55,1,0,37,31,0.619718,0.380282,14,16
2021020085,2021-10-25,2,FLA,5,3,ARI,30,11,15,3,59,15,6,9,3,33,30,10,15,3,58,13,6,9,3,31,0,1,41,21,0.571429,0.428571,9,23
2021020086,2021-10-25,2,NYR,1,5,CGY,22,11,14,1,48,30,7,16,4,57,22,11,14,1,48,29,7,15,3,54,0,1,29,37,0.607843,0.392157,6,6
2021020087,2021-10-25,2,CAR,4,1,TOR,29,11,8,4,52,22,11,14,1,48,29,10,7,4,50,22,11,14,1,48,0,1,36,25,0.5,0.5,6,6
2021020088,2021-10-25,2,CBJ,4,1,DAL,14,10,11,4,39,22,10,7,1,40,14,10,11,4,39,22,10,7,1,40,1,0,26,32,0.5,0.5,8,10
2021020089,2021-10-25,2,STL,3,0,LAK,26,7,11,3,47,23,7,6,0,36,26,7,11,3,47,23,7,6,0,36,1,0,35,34,0.581818,0.418182,6,4
2021020090,2021-10-26,2,NJD,3,5,CGY,23,9,13,2,47,20,11,16,3,50,22,8,13,2,45,20,11,15,3,49,0,1,30,29,0.477612,0.522388,10,12
2021020091,2021-10-26,2,PIT,1,5,TBL,22,10,10,0,42,24,4,9,5,42,22,10,10,0,42,24,4,9,5,42,0,1,29,31,0.482143,0.517857,11,15
2021020092,2021-10-26,2,NSH,3,1,SJS,22,7,8,2,39,22,8,12,1,43,22,7,8,2,39,22,8,12,1,43,1,0,26,29,0.462687,0.537313,6,2
2021020093,2021-10-26,2,COL,1,3,VGK,24,8,21,1,54,19,7,11,2,39,24,8,21,0,53,19,7,11,2,39,0,1,27,29,0.603774,0.396226,24,21
2021020094,2021-10-26,2,VAN,2,3,MIN,16,7,14,1,38,23,5,8,3,39,16,7,14,1,38,23,5,8,3,39,0,1,24,30,0.545455,0.454545,4,6
2021020095,2021-10-26,2,ANA,3,4,WPG,25,14,10,3,52,18,12,12,4,46,25,14,10,3,52,18,12,12,4,46,0,1,35,25,0.457627,0.542373,2,6
2021020096,2021-10-26,2,SEA,5,1,MTL,15,6,13,5,39,19,5,5,1,30,15,6,13,5,39,19,5,5,1,30,1,0,26,24,0.6,0.4,4,8
2021020097,2021-10-27,2,FLA,4,1,BOS,22,11,12,4,49,25,8,16,1,50,20,11,12,4,47,25,8,16,1,50,0,1,27,31,0.339286,0.660714,4,2
2021020098,2021-10-27,2,WSH,2,3,DET,22,11,4,0,37,18,9,11,3,41,21,11,4,0,36,18,9,11,2,40,1,0,28,25,0.423077,0.576923,4,8
2021020099,2021-10-27,2,CHI,2,3,TOR,21,7,5,1,34,28,12,19,3,62,18,7,5,1,31,26,12,19,2,59,1,0,29,40,0.418182,0.581818,8,8
2021020100,2021-10-27,2,DAL,2,3,VGK,32,13,18,2,65,16,7,26,3,52,32,12,17,2,63,16,7,25,2,50,1,0,34,21,0.711538,0.288462,2,2
2021020101,2021-10-27,2,EDM,3,5,PHI,27,11,18,2,58,22,7,6,5,40,27,11,18,2,58,22,7,6,5,40,0,1,37,34,0.423077,0.576923,4,8
2021020102,2021-10-28,2,TBL,5,1,ARI,16,5,9,4,34,21,14,6,1,42,16,5,9,4,34,21,14,6,1,42,1,0,28,25,0.392857,0.607143,28,20
2021020103,2021-10-28,2,PIT,0,4,CGY,36,14,10,0,60,26,10,9,4,49,36,14,10,0,60,26,10,9,4,49,0,1,45,35,0.5,0.5,4,8
2021020104,2021-10-28,2,CAR,3,0,BOS,18,15,8,2,43,31,10,10,0,51,17,12,6,2,37,30,9,10,0,49,1,0,24,33,0.557377,0.442623,12,12
2021020105,2021-10-28,2,STL,3,4,COL,15,5,14,3,37,32,5,14,3,54,15,5,13,3,36,31,5,14,3,53,1,0,18,42,0.532258,0.467742,37,19
2021020106,2021-10-28,2,VAN,1,2,PHI,17,9,7,1,34,22,6,11,1,40,16,9,7,1,33,22,6,11,1,40,0,1,28,28,0.54902,0.45098,15,15
2021020107,2021-10-28,2,ANA,3,4,BUF,32,10,9,3,54,25,13,10,3,51,32,9,9,2,52,21,12,10,2,45,0,1,37,29,0.64,0.36,4,2
2021020108,2021-10-28,2,LAK,2,3,WPG,29,6,12,2,49,23,10,10,2,45,28,6,10,2,46,22,10,10,2,44,0,1,32,31,0.627907,0.372093,8,4
2021020109,2021-10-28,2,SJS,0,4,MTL,31,7,18,0,56,20,4,8,3,35,31,7,18,0,56,20,4,8,3,35,0,1,45,32,0.516129,0.483871,23,13
2021020110,2021-10-28,2,SEA,4,1,MIN,28,8,11,4,51,23,4,9,1,37,28,8,11,4,51,23,4,9,1,37,0,1,38,31,0.472727,0.527273,4,8
2021020111,2021-10-29,2,DET,2,3,FLA,22,9,7,2,40,26,11,20,3,60,21,9,7,2,39,25,9,20,2,56,0,1,30,33,0.586207,0.413793,6,8
2021020112,2021-10-29,2,NYR,4,0,CBJ,25,11,11,2,49,28,11,10,0,49,24,11,11,2,48,27,11,10,0,48,1,0,37,31,0.423077,0.576923,8,8
2021020113,2021-10-29,2,WSH,2,0,ARI,22,9,9,1,41,13,4,16,0,33,22,8,9,1,40,13,4,16,0,33,1,0,32,16,0.5,0.5,6,12
2021020114,2021-10-29,2,CAR,6,3,CHI,19,5,8,5,37,16,9,7,1,33,19,5,8,5,37,16,9,7,1,33,0,1,35,26,0.566038,0.433962,23,13
2021020115,2021-10-29,2,DAL,1,4,OTT,35,13,15,0,63,19,5,8,3,35,35,13,15,0,63,19,5,8,3,35,0,1,39,24,0.580645,0.419355,6,4
2021020116,2021-10-29,2,VGK,5,4,ANA,40,10,15,6,71,31,8,18,5,62,35,10,14,4,63,24,8,18,4,54,1,0,42,38,0.5,0.5,11,5
2021020117,2021-10-30,2,BOS,3,2,FLA,27,4,13,2,46,35,5,11,1,52,25,4,12,1,42,32,4,9,1,46,1,0,33,35,0.631579,0.368421,2,6
2021020118,2021-10-30,2,TOR,5,4,DET,33,11,14,4,62,25,6,11,3,45,33,11,14,4,62,25,6,11,3,45,1,0,38,31,0.644444,0.355556,4,4
2021020119,2021-10-30,2,PIT,2,4,NJD,25,5,10,2,42,31,4,11,3,49,25,5,10,2,42,31,4,11,2,48,1,0,35,40,0.523077,0.476923,4,10
2021020120,2021-10-30,2,STL,1,0,CHI,32,15,11,0,58,21,14,14,0,49,32,15,11,0,58,21,14,14,0,49,1,0,37,25,0.54717,0.45283,4,6
2021020121,2021-10-30,2,NSH,3,2,NYI,15,17,9,2,43,27,7,6,0,40,12,15,8,2,37,25,7,6,0,38,0,1,23,36,0.553571,0.446429,12,10
2021020122,2021-10-30,2,COL,4,1,MIN,22,7,15,3,47,26,9,18,0,53,22,7,15,3,47,26,9,18,0,53,1,0,31,30,0.467742,0.532258,6,21
2021020123,2021-10-30,2,CGY,4,0,PHI,25,10,9,2,46,17,3,11,0,31,25,10,9,2,46,17,3,11,0,31,1,0,36,20,0.46875,0.53125,8,12
2021020124,2021-10-30,2,VAN,1,2,EDM,25,15,15,1,56,29,10,11,0,50,25,15,15,1,56,29,10,11,0,50,0,1,30,34,0.5,0.5,4,2
2021020125,2021-10-30,2,LAK,5,2,MTL,28,10,13,2,53,22,6,12,2,42,27,10,13,2,52,21,6,11,2,40,0,1,38,28,0.615385,0.384615,6,10
2021020126,2021-10-30,2,SJS,2,1,WPG,32,10,9,1,52,34,17,15,1,67,30,10,9,1,50,34,17,15,1,67,1,0,36,35,0.38,0.62,2,8
2021020127,2021-10-31,2,NJD,3,4,CBJ,35,8,17,3,63,21,12,19,3,55,28,7,15,3,53,18,9,19,2,48,1,0,39,26,0.45,0.55,4,6
2021020128,2021-10-31,2,CAR,2,1,ARI,28,13,18,1,60,17,5,5,1,28,27,12,18,1,58,15,5,5,1,26,0,1,39,23,0.642857,0.357143,8,12
2021020129,2021-10-31,2,ANA,4,2,MTL,17,8,9,2,36,13,4,11,1,29,14,8,9,2,33,12,4,11,1,28,1,0,26,18,0.714286,0.285714,10,25
2021020130,2021-10-31,2,LAK,3,2,BUF,21,11,9,2,43,20,3,7,1,31,21,11,9,2,43,20,3,7,1,31,0,1,34,24,0.571429,0.428571,9,17
2021020131,2021-10-31,2,SEA,1,3,NYR,23,16,16,1,56,15,9,11,3,38,22,16,16,1,55,15,9,10,3,37,0,1,32,18,0.54386,0.45614,4,8
2021020132,2021-11-01,2,TBL,3,2,WSH,16,6,9,2,33,22,9,6,1,38,16,6,8,2,32,22,9,6,1,38,0,1,26,33,0.574074,0.425926,10,10
2021020133,2021-11-01,2,CHI,5,1,OTT,19,8,15,4,46,23,8,16,1,48,19,8,15,4,46,21,7,15,1,44,1,0,31,30,0.630435,0.369565,8,6
2021020134,2021-11-01,2,EDM,5,2,SEA,12,5,12,4,33,21,7,11,2,41,11,5,11,4,31,21,6,11,2,40,1,0,23,29,0.543478,0.456522,8,8
2021020135,2021-11-02,2,TOR,4,0,VGK,25,8,20,3,56,24,6,11,0,41,25,8,20,3,56,24,6,11,0,41,1,0,33,26,0.538462,0.461538,6,2
2021020136,2021-11-02,2,MTL,3,0,DET,37,7,11,3,58,22,4,12,0,38,37,7,11,3,58,22,4,12,0,38,1,0,41,22,0.491228,0.508772,4,2
2021020137,2021-11-02,2,PHI,3,0,ARI,25,10,14,3,52,28,11,12,0,51,25,10,14,3,52,28,11,12,0,51,1,0,34,29,0.622642,0.377358,0,6
2021020138,2021-11-02,2,MIN,5,4,OTT,34,11,18,4,67,16,6,4,3,29,33,11,17,3,64,16,6,4,3,29,1,0,43,28,0.55,0.45,13,13
2021020139,2021-11-02,2,WPG,4,3,DAL,30,14,15,3,62,23,9,12,3,47,24,10,13,1,48,21,8,11,2,42,1,0,35,27,0.5,0.5,4,8
2021020140,2021-11-02,2,CGY,2,3,NSH,32,13,9,1,55,17,6,8,3,34,31,13,8,1,53,17,6,8,2,33,0,1,40,22,0.517857,0.482143,9,17
2021020141,2021-11-02,2,VAN,3,2,NYR,20,8,10,3,41,13,6,6,0,25,17,8,10,2,37,13,6,6,0,25,0,1,36,25,0.522727,0.477273,10,12
2021020142,2021-11-02,2,ANA,4,0,NJD,16,11,15,1,43,22,8,9,0,39,15,11,15,1,42,21,6,8,0,35,1,0,27,28,0.510638,0.489362,10,14
2021020143,2021-11-02,2,SJS,5,3,BUF,19,6,12,5,42,25,6,10,3,44,18,5,12,4,39,24,5,10,3,42,1,0,27,28,0.653846,0.346154,6,4
2021020144,2021-11-03,2,CHI,3,4,CAR,21,6,9,3,39,19,9,20,4,52,21,6,9,3,39,19,9,20,4,52,1,0,30,32,0.527273,0.472727,4,10
2021020145,2021-11-03,2,COL,4,5,CBJ,19,4,19,4,46,31,7,17,5,60,19,4,18,4,45,31,7,17,4,59,1,0,32,37,0.553571,0.446429,0,6
2021020146,2021-11-03,2,EDM,5,2,NSH,18,6,13,4,41,26,9,11,1,47,18,6,13,4,41,26,9,11,1,47,1,0,30,33,0.5,0.5,8,4
2021020147,2021-11-03,2,LAK,3,2,STL,27,12,15,5,59,30,15,10,2,57,20,11,14,2,47,29,13,10,0,52,0,1,35,35,0.586207,0.413793,4,10
2021020148,2021-11-04,2,BOS,5,1,DET,27,15,7,1,50,12,11,7,0,30,27,15,7,1,50,12,11,7,0,30,1,0,37,15,0.592593,0.407407,10,12
2021020149,2021-11-04,2,TOR,2,1,TBL,27,8,16,1,52,23,13,8,1,45,25,8,16,1,50,23,13,8,1,45,0,1,34,25,0.509434,0.490566,4,8
2021020150,2021-11-04,2,MTL,2,6,NYI,32,8,24,0,64,22,5,5,6,38,32,8,24,0,64,22,5,5,5,37,0,1,38,36,0.539683,0.460317,6,6
2021020151,2021-11-04,2,OTT,1,5,VGK,34,11,12,1,58,30,14,14,5,63,34,11,12,1,58,30,14,14,5,63,0,1,39,39,0.596154,0.403846,2,2
2021020152,2021-11-04,2,FLA,5,4,WSH,23,4,11,4,42,32,7,8,4,51,22,4,11,3,40,32,7,8,4,51,1,0,33,42,0.489362,0.510638,4,6
2021020153,2021-11-04,2,PIT,3,2,PHI,31,12,10,3,56,34,8,15,1,58,30,12,9,2,53,32,8,15,1,56,1,0,36,38,0.526316,0.473684,6,4
2021020154,2021-11-04,2,CGY,3,4,DAL,25,7,13,2,47,20,8,5,3,36,24,6,12,1,43,18,7,5,2,32,0,1,33,28,0.507692,0.492308,8,10
2021020155,2021-11-04,2,SJS,3,5,STL,15,10,9,1,35,19,11,10,4,44,15,10,9,1,35,19,11,10,4,44,1,0,26,28,0.578947,0.421053,8,10
2021020156,2021-11-04,2,SEA,5,2,BUF,25,9,4,5,43,16,7,11,1,35,23,8,3,4,38,16,6,11,1,34,1,0,38,21,0.413793,0.586207,17,19
2021020157,2021-11-05,2,WPG,5,1,CHI,26,7,11,4,48,14,4,12,0,30,26,7,10,4,47,14,4,12,0,30,1,0,33,18,0.530612,0.469388,4,6
2021020158,2021-11-05,2,EDM,6,5,NYR,30,15,22,4,71,17,6,11,4,38,29,13,21,3,66,17,6,11,4,38,0,1,39,25,0.584906,0.415094,4,4
2021020159,2021-11-05,2,VAN,2,3,NSH,23,8,21,2,54,20,8,10,1,39,23,8,21,2,54,20,8,10,1,39,0,1,28,28,0.409836,0.590164,11,15
2021020160,2021-11-05,2,ANA,3,1,ARI,21,11,12,2,46,27,8,8,1,44,21,11,12,2,46,25,8,8,1,42,1,0,31,29,0.566667,0.433333,16,40
2021020161,2021-11-05,2,LAK,3,2,NJD,20,9,11,2,42,19,10,12,2,43,19,9,11,1,40,18,9,12,2,41,1,0,29,23,0.586207,0.413793,8,12
2021020162,2021-11-06,2,BUF,3,4,DET,27,9,12,2,50,25,6,12,4,47,26,9,12,2,49,22,6,12,3,43,0,1,32,33,0.428571,0.571429,2,4
2021020163,2021-11-06,2,TOR,5,2,BOS,25,4,9,3,41,38,13,14,1,66,25,4,9,3,41,38,13,14,1,66,0,1,36,44,0.509091,0.490909,8,8
2021020164,2021-11-06,2,MTL,2,5,VGK,28,10,18,1,57,13,7,13,3,36,25,10,15,1,51,13,6,12,2,33,1,0,38,18,0.5,0.5,8,12
2021020165,2021-11-06,2,OTT,3,5,TBL,21,5,9,3,38,25,14,9,4,52,21,5,9,3,38,25,14,9,4,52,0,1,27,33,0.516129,0.483871,4,8
2021020166,2021-11-06,2,FLA,5,2,CAR,22,13,10,2,47,25,11,22,1,59,22,12,9,2,45,24,11,22,1,58,1,0,32,32,0.355932,0.644068,21,20
2021020167,2021-11-06,2,PIT,4,5,MIN,33,7,10,6,56,34,10,16,7,67,28,6,10,4,48,29,9,16,4,58,0,1,39,40,0.492537,0.507463,4,4
2021020168,2021-11-06,2,WSH,1,2,PHI,21,12,9,1,43,28,9,19,2,58,21,12,9,1,43,28,9,19,2,58,0,1,32,32,0.470588,0.529412,2,6
2021020169,2021-11-06,2,CBJ,4,2,COL,25,4,9,4,42,28,9,8,2,47,25,4,9,4,42,28,9,8,2,47,1,0,42,36,0.5,0.5,8,8
2021020170,2021-11-06,2,WPG,0,2,NYI,24,16,17,0,57,28,14,7,2,51,24,16,17,0,57,28,14,7,2,51,0,1,24,31,0.576923,0.423077,7,7
2021020171,2021-11-06,2,CGY,6,0,NYR,25,19,10,5,59,16,13,10,0,39,25,19,10,5,59,16,13,10,0,39,1,0,37,22,0.489796,0.510204,11,11
2021020172,2021-11-06,2,ARI,5,4,SEA,17,6,8,4,35,22,11,17,4,54,16,6,8,4,34,21,11,17,4,53,0,1,22,31,0.571429,0.428571,6,4
2021020173,2021-11-06,2,SJS,2,3,NJD,20,12,17,2,51,24,10,17,4,55,15,10,15,1,41,20,10,17,2,49,1,0,27,28,0.457627,0.542373,8,6
2021020174,2021-11-07,2,DET,5,2,VGK,22,4,6,3,35,34,12,16,2,64,22,4,6,3,35,34,12,16,2,64,0,1,30,40,0.436364,0.563636,6,8
2021020175,2021-11-07,2,CHI,2,1,NSH,22,11,10,2,45,20,10,12,1,43,22,11,10,1,44,20,10,12,1,43,1,0,32,21,0.456522,0.543478,4,6
2021020176,2021-11-07,2,MIN,5,2,NYI,27,12,15,5,59,19,9,11,2,41,27,12,15,5,59,19,9,11,2,41,0,1,39,21,0.416667,0.583333,2,4
2021020177,2021-11-07,2,VAN,6,3,DAL,24,9,10,3,46,23,5,12,1,41,24,9,10,3,46,23,5,12,1,41,0,1,36,28,0.571429,0.428571,6,12
2021020178,2021-11-07,2,ANA,4,1,STL,20,11,8,3,42,31,13,15,1,60,20,11,8,3,42,31,13,15,1,60,0,1,27,35,0.431034,0.568966,2,14
2021020179,2021-11-08,2,TOR,1,5,LAK,28,14,21,0,63,21,11,7,5,44,28,14,21,0,63,21,11,7,5,44,0,1,34,29,0.410714,0.589286,6,4
2021020180,2021-11-08,2,NYR,4,3,FLA,9,10,6,2,27,39,24,19,3,85,7,10,6,0,23,36,23,19,3,81,1,0,18,45,0.527273,0.472727,6,6
2021020181,2021-11-08,2,WSH,5,3,BUF,19,10,4,4,37,20,12,14,3,49,19,10,4,4,37,20,12,14,3,49,1,0,30,28,0.559322,0.440678,6,6
2021020182,2021-11-09,2,BOS,3,2,OTT,30,10,16,2,58,15,8,4,2,29,29,7,15,1,52,14,8,3,2,27,0,1,36,27,0.578947,0.421053,19,13
2021020183,2021-11-09,2,MTL,2,3,LAK,26,14,20,2,62,24,11,14,3,52,22,14,18,2,56,21,11,13,2,47,1,0,35,34,0.507692,0.492308,10,8
2021020184,2021-11-09,2,DET,4,2,EDM,31,8,8,4,51,25,8,17,2,52,31,8,8,4,51,25,8,17,2,52,1,0,39,33,0.482143,0.517857,4,4
2021020185,2021-11-09,2,TBL,1,2,CAR,16,8,6,1,31,19,8,15,1,43,14,6,5,1,26,17,6,15,0,38,1,0,18,31,0.35,0.65,12,10
2021020186,2021-11-09,2,NJD,7,3,FLA,19,13,9,5,46,33,11,14,3,61,19,13,9,5,46,33,11,14,3,61,0,1,31,38,0.533333,0.466667,4,8
2021020187,2021-11-09,2,CHI,3,2,PIT,22,6,6,4,38,43,12,18,2,75,20,3,5,2,30,39,11,18,2,70,1,0,32,44,0.52459,0.47541,8,6
2021020188,2021-11-09,2,WPG,2,3,STL,41,16,14,2,73,30,11,14,2,57,36,16,14,2,68,19,8,13,1,41,0,1,41,33,0.518519,0.481481,2,4
2021020189,2021-11-09,2,CGY,1,4,SJS,31,13,10,1,55,18,17,8,4,47,31,13,10,1,55,18,17,8,4,47,0,1,38,26,0.52381,0.47619,4,6
2021020190,2021-11-09,2,VAN,2,3,ANA,33,11,21,1,66,25,0,10,2,37,27,10,20,1,58,23,0,10,1,34,0,1,43,30,0.586957,0.413043,10,6
2021020191,2021-11-09,2,VGK,4,2,SEA,16,11,10,3,40,21,7,15,1,44,16,11,9,3,39,21,7,15,1,44,0,1,23,27,0.474576,0.525424,8,6
2021020192,2021-11-10,2,PHI,0,3,TOR,31,12,14,0,57,23,5,10,2,40,31,12,14,0,57,23,5,10,2,40,0,1,36,33,0.578125,0.421875,6,8
2021020193,2021-11-10,2,DAL,2,4,NSH,21,10,18,1,50,17,7,6,4,34,21,10,18,1,50,17,7,6,4,34,0,1,27,22,0.615385,0.384615,2,6
2021020194,2021-11-10,2,ARI,2,5,MIN,19,9,5,2,35,24,10,10,3,47,19,9,5,2,35,24,10,10,3,47,0,1,26,30,0.62069,0.37931,6,6
2021020195,2021-11-11,2,BOS,3,5,EDM,20,9,7,3,39,16,8,7,5,36,20,9,7,3,39,16,8,7,5,36,1,0,29,28,0.673077,0.326923,4,6
2021020196,2021-11-11,2,MTL,4,2,CGY,19,7,11,2,39,20,8,15,2,45,17,7,10,2,36,19,8,14,2,43,0,1,28,26,0.537037,0.462963,6,12
2021020197,2021-11-11,2,OTT,0,2,LAK,29,11,10,0,50,29,3,9,1,42,29,11,10,0,50,29,3,9,1,42,0,1,34,36,0.413043,0.586957,8,8
2021020198,2021-11-11,2,DET,0,2,WSH,20,11,11,0,42,18,13,6,2,39,20,11,11,0,42,18,13,6,2,39,0,1,21,29,0.52,0.48,8,8
2021020199,2021-11-11,2,NJD,4,0,NYI,25,11,10,2,48,37,9,20,0,66,24,10,9,2,45,35,9,18,0,62,1,0,34,42,0.472727,0.527273,8,6
2021020200,2021-11-11,2,PIT,3,2,FLA,19,7,10,2,38,29,10,10,2,51,17,7,10,2,36,29,10,9,2,50,1,0,31,38,0.576923,0.423077,8,6
2021020201,2021-11-11,2,STL,3,4,NSH,33,8,16,2,59,23,13,11,4,51,31,8,16,2,57,23,13,11,3,50,1,0,36,27,0.55,0.45,5,7
2021020202,2021-11-11,2,WPG,4,1,SJS,26,20,17,4,67,25,17,16,1,59,25,20,17,4,66,23,17,15,1,56,0,1,34,27,0.425926,0.574074,7,13
2021020203,2021-11-11,2,COL,7,1,VAN,22,11,7,4,44,17,7,12,1,37,22,11,6,4,43,17,7,12,1,37,1,0,35,22,0.436364,0.563636,6,12
2021020204,2021-11-11,2,VGK,3,2,MIN,26,7,14,3,50,13,13,10,2,38,26,7,14,3,50,13,13,10,2,38,1,0,35,26,0.5,0.5,12,4
2021020205,2021-11-11,2,SEA,4,7,ANA,20,10,11,4,45,29,10,14,7,60,20,10,11,3,44,29,10,14,5,58,0,1,25,36,0.519231,0.480769,9,9
2021020206,2021-11-12,2,BUF,3,2,EDM,19,4,6,3,32,30,6,16,0,52,18,4,6,3,31,30,6,16,0,52,1,0,23,35,0.350877,0.649123,12,6
2021020207,2021-11-12,2,TOR,2,1,CGY,30,13,15,2,60,28,11,13,1,53,27,13,14,1,55,26,10,12,1,49,0,1,37,31,0.517241,0.482759,2,6
2021020208,2021-11-12,2,CAR,1,2,PHI,27,9,14,1,51,21,16,8,2,47,27,9,14,1,51,21,16,8,2,47,1,0,40,28,0.583333,0.416667,10,10
2021020209,2021-11-12,2,CBJ,3,4,WSH,23,13,12,3,51,24,8,10,4,46,23,13,12,3,51,23,8,10,4,45,1,0,29,28,0.611111,0.388889,2,4
2021020210,2021-11-12,2,CHI,2,1,ARI,17,6,11,1,35,18,7,12,0,37,17,6,11,1,35,18,7,12,0,37,1,0,29,23,0.44898,0.55102,8,12
2021020211,2021-11-13,2,BUF,4,5,TOR,21,18,10,4,53,18,9,8,4,39,21,18,10,4,53,18,9,8,4,39,0,1,27,26,0.363636,0.636364,2,4
2021020212,2021-11-13,2,OTT,6,3,PIT,16,8,14,4,42,23,16,14,3,56,16,8,14,4,42,23,16,14,3,56,1,0,24,31,0.519231,0.480769,10,8
2021020213,2021-11-13,2,DET,3,2,MTL,25,15,8,3,51,26,5,12,2,45,25,15,8,2,50,25,5,11,2,43,0,1,33,37,0.462687,0.537313,8,6
2021020214,2021-11-13,2,TBL,3,2,FLA,20,9,6,2,37,26,12,15,2,55,19,9,6,1,35,23,12,14,2,51,1,0,24,28,0.455882,0.544118,11,11
2021020215,2021-11-13,2,NJD,2,5,BOS,26,13,24,2,65,26,11,7,4,48,25,12,24,2,63,24,11,7,4,46,0,1,29,36,0.461538,0.538462,6,8
2021020216,2021-11-13,2,CAR,3,2,STL,18,12,9,2,41,19,8,6,1,34,18,12,9,2,41,19,8,6,1,34,1,0,24,29,0.470588,0.529412,8,4
2021020217,2021-11-13,2,CBJ,3,5,NYR,30,13,10,2,55,28,8,7,4,47,30,13,10,2,55,28,8,7,4,47,1,0,36,41,0.472727,0.527273,4,8
2021020218,2021-11-13,2,NSH,4,1,ARI,15,12,3,3,33,17,3,5,0,25,15,11,3,3,32,14,3,4,0,21,1,0,24,23,0.482143,0.517857,35,28
2021020219,2021-11-13,2,DAL,5,2,PHI,21,16,15,4,56,24,14,12,1,51,19,15,15,4,53,23,13,12,1,49,1,0,31,33,0.55,0.45,8,6
2021020220,2021-11-13,2,WPG,3,2,LAK,20,12,11,2,45,22,10,15,2,49,19,12,11,1,43,21,10,15,2,48,1,0,23,29,0.5,0.5,4,2
2021020221,2021-11-13,2,COL,6,2,SJS,18,6,15,4,43,24,3,9,1,37,18,6,15,4,43,24,3,9,1,37,0,1,31,30,0.484375,0.515625,4,10
2021020222,2021-11-13,2,VGK,7,4,VAN,20,9,6,5,40,29,7,16,4,56,18,9,6,4,37,26,6,15,4,51,0,1,39,43,0.391304,0.608696,17,21
2021020223,2021-11-13,2,SEA,2,4,MIN,23,15,7,1,46,16,8,9,4,37,23,15,7,1,46,16,8,9,4,37,0,1,30,22,0.54386,0.45614,2,6
2021020224,2021-11-14,2,BOS,5,2,MTL,31,4,7,4,46,25,9,10,2,46,29,4,7,4,44,24,9,10,2,45,0,1,41,29,0.461538,0.538462,2,18
2021020225,2021-11-14,2,OTT,0,4,CGY,17,10,7,0,34,22,7,11,3,43,17,10,7,0,34,22,7,11,3,43,0,1,27,33,0.40678,0.59322,13,15
2021020226,2021-11-14,2,NYR,4,3,NJD,39,11,11,7,68,26,12,19,5,62,31,8,11,3,53,22,11,17,2,52,0,1,41,27,0.507042,0.492958,2,4
2021020227,2021-11-14,2,WSH,6,1,PIT,24,8,15,4,51,22,9,9,1,41,24,8,15,4,51,22,9,9,1,41,1,0,32,25,0.489796,0.510204,4,6
2021020228,2021-11-14,2,STL,4,5,EDM,26,11,3,3,43,25,5,6,4,40,26,11,3,3,43,25,5,6,4,40,1,0,39,32,0.377049,0.622951,6,10
2021020229,2021-11-14,2,ANA,5,1,VAN,29,12,14,3,58,21,12,9,1,43,29,12,14,3,58,21,12,9,1,43,0,1,38,27,0.54717,0.45283,2,8
2021020230,2021-11-15,2,TBL,4,1,NYI,18,12,7,3,40,23,8,10,1,42,18,12,7,3,40,23,8,10,1,42,0,1,28,26,0.444444,0.555556,38,30
2021020231,2021-11-15,2,CBJ,5,3,DET,27,7,12,5,51,22,8,12,3,45,27,7,11,5,50,19,8,12,3,42,0,1,38,27,0.44,0.56,4,8
2021020232,2021-11-16,2,TOR,3,0,NSH,25,14,14,2,55,21,12,8,0,41,24,14,14,2,54,20,12,7,0,39,1,0,34,24,0.54902,0.45098,9,15
2021020233,2021-11-16,2,FLA,6,1,NYI,25,11,5,6,47,25,5,12,1,43,25,11,5,6,47,25,4,12,1,42,1,0,36,28,0.490566,0.509434,9,46
2021020234,2021-12-06,2,NJD,2,3,OTT,23,28,19,3,73,21,13,10,4,48,17,22,19,2,60,19,12,10,2,43,1,0,24,23,0.528302,0.471698,6,4
2021020235,2021-11-16,2,NYR,3,2,MTL,29,15,9,3,56,30,12,23,2,67,28,15,9,3,55,28,12,23,2,65,1,0,34,33,0.490566,0.509434,14,26
2021020236,2021-11-16,2,PHI,2,1,CGY,35,10,10,2,57,26,3,13,1,43,28,10,10,1,49,23,3,11,1,38,0,1,43,34,0.596774,0.403226,8,12
2021020237,2021-11-16,2,PIT,1,2,BUF,32,7,12,0,51,14,5,6,2,27,32,6,12,0,50,14,5,6,2,27,0,1,46,19,0.551724,0.448276,15,13
2021020238,2021-11-16,2,STL,2,3,ARI,27,6,9,2,44,16,8,8,1,33,27,6,9,1,43,15,8,8,1,32,0,1,36,23,0.516129,0.483871,6,8
2021020239,2021-11-16,2,DAL,5,2,DET,24,11,13,5,53,28,15,15,1,59,24,11,13,5,53,28,15,15,1,59,1,0,30,30,0.483333,0.516667,2,2
2021020240,2021-11-16,2,MIN,1,4,SJS,25,8,14,1,48,13,9,8,4,34,25,8,13,1,47,13,9,8,3,33,0,1,27,21,0.411765,0.588235,16,14
2021020241,2021-11-16,2,WPG,5,2,EDM,23,7,7,4,41,25,10,14,0,49,23,7,7,4,41,25,10,14,0,49,1,0,35,34,0.45,0.55,8,8
2021020242,2021-11-16,2,VGK,2,4,CAR,18,10,6,2,36,34,12,13,3,62,18,10,6,2,36,34,12,13,3,62,0,1,23,42,0.514706,0.485294,4,2
2021020243,2021-11-16,2,ANA,3,2,WSH,27,8,14,3,52,27,14,15,2,58,26,8,14,2,50,25,14,15,2,56,1,0,31,30,0.673077,0.326923,10,2
2021020244,2021-11-17,2,VAN,2,4,COL,30,9,22,2,63,18,11,20,1,50,30,9,22,2,63,18,9,17,1,45,0,1,34,30,0.546875,0.453125,12,8
2021020245,2021-11-17,2,LAK,0,2,WSH,29,9,14,0,52,31,6,11,2,50,28,9,14,0,51,30,6,11,2,49,0,1,34,38,0.6,0.4,8,6
2021020246,2021-11-17,2,SEA,2,4,CHI,30,11,18,1,60,15,6,8,4,33,29,11,18,1,59,15,6,8,4,33,0,1,33,19,0.604167,0.395833,7,9
2021020247,2021-11-18,2,BUF,0,5,CGY,23,6,11,0,40,27,11,16,4,58,23,6,11,0,40,27,11,16,4,58,0,1,27,33,0.416667,0.583333,4,4
2021020248,2021-11-18,2,TOR,2,1,NYR,28,16,6,1,51,25,10,12,1,48,27,15,5,1,48,24,10,12,1,47,1,0,30,28,0.804348,0.195652,4,4
2021020249,2021-11-18,2,MTL,0,6,PIT,23,7,18,0,48,36,8,11,5,60,23,7,18,0,48,36,8,11,5,60,0,1,24,43,0.45,0.55,2,2
2021020250,2022-04-07,2,OTT,2,3,NSH,20,11,20,2,53,24,10,7,2,43,20,11,20,2,53,24,10,7,2,43,0,1,29,34,0.5,0.5,18,18
2021020251,2021-11-18,2,FLA,4,1,NJD,34,8,14,4,60,36,3,13,1,53,34,8,14,4,60,36,2,13,1,52,0,1,41,46,0.428571,0.571429,8,6
2021020252,2021-11-18,2,PHI,3,4,TBL,27,8,17,3,55,28,14,18,4,64,21,5,17,3,46,25,13,17,2,57,1,0,30,32,0.517857,0.482143,6,4
2021020253,2021-11-18,2,STL,4,1,SJS,32,10,16,3,61,25,16,3,1,45,32,10,16,3,61,25,16,3,1,45,1,0,48,27,0.517241,0.482759,5,13
2021020254,2021-11-18,2,MIN,7,2,DAL,12,7,13,7,39,23,11,9,1,44,12,7,13,7,39,22,10,8,1,41,1,0,26,38,0.421875,0.578125,19,15
2021020255,2021-11-18,2,EDM,2,1,WPG,26,14,10,3,53,36,9,10,1,56,25,14,9,1,49,31,8,10,1,50,0,1,32,47,0.540984,0.459016,17,11
2021020256,2021-11-18,2,ARI,4,5,CBJ,28,11,11,6,56,41,13,19,5,78,20,10,9,4,43,34,10,18,2,64,1,0,29,46,0.473684,0.526316,15,13
2021020257,2021-11-18,2,VGK,5,2,DET,25,7,14,5,51,22,7,16,2,47,25,7,14,5,51,22,7,16,2,47,1,0,32,28,0.581395,0.418605,7,9
2021020258,2021-11-18,2,ANA,1,2,CAR,28,7,12,1,48,27,18,18,2,65,28,7,12,1,48,25,18,18,2,63,0,1,32,31,0.459016,0.540984,4,6
2021020259,2021-11-19,2,VAN,3,2,WPG,23,5,5,1,34,37,8,18,2,65,23,5,5,1,34,37,8,18,2,65,1,0,29,39,0.672727,0.327273,2,8
2021020260,2021-11-19,2,SEA,3,7,COL,17,6,5,1,29,18,6,8,4,36,17,6,5,1,29,18,6,8,4,36,0,1,28,30,0.630769,0.369231,20,10
2021020261,2021-11-20,2,TOR,0,2,PIT,23,14,16,0,53,24,6,9,2,41,23,14,16,0,53,24,6,9,2,41,0,1,26,31,0.536585,0.463415,2,8
2021020262,2021-11-20,2,MTL,6,3,NSH,23,15,11,5,54,32,13,10,1,56,23,15,11,5,54,31,13,9,1,54,1,0,29,36,0.573529,0.426471,23,21
2021020263,2022-02-20,2,OTT,1,2,NYR,24,14,16,1,55,26,8,13,1,48,24,14,16,1,55,26,8,13,1,48,1,0,30,33,0.510204,0.489796,4,2
2021020264,2021-11-20,2,TBL,3,5,NJD,27,11,4,2,44,20,11,6,5,42,28,10,4,2,44,20,10,6,5,41,1,0,34,27,0.571429,0.428571,6,8
2021020265,2021-11-20,2,FLA,5,4,MIN,31,11,15,5,62,34,5,13,3,55,31,11,15,5,62,34,5,13,3,55,1,0,37,39,0.490566,0.509434,4,2
2021020266,2021-11-20,2,NYI,2,5,CGY,26,5,8,1,40,19,4,10,3,36,26,5,8,1,40,19,4,10,3,36,0,1,36,31,0.509434,0.490566,8,12
2021020267,2021-11-20,2,PHI,2,5,BOS,24,8,6,1,39,31,7,6,5,49,22,6,6,1,35,30,6,5,4,45,0,1,31,44,0.491228,0.508772,13,17
2021020268,2021-11-20,2,DAL,4,1,STL,20,4,5,1,30,23,4,6,0,33,20,4,5,1,30,23,4,6,0,33,1,0,33,36,0.606557,0.393443,12,8
2021020269,2021-11-20,2,EDM,5,2,CHI,24,11,10,2,47,26,7,16,2,51,24,11,9,2,46,26,7,16,2,51,1,0,33,31,0.5625,0.4375,6,8
2021020270,2021-11-20,2,ARI,2,1,DET,26,11,12,2,51,27,7,11,1,46,25,11,12,1,49,27,7,11,1,46,0,1,29,34,0.630435,0.369565,4,2
2021020271,2021-11-20,2,VGK,3,2,CBJ,26,9,16,2,53,18,12,17,1,48,26,9,15,2,52,18,12,16,1,47,0,1,35,29,0.354839,0.645161,10,10
2021020272,2021-11-20,2,LAK,4,5,CAR,34,13,9,3,59,12,8,7,5,32,34,12,9,3,58,12,8,7,5,32,0,1,43,20,0.595745,0.404255,4,8
2021020273,2021-11-20,2,SJS,0,4,WSH,15,14,7,0,36,15,7,4,3,29,15,13,7,0,35,15,7,4,3,29,0,1,22,21,0.55,0.45,6,8
2021020274,2021-11-21,2,BOS,0,4,CGY,23,10,12,0,45,20,10,12,3,45,23,10,12,0,45,20,10,12,3,45,0,1,28,32,0.532258,0.467742,4,6
2021020275,2021-11-21,2,TBL,5,4,MIN,18,13,12,4,47,25,12,11,3,51,16,10,11,3,40,23,10,11,3,47,1,0,24,32,0.453125,0.546875,13,15
2021020276,2021-11-21,2,NYI,0,3,TOR,17,13,10,0,40,32,7,9,2,50,17,13,10,0,40,32,7,9,2,50,0,1,20,40,0.442308,0.557692,8,8
2021020277,2021-11-21,2,NYR,5,4,BUF,31,9,15,4,59,16,8,8,3,35,31,9,15,4,59,16,8,8,3,35,0,1,36,22,0.44,0.56,6,2
2021020278,2021-11-21,2,VAN,0,1,CHI,26,7,15,0,48,18,6,14,1,39,25,7,14,0,46,18,6,14,1,39,0,1,40,24,0.54,0.46,8,8
2021020279,2021-11-21,2,LAK,1,2,ARI,29,9,12,1,51,22,10,8,2,42,25,7,12,1,45,21,9,7,1,38,1,0,38,27,0.6,0.4,8,10
2021020280,2021-11-21,2,SEA,5,2,WSH,21,10,7,4,42,27,9,7,2,45,21,10,7,4,42,27,9,7,2,45,0,1,31,39,0.485294,0.514706,8,2
2021020281,2021-11-22,2,BUF,4,7,CBJ,25,9,12,2,48,20,13,11,7,51,24,9,12,2,47,19,12,11,7,49,1,0,33,29,0.54717,0.45283,8,10
2021020282,2021-11-22,2,STL,5,2,VGK,25,3,11,4,43,29,9,4,2,44,25,3,11,4,43,29,9,4,2,44,0,1,31,34,0.555556,0.444444,6,4
2021020283,2021-11-22,2,NSH,3,2,ANA,21,6,7,2,36,23,12,13,2,50,20,6,7,2,35,23,12,13,2,50,1,0,35,31,0.491525,0.508475,4,8
2021020284,2021-11-22,2,WPG,1,3,PIT,26,10,7,1,44,29,8,10,3,50,26,10,7,1,44,29,8,10,3,50,1,0,31,36,0.44898,0.55102,4,4
2021020285,2021-11-22,2,COL,7,5,OTT,24,9,8,6,47,12,1,10,3,26,24,9,7,6,46,11,1,10,3,25,1,0,40,21,0.491803,0.508197,8,10
2021020286,2021-11-22,2,SJS,2,1,CAR,24,10,11,2,47,19,10,22,1,52,23,10,11,1,45,19,10,22,1,52,0,1,27,23,0.588235,0.411765,4,2
2021020287,2021-11-23,2,TBL,4,0,PHI,30,22,8,4,64,30,8,10,0,48,30,22,8,4,64,30,8,10,0,48,1,0,35,34,0.441176,0.558824,2,4
2021020288,2021-11-23,2,DAL,4,1,EDM,23,8,17,2,50,18,11,19,1,49,21,7,17,2,47,18,10,19,1,48,1,0,33,22,0.602941,0.397059,4,10
2021020289,2021-11-23,2,CGY,5,2,CHI,33,13,12,5,63,19,6,12,2,39,33,13,12,5,63,19,6,12,2,39,1,0,39,21,0.54,0.46,7,5
2021020290,2021-11-24,2,BUF,1,5,BOS,23,12,10,1,46,34,7,7,3,51,22,12,10,1,45,34,7,7,3,51,1,0,25,47,0.3125,0.6875,22,7
2021020291,2021-11-24,2,DET,4,2,STL,17,8,13,4,42,30,11,15,1,57,17,8,13,4,42,30,11,15,1,57,0,1,23,37,0.54386,0.45614,6,0
2021020292,2021-11-24,2,FLA,2,1,PHI,40,12,21,1,74,27,4,5,1,37,33,11,20,0,64,26,3,4,1,34,0,1,45,33,0.421053,0.578947,6,6
2021020293,2021-11-24,2,NJD,2,3,MIN,33,16,15,2,66,20,6,9,2,37,27,13,15,2,57,19,5,8,1,33,0,1,42,27,0.54717,0.45283,8,10
2021020294,2021-11-24,2,NYI,1,4,NYR,11,3,12,1,27,10,8,5,3,26,11,3,12,1,27,10,8,5,3,26,0,1,21,21,0.583333,0.416667,17,19
2021020295,2021-11-24,2,PIT,4,1,VAN,24,6,10,3,43,34,4,12,1,51,23,6,10,3,42,31,4,12,1,48,1,0,37,37,0.377358,0.622642,4,10
2021020296,2021-11-24,2,WSH,6,3,MTL,28,19,12,5,64,20,9,7,3,39,28,19,12,5,64,20,9,7,3,39,1,0,34,28,0.535714,0.464286,6,2
2021020297,2021-11-24,2,CBJ,3,0,WPG,22,9,3,2,36,29,11,12,0,52,22,9,3,2,36,29,11,12,0,52,1,0,32,36,0.423729,0.576271,10,8
2021020298,2021-11-24,2,NSH,2,5,VGK,22,10,14,1,47,23,7,10,4,44,22,10,14,1,47,23,7,10,4,44,0,1,28,35,0.555556,0.444444,4,12
2021020299,2021-11-24,2,COL,5,2,ANA,19,7,14,4,44,17,10,9,0,36,19,7,14,4,44,17,10,9,0,36,0,1,36,26,0.565217,0.434783,11,19
2021020300,2021-11-24,2,ARI,3,5,EDM,19,5,6,3,33,30,12,8,3,53,18,5,6,3,32,30,12,8,3,53,1,0,27,44,0.41791,0.58209,8,4
2021020301,2021-11-24,2,LAK,2,6,TOR,27,14,11,0,52,24,10,16,5,55,26,14,11,0,51,24,10,16,5,55,0,1,32,38,0.372549,0.627451,6,6
2021020302,2021-11-24,2,SJS,6,3,OTT,18,9,12,5,44,19,11,19,3,52,18,9,10,4,41,19,10,18,2,49,1,0,29,29,0.538462,0.461538,15,17
2021020303,2021-11-24,2,SEA,2,1,CAR,16,12,6,1,35,29,10,19,1,59,16,12,6,1,35,29,10,19,1,59,0,1,22,36,0.393443,0.606557,9,13
2021020304,2021-11-26,2,BOS,2,5,NYR,26,8,17,2,53,22,3,2,5,32,26,8,17,2,53,22,3,2,4,31,1,0,36,31,0.571429,0.428571,16,18
2021020305,2021-11-26,2,BUF,4,1,MTL,29,16,13,3,61,24,10,8,1,43,29,16,13,3,61,24,10,8,1,43,1,0,39,26,0.490566,0.509434,4,2
2021020306,2021-11-26,2,TBL,3,0,SEA,20,10,16,3,49,15,4,10,0,29,20,9,15,3,47,15,4,10,0,29,1,0,26,17,0.487179,0.512821,4,4
2021020307,2021-11-26,2,NYI,0,1,PIT,21,6,13,0,40,28,15,17,1,61,21,6,13,0,40,27,15,17,1,60,0,1,25,30,0.586957,0.413043,6,8
2021020308,2021-11-26,2,PHI,3,6,CAR,16,11,9,2,38,27,9,16,6,58,16,11,9,2,38,27,9,16,6,58,1,0,23,36,0.533333,0.466667,10,8
2021020309,2021-11-26,2,WSH,4,3,FLA,22,9,12,2,45,18,15,9,3,45,22,9,12,2,45,18,15,9,3,45,0,1,29,22,0.52381,0.47619,6,6
2021020310,2021-11-26,2,CBJ,4,2,VAN,17,9,12,3,41,34,10,18,2,64,17,9,12,3,41,34,10,18,2,64,1,0,21,41,0.5625,0.4375,4,2
2021020311,2021-11-26,2,CHI,3,2,STL,22,10,14,3,49,22,7,11,1,41,22,10,14,2,48,21,7,11,1,40,0,1,27,25,0.489796,0.510204,7,11
2021020312,2021-11-26,2,NSH,4,2,NJD,25,12,7,4,48,22,13,11,2,48,24,11,7,3,45,22,12,11,2,47,1,0,31,25,0.433962,0.566038,6,6
2021020313,2021-11-26,2,DAL,3,1,COL,12,15,8,2,37,33,12,9,1,55,12,15,8,2,37,33,12,9,1,55,1,0,22,37,0.583333,0.416667,6,6
2021020314,2021-11-26,2,MIN,7,1,WPG,21,8,6,7,42,20,14,10,0,44,21,8,6,7,42,20,14,10,0,44,1,0,38,31,0.45283,0.54717,8,10
2021020315,2021-11-26,2,ANA,4,0,OTT,22,11,18,3,54,20,11,2,0,33,22,11,18,3,54,20,11,2,0,33,1,0,33,34,0.461538,0.538462,18,16
2021020316,2021-11-26,2,SJS,1,4,TOR,32,8,8,1,49,23,5,8,3,39,31,7,8,1,47,22,5,7,3,37,0,1,35,33,0.403846,0.596154,6,8
2021020317,2021-11-27,2,DET,3,2,BUF,32,8,7,3,50,26,4,15,2,47,31,8,7,2,48,26,4,15,2,47,0,1,41,28,0.557692,0.442308,2,8
2021020318,2021-11-27,2,FLA,1,4,SEA,30,10,21,1,62,21,5,10,3,39,30,10,21,1,62,21,5,9,3,38,0,1,34,27,0.28,0.72,6,4
2021020319,2021-11-27,2,PIT,3,6,MTL,41,10,11,2,64,22,10,10,6,48,41,10,11,2,64,22,10,10,6,48,0,1,50,33,0.557143,0.442857,8,6
2021020320,2021-11-27,2,STL,6,3,CBJ,21,13,5,6,45,19,8,14,1,42,21,13,5,6,45,19,8,14,1,42,0,1,33,27,0.464286,0.535714,10,4
2021020321,2021-11-27,2,COL,6,2,NSH,21,10,19,4,54,22,11,9,2,44,21,10,19,4,54,19,11,8,2,40,1,0,35,28,0.516667,0.483333,21,12
2021020322,2021-11-27,2,CGY,2,4,WPG,28,11,16,1,56,15,4,6,4,29,26,11,16,1,54,15,4,6,4,29,1,0,36,28,0.528302,0.471698,19,8
2021020323,2021-11-27,2,ARI,2,3,DAL,20,9,16,2,47,24,7,12,3,46,20,9,16,2,47,23,6,12,3,44,0,1,27,29,0.389831,0.610169,2,4
2021020324,2021-11-27,2,VGK,2,3,EDM,33,7,16,2,58,20,5,13,3,41,33,7,16,2,58,20,5,13,3,41,0,1,38,30,0.446429,0.553571,4,2
2021020325,2021-11-27,2,LAK,4,2,OTT,19,8,9,3,39,23,3,14,2,42,18,8,9,3,38,22,3,14,2,41,1,0,37,32,0.557692,0.442308,16,14
2021020326,2021-11-28,2,BOS,3,2,VAN,35,7,8,1,51,25,5,10,1,41,35,7,8,1,51,25,5,10,1,41,0,1,42,38,0.507692,0.492308,8,6
2021020327,2021-11-28,2,NJD,5,2,PHI,25,12,19,5,61,20,16,13,1,50,25,12,19,5,61,20,16,13,1,50,1,0,35,25,0.457627,0.542373,11,11
2021020328,2022-03-17,2,NYR,1,2,NYI,24,6,11,0,41,18,9,6,1,34,24,6,11,0,41,18,9,6,1,34,0,1,30,28,0.578947,0.421053,6,6
2021020329,2021-11-28,2,CAR,2,4,WSH,25,16,11,2,54,17,10,13,3,43,25,16,11,2,54,17,10,13,3,43,0,1,32,25,0.548387,0.451613,12,8
2021020330,2021-11-28,2,CHI,0,2,SJS,27,12,28,0,67,19,9,16,2,46,27,12,28,0,67,19,9,16,2,46,0,1,29,22,0.468085,0.531915,2,4
2021020331,2021-11-28,2,MIN,4,2,TBL,27,12,9,4,52,20,9,13,2,44,27,12,9,4,52,20,9,13,2,44,1,0,37,30,0.415094,0.584906,6,6
2021020332,2021-11-28,2,ANA,1,5,TOR,36,9,9,1,55,24,14,8,5,51,36,9,9,1,55,24,14,8,5,51,0,1,40,31,0.622222,0.377778,2,2
2021020333,2021-11-29,2,BUF,4,7,SEA,24,8,8,3,43,24,6,9,5,44,24,8,8,3,43,24,6,9,5,44,0,1,36,32,0.532258,0.467742,0,8
2021020334,2021-11-29,2,MTL,1,2,VAN,30,8,17,1,56,39,6,16,1,62,29,8,17,1,55,38,6,15,1,60,0,1,34,42,0.5,0.5,4,4
2021020335,2021-11-29,2,WPG,0,1,ARI,39,7,12,0,58,12,11,5,1,29,39,7,12,0,58,12,10,5,1,28,0,1,46,15,0.55102,0.44898,2,12
2021020336,2021-11-29,2,CGY,2,1,PIT,36,19,20,3,78,25,7,6,1,39,28,15,18,1,62,19,5,6,0,30,1,0,32,22,0.4375,0.5625,4,2
2021020337,2021-11-30,2,BOS,1,2,DET,34,8,11,0,53,12,8,7,2,29,34,8,11,0,53,10,7,5,2,24,0,1,42,16,0.47619,0.52381,4,8
2021020338,2021-11-30,2,FLA,5,4,WSH,37,12,6,2,57,19,8,8,4,39,37,12,6,2,57,19,8,8,4,39,0,1,51,27,0.514706,0.485294,8,12
2021020339,2021-11-30,2,NJD,2,5,SJS,31,14,15,2,62,21,8,15,4,48,31,14,15,2,62,21,8,15,4,48,0,1,34,31,0.413793,0.586207,6,2
2021020340,2022-01-18,2,PHI,3,4,NYI,30,15,15,2,62,29,8,16,4,57,24,10,13,2,49,17,6,16,3,42,0,1,34,31,0.560606,0.439394,9,11
2021020341,2021-11-30,2,STL,4,3,TBL,26,11,10,3,50,24,15,13,2,54,24,11,10,2,47,21,13,13,2,49,0,1,33,33,0.525424,0.474576,8,8
2021020342,2021-11-30,2,NSH,6,0,CBJ,22,8,14,5,49,23,9,11,0,43,22,8,14,5,49,23,9,11,0,43,1,0,37,27,0.612903,0.387097,13,17
2021020343,2021-11-30,2,DAL,4,1,CAR,10,7,9,4,30,36,14,17,1,68,10,7,9,4,30,36,14,17,1,68,1,0,17,40,0.57377,0.42623,8,6
2021020344,2021-11-30,2,MIN,5,2,ARI,27,6,7,5,45,26,12,8,2,48,27,6,7,5,45,26,12,8,2,48,0,1,37,31,0.491228,0.508772,11,15
2021020345,2021-11-30,2,LAK,4,5,ANA,28,13,12,5,58,29,12,7,5,53,26,11,11,4,52,26,11,7,3,47,0,1,34,36,0.557692,0.442308,4,2
2021020346,2021-12-01,2,TOR,8,3,COL,31,8,6,8,53,24,12,15,2,53,30,8,6,7,51,23,12,15,2,52,1,0,41,31,0.65625,0.34375,10,6
2021020347,2021-12-01,2,OTT,2,6,VAN,14,8,5,1,28,23,12,19,4,58,14,8,4,1,27,22,12,15,2,51,0,1,21,35,0.507937,0.492063,14,12
2021020348,2021-12-01,2,DET,4,3,SEA,19,8,10,4,41,20,12,8,3,43,19,5,8,2,34,18,10,7,2,37,1,0,26,24,0.530612,0.469388,6,6
2021020349,2021-12-01,2,NYR,4,1,PHI,23,4,10,3,40,19,12,10,1,42,23,4,10,3,40,19,12,10,1,42,1,0,28,34,0.490196,0.509804,19,4
2021020350,2021-12-01,2,EDM,5,2,PIT,13,4,8,5,30,28,12,15,2,57,13,4,8,4,29,28,12,15,2,57,1,0,22,34,0.482759,0.517241,6,6
2021020351,2021-12-01,2,ANA,6,5,VGK,25,5,10,5,45,22,7,20,1,50,25,5,10,5,45,22,7,20,1,50,1,0,34,39,0.376623,0.623377,8,6
2021020352,2021-12-02,2,MTL,1,4,COL,17,7,10,0,34,20,13,16,3,52,17,6,9,0,32,20,11,16,3,50,0,1,20,34,0.571429,0.428571,8,12
2021020353,2021-12-02,2,TBL,4,2,STL,28,8,9,3,48,21,9,17,0,47,28,8,9,3,48,21,9,17,0,47,1,0,35,28,0.54386,0.45614,8,6
2021020354,2021-12-02,2,FLA,7,4,BUF,31,6,17,6,60,17,6,11,4,38,31,6,17,6,60,17,6,11,4,38,0,1,45,31,0.47619,0.52381,8,8
2021020355,2021-12-02,2,NYI,1,2,SJS,23,9,18,1,51,27,13,14,2,56,22,9,18,1,50,27,13,14,1,55,1,0,25,35,0.553191,0.446809,6,0
2021020356,2021-12-02,2,WSH,3,4,CHI,25,16,14,3,58,23,10,13,3,49,21,13,12,3,49,20,9,13,2,44,0,1,28,28,0.5,0.5,4,2
2021020357,2021-12-02,2,CAR,2,3,OTT,32,13,14,1,60,15,13,8,3,39,32,13,14,1,60,15,13,8,3,39,0,1,49,20,0.61194,0.38806,6,8
2021020358,2021-12-02,2,NSH,0,2,BOS,36,12,18,0,66,24,12,5,1,42,36,12,18,0,66,24,12,5,1,42,0,1,42,33,0.491803,0.508197,10,4
2021020359,2021-12-02,2,DAL,3,2,CBJ,30,11,19,3,63,18,13,6,2,39,30,11,19,3,63,18,13,6,2,39,1,0,37,22,0.603774,0.396226,4,2
2021020360,2021-12-02,2,MIN,5,2,NJD,27,14,12,5,58,24,6,11,2,43,27,14,12,5,58,24,6,11,2,43,1,0,38,31,0.548387,0.451613,8,10
2021020361,2021-12-02,2,LAK,2,3,CGY,35,17,12,2,66,21,12,10,1,44,35,17,12,2,66,21,12,10,1,44,1,0,42,32,0.537037,0.462963,8,4
2021020362,2021-12-03,2,NYR,1,0,SJS,23,10,15,0,48,26,12,8,0,46,23,10,15,0,48,26,12,8,0,46,1,0,27,28,0.422222,0.577778,4,6
2021020363,2021-12-03,2,WPG,8,4,NJD,27,7,9,7,50,29,10,8,3,50,27,7,9,7,50,29,10,8,3,50,1,0,40,37,0.627119,0.372881,4,8
2021020364,2021-12-03,2,ARI,1,7,VGK,24,11,11,1,47,19,8,9,5,41,23,11,11,1,46,19,7,9,5,40,0,1,30,32,0.578947,0.421053,11,13
2021020365,2021-12-03,2,ANA,3,4,CGY,31,9,17,2,59,32,13,9,5,59,26,8,15,2,51,29,12,9,3,53,1,0,34,36,0.551724,0.448276,4,18
2021020366,2021-12-03,2,SEA,4,3,EDM,24,8,9,4,45,24,11,12,2,49,23,8,9,4,44,24,11,12,2,49,1,0,34,32,0.533333,0.466667,8,8
2021020367,2021-12-04,2,BOS,2,3,TBL,35,21,18,2,76,20,16,10,2,48,34,19,18,2,73,17,16,10,1,44,0,1,39,25,0.58209,0.41791,4,2
2021020368,2021-12-04,2,OTT,6,5,COL,26,9,10,5,50,23,12,16,4,55,26,9,10,4,49,22,11,16,4,53,0,1,34,31,0.617284,0.382716,4,6
2021020369,2021-12-04,2,DET,4,3,NYI,21,7,16,4,48,19,11,18,0,48,17,5,15,3,40,18,10,17,0,45,0,1,30,23,0.418182,0.581818,11,21
2021020370,2021-12-04,2,FLA,4,3,STL,44,18,13,3,78,16,2,8,3,29,42,17,13,3,75,16,2,7,2,27,0,1,51,25,0.47619,0.52381,4,10
2021020371,2021-12-04,2,NYR,3,2,CHI,19,4,9,2,34,21,8,16,2,47,19,4,9,2,34,21,8,16,2,47,0,1,31,27,0.425926,0.574074,2,8
2021020372,2021-12-04,2,WSH,3,1,CBJ,28,7,19,3,57,14,11,14,1,40,28,7,19,3,57,14,11,14,1,40,1,0,32,18,0.340909,0.659091,0,2
2021020373,2021-12-04,2,CAR,6,2,BUF,21,7,11,5,44,28,13,11,1,53,21,7,11,5,44,28,13,11,1,53,1,0,29,34,0.629032,0.370968,17,0
2021020374,2021-12-04,2,NSH,4,3,MTL,30,13,11,4,58,11,10,6,2,29,28,13,10,3,54,8,7,5,2,22,1,0,44,23,0.523077,0.476923,18,20
2021020375,2021-12-04,2,MIN,4,3,TOR,27,9,12,2,50,33,8,14,1,56,25,8,10,2,45,29,8,13,1,51,1,0,40,42,0.478873,0.521127,15,15
2021020376,2021-12-04,2,VAN,1,4,PIT,18,12,11,1,42,29,10,16,2,57,17,12,9,1,39,28,9,16,2,55,0,1,23,44,0.428571,0.571429,24,8
2021020377,2021-12-05,2,NYI,2,3,CHI,20,12,9,1,42,19,12,13,2,46,17,11,9,1,38,16,12,11,1,40,0,1,24,26,0.583333,0.416667,4,8
2021020378,2021-12-05,2,PHI,1,7,TBL,38,9,17,0,64,19,8,9,5,41,38,9,17,0,64,19,8,9,5,41,0,1,39,27,0.490909,0.509091,8,10
2021020379,2021-12-05,2,CBJ,6,4,SJS,24,10,14,6,54,30,14,11,4,59,24,10,14,6,54,30,14,11,4,59,1,0,30,34,0.506849,0.493151,0,2
2021020380,2021-12-05,2,WPG,6,3,TOR,27,8,7,3,45,25,8,16,1,50,26,8,7,3,44,23,4,16,1,44,1,0,41,35,0.523077,0.476923,21,31
2021020381,2021-12-05,2,EDM,1,5,LAK,17,5,17,0,39,30,10,8,2,50,17,4,17,0,38,29,10,8,2,49,0,1,22,40,0.528302,0.471698,19,6
2021020382,2021-12-05,2,VGK,3,2,CGY,20,13,13,3,49,19,10,15,2,46,20,13,13,3,49,18,10,15,2,45,1,0,28,25,0.471429,0.528571,6,8
2021020383,2021-12-06,2,PHI,5,7,COL,24,7,15,3,49,33,8,10,3,54,24,7,15,3,49,33,8,10,3,54,1,0,32,50,0.544118,0.455882,10,6
2021020384,2021-12-06,2,WSH,4,3,ANA,26,17,14,6,63,33,9,10,5,57,24,17,12,3,56,30,8,7,3,48,1,0,29,34,0.490566,0.509434,7,7
2021020385,2021-12-06,2,DAL,4,1,ARI,18,6,15,3,42,18,3,10,1,32,18,6,15,3,42,18,3,10,1,32,1,0,27,19,0.527273,0.472727,2,8
2021020386,2021-12-06,2,VAN,4,0,LAK,22,13,9,2,46,29,7,10,0,46,22,13,9,2,46,29,7,10,0,46,1,0,30,31,0.526316,0.473684,4,8
2021020387,2021-12-06,2,SEA,1,6,PIT,26,8,11,1,46,24,8,6,6,44,26,8,11,1,46,24,8,6,6,44,0,1,29,31,0.428571,0.571429,0,2
2021020388,2021-12-07,2,BUF,0,2,ANA,20,13,24,0,57,21,10,7,2,40,20,13,24,0,57,21,10,7,2,40,0,1,25,23,0.489796,0.510204,2,6
2021020389,2021-12-07,2,TOR,5,4,CBJ,33,8,8,3,52,24,18,19,3,64,33,8,8,3,52,24,18,19,3,64,1,0,40,32,0.516667,0.483333,4,6
2021020390,2021-12-07,2,MTL,2,3,TBL,20,8,7,2,37,21,9,16,3,49,20,8,7,2,37,21,9,16,3,49,0,1,23,27,0.510204,0.489796,13,19
2021020391,2021-12-07,2,OTT,3,5,NYI,17,14,10,1,42,16,13,6,5,40,17,13,9,1,40,15,12,6,4,37,0,1,33,27,0.422222,0.577778,8,14
2021020392,2021-12-07,2,DET,2,5,NSH,12,5,15,1,33,26,8,14,4,52,12,5,15,1,33,26,8,14,4,52,0,1,16,33,0.561404,0.438596,16,14
2021020393,2021-12-07,2,CHI,2,6,NYR,19,12,12,2,45,21,6,8,4,39,19,12,12,2,45,21,6,8,4,39,0,1,26,30,0.558824,0.441176,13,27
2021020394,2021-12-07,2,STL,4,3,FLA,19,8,5,3,35,29,9,11,3,52,19,8,5,2,34,29,8,11,3,51,0,1,30,40,0.5,0.5,12,12
2021020395,2021-12-07,2,WPG,2,4,CAR,12,4,13,1,30,25,9,16,2,52,11,4,12,0,27,24,9,16,2,51,0,1,18,34,0.428571,0.571429,6,23
2021020396,2021-12-07,2,EDM,1,4,MIN,26,17,11,1,55,19,7,8,3,37,26,17,11,1,55,19,7,8,3,37,0,1,39,26,0.490566,0.509434,4,10
2021020397,2021-12-07,2,SJS,5,3,CGY,18,9,14,3,44,34,16,18,3,71,18,9,14,3,44,34,16,18,3,71,0,1,27,43,0.408163,0.591837,6,4
2021020398,2021-12-08,2,NJD,3,0,PHI,22,10,13,2,47,23,7,6,0,36,22,10,13,2,47,23,7,6,0,36,1,0,27,25,0.322034,0.677966,4,6
2021020399,2021-12-08,2,NYR,3,7,COL,23,8,9,2,42,27,2,16,6,51,23,8,9,2,42,27,2,16,6,51,0,1,30,39,0.509804,0.490196,17,27
2021020400,2021-12-08,2,VAN,2,1,BOS,29,16,16,2,63,30,10,12,0,52,25,15,15,0,55,25,9,12,0,46,1,0,32,36,0.477612,0.522388,8,8
2021020401,2021-12-08,2,VGK,5,4,DAL,35,11,20,5,71,18,11,10,1,40,35,11,20,5,71,18,11,10,1,40,0,1,45,23,0.35,0.65,6,6
2021020402,2021-12-09,2,TOR,3,5,TBL,33,16,14,1,64,19,10,8,4,41,33,16,14,1,64,19,10,8,4,41,1,0,38,27,0.666667,0.333333,6,4
2021020403,2021-12-09,2,MTL,0,2,CHI,26,11,10,0,47,21,10,10,1,42,26,11,10,0,47,21,10,10,1,42,0,1,30,25,0.534884,0.465116,4,2
2021020404,2021-12-09,2,NYI,3,4,NSH,16,8,12,2,38,22,10,12,4,48,16,8,12,2,38,22,10,12,4,48,1,0,21,29,0.425926,0.574074,7,9
2021020405,2021-12-09,2,CBJ,1,2,ANA,29,14,10,2,55,26,8,10,3,47,27,11,9,1,48,24,8,9,1,42,1,0,34,26,0.483333,0.516667,2,4
2021020406,2021-12-09,2,STL,6,2,DET,15,9,10,6,40,28,8,11,2,49,15,9,10,6,40,28,8,11,2,49,1,0,26,31,0.372093,0.627907,2,6
2021020407,2021-12-09,2,CGY,1,2,CAR,20,10,10,1,41,18,6,9,2,35,16,10,10,1,37,15,6,8,1,30,0,1,27,26,0.508772,0.491228,6,10
2021020408,2021-12-09,2,EDM,2,3,BOS,31,10,14,0,55,26,6,6,1,39,29,10,14,0,53,25,6,5,1,37,0,1,43,30,0.430769,0.569231,8,12
2021020409,2021-12-09,2,LAK,4,0,DAL,29,13,12,4,58,19,14,11,0,44,29,13,12,4,58,19,14,11,0,44,1,0,41,27,0.490566,0.509434,6,4
2021020410,2021-12-09,2,SJS,2,5,MIN,28,10,9,1,48,20,11,14,3,48,27,10,9,1,47,20,11,14,3,48,0,1,35,27,0.571429,0.428571,6,6
2021020411,2021-12-09,2,SEA,0,3,WPG,23,9,13,0,45,27,16,10,3,56,22,8,13,0,43,25,16,10,3,54,0,1,25,33,0.527273,0.472727,4,10
2021020412,2021-12-10,2,BUF,1,2,NYR,33,6,13,1,53,26,6,10,1,43,33,6,13,1,53,26,6,10,1,43,0,1,37,31,0.472727,0.527273,11,11
2021020413,2021-12-10,2,NJD,2,3,NSH,24,15,6,2,47,20,12,9,2,43,24,15,6,2,47,20,12,9,2,43,1,0,31,27,0.481481,0.518519,11,15
2021020414,2021-12-10,2,WSH,2,4,PIT,25,11,11,2,49,26,6,11,4,47,25,11,11,2,49,26,6,11,4,47,0,1,31,33,0.40678,0.59322,2,4
2021020415,2021-12-10,2,COL,7,3,DET,34,10,14,7,65,23,8,7,2,40,34,10,14,7,65,23,8,7,2,40,1,0,47,40,0.5,0.5,8,6
2021020416,2021-12-10,2,ARI,1,3,FLA,14,8,9,0,31,17,8,6,2,33,11,7,9,0,27,16,7,6,2,31,0,1,23,23,0.545455,0.454545,8,10
2021020417,2021-12-10,2,VAN,4,3,WPG,30,9,16,3,58,31,10,13,2,56,27,8,15,3,53,26,8,12,2,48,1,0,36,37,0.546875,0.453125,6,4
2021020418,2021-12-10,2,VGK,3,4,PHI,33,9,19,2,63,18,10,13,2,43,32,9,18,2,61,16,9,13,1,39,0,1,44,25,0.529412,0.470588,6,12
2021020419,2021-12-11,2,BUF,2,3,WSH,28,9,7,2,46,33,12,14,2,61,26,9,7,2,44,31,12,14,2,59,0,1,31,42,0.616667,0.383333,6,2
2021020420,2021-12-11,2,TOR,5,4,CHI,19,5,12,3,39,26,6,3,4,39,19,5,12,3,39,26,6,3,4,39,0,1,26,35,0.518519,0.481481,6,6
2021020421,2021-12-11,2,OTT,4,0,TBL,13,8,7,2,30,20,13,8,0,41,13,8,7,2,30,20,13,8,0,41,1,0,23,25,0.454545,0.545455,15,13
2021020422,2021-12-11,2,NYI,4,2,NJD,25,13,10,2,50,25,6,17,2,50,24,13,10,2,49,24,6,17,2,49,0,1,29,32,0.612903,0.387097,25,13
2021020423,2021-12-11,2,PIT,1,0,ANA,25,10,14,1,50,29,12,12,0,53,25,10,14,1,50,29,12,12,0,53,1,0,29,33,0.545455,0.454545,4,2
2021020424,2021-12-11,2,STL,4,1,MTL,28,5,7,2,42,18,13,6,1,38,28,5,7,2,42,18,13,6,1,38,1,0,37,23,0.5,0.5,2,6
2021020425,2021-12-11,2,CGY,2,4,BOS,28,15,17,1,61,21,5,6,4,36,26,15,17,1,59,21,5,6,4,36,0,1,42,27,0.5125,0.4875,4,10
2021020426,2021-12-11,2,EDM,1,3,CAR,18,11,11,1,41,24,12,8,2,46,18,11,11,1,41,24,12,8,2,46,0,1,23,31,0.508197,0.491803,4,4
2021020427,2021-12-11,2,ARI,3,5,PHI,28,9,13,3,53,25,7,13,4,49,28,9,13,3,53,25,7,13,4,49,0,1,32,34,0.470588,0.529412,6,4
2021020428,2021-12-11,2,LAK,2,1,MIN,24,15,18,2,59,26,9,8,0,43,24,15,18,2,59,26,9,8,0,43,0,1,37,31,0.641509,0.358491,4,10
2021020429,2021-12-11,2,SJS,2,1,DAL,22,9,9,2,42,26,9,27,1,63,22,9,9,2,42,26,9,27,1,63,1,0,25,35,0.471698,0.528302,6,4
2021020430,2021-12-11,2,SEA,4,5,CBJ,27,10,9,3,49,21,14,11,5,51,26,10,9,3,48,21,14,11,4,50,0,1,32,28,0.42623,0.57377,4,2
2021020431,2021-12-12,2,NYR,0,1,NSH,27,8,11,0,46,20,5,13,1,39,27,8,11,0,46,20,5,13,1,39,0,1,32,24,0.458333,0.541667,2,4
2021020432,2021-12-12,2,STL,2,3,ANA,18,7,7,2,34,36,9,8,3,56,17,6,7,2,32,34,8,8,2,52,0,1,25,39,0.4375,0.5625,2,2
2021020433,2021-12-12,2,COL,3,2,FLA,20,7,11,2,40,20,8,10,1,39,20,7,11,2,40,20,8,10,1,39,1,0,26,31,0.455882,0.544118,13,19
2021020434,2021-12-12,2,VAN,2,1,CAR,21,5,9,2,37,26,12,23,1,62,21,5,9,2,37,26,12,23,1,62,1,0,26,29,0.416667,0.583333,2,2
2021020435,2021-12-12,2,VGK,6,4,MIN,25,10,7,4,46,14,11,17,3,45,25,10,7,4,46,14,11,17,3,45,1,0,36,27,0.45614,0.54386,14,10
2021020436,2022-04-18,2,CHI,2,5,CGY,21,5,12,2,40,24,4,12,5,45,21,5,12,2,40,24,4,12,5,45,0,1,24,35,0.534483,0.465517,8,6
2021020437,2021-12-14,2,BOS,1,4,VGK,20,12,14,1,47,20,13,12,3,48,20,12,14,1,47,20,13,12,3,48,0,1,24,25,0.603774,0.396226,2,2
2021020438,2021-12-14,2,DET,2,1,NYI,31,7,11,1,50,32,9,15,1,57,31,7,11,1,50,32,9,15,1,57,1,0,39,34,0.509804,0.490196,2,6
2021020439,2021-12-14,2,TBL,3,2,LAK,21,11,7,3,42,26,4,6,1,37,19,11,6,2,38,25,3,5,1,34,0,1,30,30,0.488889,0.511111,4,6
2021020440,2021-12-14,2,FLA,2,8,OTT,23,8,22,2,55,24,4,9,5,42,23,8,22,2,55,24,4,9,5,42,0,1,35,38,0.432836,0.567164,37,21
2021020441,2021-12-14,2,PHI,6,1,NJD,23,14,11,5,53,20,8,8,1,37,21,13,11,4,49,20,8,8,1,37,1,0,30,27,0.525424,0.474576,10,2
2021020442,2021-12-14,2,PIT,5,2,MTL,20,9,8,4,41,26,6,15,2,49,20,9,8,4,41,26,6,15,2,49,1,0,31,30,0.631579,0.368421,4,10
2021020443,2022-04-19,2,NSH,3,2,CGY,24,14,11,1,50,16,6,16,1,39,22,13,11,1,47,13,6,14,1,34,1,0,27,21,0.589286,0.410714,6,10
2021020444,2021-12-14,2,DAL,1,4,STL,26,12,10,1,49,21,8,12,2,43,26,12,10,1,49,21,8,12,2,43,1,0,34,29,0.436364,0.563636,10,2
2021020445,2022-02-12,2,MIN,3,2,CAR,20,12,4,3,39,31,5,14,1,51,19,12,4,3,38,31,5,14,1,51,1,0,27,39,0.45,0.55,10,6
2021020446,2021-12-14,2,WPG,2,4,BUF,30,17,9,2,58,21,11,2,3,37,30,17,9,2,58,21,11,2,3,37,0,1,36,27,0.612245,0.387755,4,6
2021020447,2021-12-14,2,COL,4,2,NYR,18,7,14,3,42,23,13,10,2,48,18,7,14,3,42,22,13,10,2,47,1,0,31,28,0.464286,0.535714,9,17
2021020448,2021-12-14,2,EDM,1,5,TOR,29,8,12,1,50,15,10,8,4,37,29,8,12,1,50,14,10,8,4,36,0,1,36,25,0.529412,0.470588,6,4
2021020449,2021-12-14,2,VAN,4,3,CBJ,32,15,13,3,63,18,11,22,3,54,31,14,13,2,60,18,11,22,3,54,0,1,39,23,0.534247,0.465753,4,6
2021020450,2021-12-14,2,SJS,1,3,SEA,31,7,12,1,51,27,5,15,3,50,31,7,12,1,51,27,5,15,3,50,0,1,34,30,0.512821,0.487179,0,2
2021020451,2021-12-15,2,CHI,5,4,WSH,18,9,10,2,39,35,8,15,3,61,17,9,10,1,37,33,8,15,3,59,0,1,28,46,0.62963,0.37037,6,12
2021020452,2021-12-15,2,ARI,2,3,NYR,26,11,9,1,47,26,8,7,1,42,26,11,9,1,47,25,8,7,1,41,1,0,31,30,0.339286,0.660714,8,6
2021020453,2021-12-15,2,ANA,4,1,SEA,20,11,12,2,45,16,7,14,0,37,20,11,12,2,45,16,6,14,0,36,1,0,24,20,0.55,0.45,10,6
2021020454,2021-12-16,2,MTL,3,2,PHI,32,14,10,3,59,35,7,14,2,58,29,12,10,2,53,27,6,14,2,49,1,0,40,39,0.4,0.6,4,4
2021020455,2021-12-16,2,TBL,2,1,OTT,20,17,7,1,45,22,10,9,1,42,19,16,7,1,43,22,10,9,1,42,0,1,27,26,0.5,0.5,4,10
2021020456,2021-12-16,2,FLA,1,4,LAK,34,7,13,1,55,22,8,10,4,44,34,7,13,1,55,22,8,10,4,44,1,0,42,31,0.320755,0.679245,4,8
2021020457,2021-12-16,2,NJD,3,5,VGK,20,12,12,1,45,21,13,8,4,46,20,12,12,1,45,21,13,8,4,46,1,0,26,30,0.516667,0.483333,18,26
2021020458,2021-12-16,2,NYI,3,1,BOS,16,7,10,2,35,37,9,11,1,58,15,5,10,2,32,34,9,10,1,54,1,0,28,41,0.576923,0.423077,11,15
2021020459,2021-12-16,2,CAR,5,3,DET,26,15,12,4,57,17,17,10,3,47,26,15,12,4,57,17,17,10,3,47,1,0,33,26,0.6,0.4,6,2
2021020460,2021-12-16,2,NSH,5,2,COL,26,6,10,3,45,19,10,8,1,38,26,6,10,3,45,19,10,8,1,38,1,0,35,26,0.472727,0.527273,8,10
2021020461,2021-12-16,2,MIN,2,3,BUF,27,14,7,2,50,33,12,10,3,58,22,12,7,2,43,30,10,10,2,52,1,0,32,40,0.509434,0.490566,4,4
2021020462,2022-02-10,2,CGY,5,2,TOR,16,8,9,4,37,34,10,11,2,57,16,8,9,4,37,34,10,11,2,57,0,1,26,48,0.413793,0.586207,12,16
2021020463,2021-12-16,2,EDM,5,2,CBJ,33,9,5,3,50,29,8,18,2,57,32,9,5,3,49,28,8,18,2,56,1,0,45,38,0.491228,0.508772,6,10
2021020464,2021-12-16,2,SJS,2,5,VAN,30,8,12,2,52,23,6,14,4,47,30,8,12,2,52,23,6,14,4,47,0,1,36,30,0.425532,0.574468,6,2
2021020465,2021-12-17,2,NYR,2,3,VGK,27,10,7,1,45,28,17,17,3,65,17,8,7,1,33,22,16,17,2,57,0,1,29,30,0.610169,0.389831,2,4
2021020466,2021-12-17,2,PIT,3,2,BUF,36,14,9,2,61,18,7,7,2,34,35,12,9,1,57,16,7,7,2,32,1,0,48,21,0.545455,0.454545,16,18
2021020467,2021-12-17,2,CHI,2,3,NSH,15,6,13,2,36,24,7,17,1,49,14,6,13,2,35,22,7,16,0,45,0,1,19,31,0.54717,0.45283,10,10
2021020468,2021-12-17,2,STL,4,1,DAL,26,5,7,3,41,23,11,20,1,55,26,5,7,3,41,23,11,20,1,55,1,0,34,27,0.47541,0.52459,6,4
2021020469,2021-12-17,2,WPG,2,5,WSH,33,8,16,1,58,28,9,12,5,54,33,8,16,1,58,28,9,12,5,54,0,1,42,39,0.516129,0.483871,4,6
2021020470,2021-12-17,2,ANA,5,6,ARI,26,5,10,3,44,16,6,2,5,29,25,4,10,3,42,14,6,2,4,26,0,1,37,27,0.515625,0.484375,18,20
2021020471,2022-04-24,2,MTL,3,5,BOS,15,12,13,1,41,37,8,10,5,60,13,12,13,1,39,32,8,10,3,53,0,1,26,42,0.517241,0.482759,8,14
2021020472,2021-12-18,2,DET,5,2,NJD,24,6,12,5,47,29,11,15,1,56,24,6,12,5,47,29,11,15,1,56,1,0,30,33,0.519231,0.480769,6,8
2021020473,2021-12-18,2,PHI,4,3,OTT,30,9,14,4,57,26,10,11,2,49,29,9,13,3,54,24,9,10,2,45,1,0,38,31,0.535714,0.464286,9,11
2021020474,2021-12-18,2,CAR,5,1,LAK,24,14,8,3,49,30,11,7,1,49,24,14,8,3,49,30,11,7,1,49,1,0,33,33,0.584906,0.415094,6,10
2021020475,2021-12-18,2,DAL,4,3,CHI,23,8,12,1,44,19,8,9,2,38,22,7,10,1,40,18,8,9,2,37,1,0,39,23,0.614035,0.385965,6,25
2021020476,2022-02-18,2,MIN,2,6,FLA,18,5,8,0,31,29,9,13,5,56,18,5,8,0,31,29,9,13,5,56,1,0,26,36,0.517857,0.482143,6,10
2021020477,2022-02-10,2,COL,3,2,TBL,38,5,22,3,68,30,6,20,2,58,36,5,21,1,63,28,6,19,2,55,1,0,47,38,0.514706,0.485294,8,8
2021020478,2022-02-15,2,CGY,6,2,CBJ,32,12,8,5,57,18,17,7,2,44,32,12,8,5,57,18,17,7,2,44,1,0,41,20,0.5,0.5,2,4
2021020479,2022-02-12,2,VAN,3,2,TOR,17,11,2,2,32,41,18,15,0,74,17,11,2,2,32,41,18,15,0,74,1,0,24,53,0.454545,0.545455,6,10
2021020480,2021-12-18,2,SEA,3,5,EDM,12,8,5,3,28,29,12,17,4,62,12,8,4,3,27,29,12,17,4,62,1,0,17,41,0.42,0.58,11,9
2021020481,2022-02-19,2,OTT,2,3,BOS,27,11,10,2,50,29,11,11,3,54,23,11,9,2,45,28,10,10,2,50,0,1,31,33,0.490909,0.509091,6,10
2021020482,2021-12-19,2,NJD,2,3,PIT,10,9,12,1,32,19,11,8,2,40,8,9,9,1,27,18,11,8,2,39,0,1,19,22,0.487805,0.512195,8,14
2021020483,2021-12-19,2,NYI,3,4,VGK,26,6,7,2,41,30,8,11,4,53,18,5,5,2,30,28,7,10,2,47,0,1,32,34,0.542373,0.457627,7,11
2021020484,2021-12-19,2,WSH,2,3,LAK,25,7,14,2,48,17,7,8,2,34,25,6,14,2,47,16,7,8,1,32,1,0,35,24,0.385714,0.614286,17,21
2021020485,2022-02-18,2,CAR,5,3,NSH,21,8,10,3,42,23,11,11,3,48,21,7,10,3,41,22,11,11,3,47,1,0,30,31,0.542373,0.457627,8,10
2021020486,2021-12-19,2,WPG,4,2,STL,24,7,12,3,46,19,13,9,1,42,24,7,12,3,46,19,13,9,1,42,1,0,34,28,0.418182,0.581818,11,11
2021020487,2022-02-08,2,VAN,5,1,ARI,19,6,8,3,36,30,6,13,1,50,19,6,8,3,36,29,5,13,1,48,1,0,29,36,0.596154,0.403846,15,13
2021020488,2022-02-14,2,SEA,2,6,TOR,18,12,19,1,50,14,8,10,3,35,18,12,19,1,50,14,8,10,3,35,0,1,25,25,0.40625,0.59375,4,8
2021020489,2022-02-10,2,BUF,3,4,CBJ,19,13,8,3,43,28,14,9,3,54,19,13,8,3,43,28,14,9,2,53,0,1,27,34,0.480769,0.519231,4,2
2021020490,2022-02-23,2,DET,2,5,COL,28,12,14,1,55,20,14,15,5,54,28,12,13,1,54,20,14,14,5,53,0,1,34,31,0.57377,0.42623,8,8
2021020491,2022-02-20,2,NYI,2,3,MTL,24,13,8,2,47,22,6,10,4,42,21,13,8,1,43,19,6,9,2,36,0,1,32,27,0.586957,0.413043,4,8
2021020492,2021-12-20,2,DAL,7,4,MIN,17,8,7,5,37,16,7,15,3,41,17,7,7,5,36,16,7,15,3,41,1,0,29,23,0.576923,0.423077,8,10
2021020493,2022-02-17,2,EDM,7,3,ANA,25,5,8,6,44,20,5,3,1,29,25,5,8,6,44,20,5,3,1,29,0,1,41,30,0.508772,0.491228,6,8
2021020494,2022-02-10,2,BOS,0,6,CAR,28,11,12,0,51,21,10,1,4,36,27,11,12,0,50,21,10,1,4,36,0,1,34,43,0.493151,0.506849,15,15
2021020495,2022-02-15,2,OTT,2,5,STL,15,8,9,1,33,26,14,12,4,56,15,8,9,1,33,26,14,12,4,56,0,1,20,36,0.507937,0.492063,8,8
2021020496,2022-02-17,2,PHI,3,5,WSH,24,7,11,2,44,17,6,11,4,38,23,6,10,2,41,17,6,10,4,37,0,1,33,25,0.610169,0.389831,13,25
2021020497,2022-02-24,2,PIT,1,6,NJD,35,9,12,0,56,26,3,9,4,42,35,8,11,0,54,26,3,8,4,41,0,1,38,36,0.527273,0.472727,12,10
2021020498,2022-02-20,2,CHI,2,5,FLA,16,8,12,2,38,20,9,12,5,46,16,8,11,2,37,20,9,11,4,44,0,1,24,25,0.435484,0.564516,9,15
2021020499,2022-02-12,2,NSH,2,5,WPG,28,6,10,1,45,26,7,8,2,43,26,5,10,1,42,25,7,8,1,41,1,0,36,43,0.54386,0.45614,45,18
2021020500,2022-02-16,2,CGY,6,2,ANA,25,9,4,4,42,16,2,6,1,25,24,9,4,3,40,16,2,6,1,25,1,0,43,28,0.55,0.45,15,15
2021020501,2021-12-21,2,VGK,3,4,TBL,33,6,14,2,55,12,10,14,3,39,33,6,14,2,55,12,10,14,3,39,0,1,41,19,0.375,0.625,4,4
2021020502,2022-02-17,2,SJS,4,5,VAN,19,14,15,2,50,19,11,14,5,49,18,12,15,2,47,15,10,9,4,38,0,1,28,27,0.6,0.4,12,10
2021020503,2022-02-09,2,SEA,2,5,ARI,28,7,14,2,51,21,17,9,5,52,28,7,14,2,51,21,17,9,5,52,0,1,36,27,0.466667,0.533333,4,4
2021020504,2022-02-19,2,BUF,3,5,COL,27,6,12,3,48,26,7,8,5,46,27,6,12,3,48,26,7,8,5,46,1,0,32,36,0.577778,0.422222,4,2
2021020505,2022-04-27,2,NYR,3,4,MTL,22,6,11,2,41,19,8,15,4,46,22,6,11,2,41,19,8,14,4,45,0,1,27,23,0.54902,0.45098,4,6
2021020506,2022-02-11,2,DAL,4,3,WPG,22,9,20,4,55,29,5,12,3,49,21,8,19,3,51,25,4,12,3,44,0,1,35,34,0.5,0.5,7,13
2021020507,2022-02-15,2,LAK,2,5,EDM,21,4,11,2,38,19,3,8,5,35,21,4,11,2,38,17,3,8,5,33,1,0,32,29,0.576923,0.423077,10,12
2021020508,2022-02-21,2,BOS,5,1,COL,30,4,2,4,40,25,7,10,0,42,30,4,2,4,40,25,7,10,0,42,1,0,45,29,0.612903,0.387097,8,6
2021020509,2022-02-19,2,TOR,3,6,STL,33,14,15,3,65,25,4,8,6,43,33,14,15,3,65,25,4,8,6,43,0,1,37,34,0.616667,0.383333,4,4
2021020510,2022-02-08,2,OTT,4,3,CAR,22,6,10,4,42,33,8,17,3,61,20,6,8,3,37,33,8,17,3,61,1,0,31,45,0.517857,0.482143,10,12
2021020511,2022-02-22,2,FLA,4,6,NSH,39,13,16,3,71,21,6,9,4,40,39,13,16,3,71,21,6,9,4,40,1,0,48,33,0.387097,0.612903,6,6
2021020512,2022-04-07,2,NJD,4,7,MTL,30,11,13,4,58,19,11,9,7,46,30,11,13,4,58,19,11,9,7,46,0,1,37,26,0.431034,0.568966,0,4
2021020513,2022-04-28,2,NYI,5,1,WSH,19,4,8,2,33,21,12,7,1,41,17,4,8,2,31,20,12,7,1,40,1,0,26,27,0.660714,0.339286,22,10
2021020514,2022-02-15,2,PIT,5,4,PHI,22,8,10,3,43,18,3,13,4,38,21,8,10,2,41,16,3,11,4,34,0,1,34,27,0.424242,0.575758,8,8
2021020515,2022-02-20,2,CBJ,7,3,BUF,25,11,8,7,51,32,10,11,3,56,25,11,8,7,51,31,9,11,3,54,1,0,39,36,0.493151,0.506849,4,6
2021020516,2022-02-18,2,CHI,0,1,DAL,34,12,15,1,62,28,8,10,2,48,25,11,15,0,51,23,4,9,0,36,0,0,34,29,0.487805,0.512195,6,4
2021020517,2022-02-14,2,MIN,7,4,DET,15,10,5,4,34,21,4,9,3,37,15,10,5,4,34,21,4,9,3,37,0,1,25,34,0.455882,0.544118,19,15
2021020518,2022-02-19,2,CGY,2,1,SEA,35,8,10,2,55,22,7,9,1,39,35,8,10,2,55,22,7,9,1,39,1,0,37,23,0.553571,0.446429,9,7
2021020519,2022-02-11,2,ARI,3,4,TBL,15,10,15,3,43,26,7,11,4,48,15,10,15,3,43,26,7,11,4,48,0,1,19,32,0.470588,0.529412,6,2
2021020520,2022-02-19,2,VAN,4,7,ANA,12,8,17,3,40,12,11,10,5,38,12,8,17,3,40,12,11,10,5,38,0,1,20,25,0.46,0.54,12,8
2021020521,2022-02-18,2,VGK,3,4,LAK,19,12,11,2,44,25,17,21,3,66,18,12,11,2,43,23,16,21,2,62,1,0,24,31,0.5,0.5,6,6
2021020522,2022-02-14,2,SJS,0,3,EDM,15,4,3,0,22,30,15,11,3,59,15,4,3,0,22,28,15,10,3,56,0,1,20,41,0.480769,0.519231,8,10
2021020523,2022-02-08,2,BOS,2,4,PIT,41,7,18,1,67,15,8,10,3,36,39,7,18,1,65,14,8,9,3,34,1,0,45,25,0.553571,0.446429,20,8
2021020524,2022-02-15,2,BUF,6,3,NYI,29,8,12,4,53,26,3,7,3,39,29,8,12,4,53,26,3,7,3,39,1,0,41,33,0.423729,0.576271,4,4
2021020525,2022-02-17,2,NYR,2,3,DET,38,13,17,2,70,30,8,10,4,52,32,10,13,1,56,23,6,10,2,41,0,1,39,33,0.454545,0.545455,8,4
2021020526,2022-02-13,2,WSH,1,4,OTT,27,7,17,0,51,20,7,8,3,38,27,7,17,0,51,20,7,8,3,38,0,1,34,26,0.59322,0.40678,15,13
2021020527,2022-02-16,2,CAR,2,3,FLA,12,8,9,2,31,22,12,9,3,46,10,7,8,2,27,22,12,7,2,43,1,0,18,31,0.428571,0.571429,12,10
2021020528,2022-02-22,2,CBJ,4,3,TOR,23,7,10,3,43,31,4,16,3,54,23,7,10,2,42,31,4,16,3,54,0,1,30,42,0.539683,0.460317,6,4
2021020529,2022-02-10,2,STL,4,7,NJD,22,9,11,4,46,21,11,13,7,52,22,9,10,4,45,18,11,12,6,47,0,1,31,29,0.447761,0.552239,8,10
2021020530,2022-02-09,2,DAL,4,3,NSH,14,12,11,2,39,19,9,14,3,45,14,12,11,2,39,19,8,14,3,44,1,0,27,23,0.460317,0.539683,10,14
2021020531,2022-02-08,2,WPG,2,0,MIN,19,9,12,1,41,23,7,13,0,43,19,9,12,1,41,23,7,13,0,43,1,0,29,27,0.714286,0.285714,17,23
2021020532,2022-03-07,2,CGY,3,1,EDM,18,7,5,2,32,22,5,13,1,41,18,7,5,2,32,22,5,13,1,41,1,0,29,28,0.545455,0.454545,10,20
2021020533,2022-02-19,2,ARI,3,5,LAK,17,9,7,3,36,28,12,11,3,54,17,9,7,3,36,28,12,11,3,54,1,0,23,39,0.386364,0.613636,8,6
2021020534,2022-02-21,2,VAN,5,2,SEA,33,8,8,4,53,20,6,15,1,42,33,8,8,4,53,20,6,15,1,42,1,0,46,27,0.515152,0.484848,8,8
2021020535,2022-02-16,2,VGK,0,2,COL,26,13,17,0,56,20,10,20,1,51,26,13,17,0,56,20,10,20,1,51,0,1,29,25,0.606557,0.393443,6,4
2021020536,2022-02-22,2,ANA,4,3,SJS,20,17,15,5,57,27,7,8,2,44,19,17,15,3,54,22,6,8,2,38,1,0,29,43,0.38806,0.61194,15,13
2021020537,2021-12-28,2,TBL,5,4,MTL,18,8,9,5,40,23,4,3,4,34,17,8,9,4,38,23,4,3,4,34,0,1,37,31,0.514706,0.485294,8,8
2021020538,2022-02-17,2,CHI,4,7,CBJ,24,4,16,3,47,23,10,17,6,56,24,4,16,3,47,23,10,17,6,56,0,1,32,37,0.425926,0.574074,6,8
2021020539,2021-12-28,2,LAK,3,6,VGK,18,10,11,2,41,13,11,6,4,34,17,10,11,2,40,13,11,6,4,34,0,1,27,27,0.6,0.4,8,8
2021020540,2021-12-28,2,SJS,8,7,ARI,17,12,6,9,44,29,9,7,5,50,16,11,6,7,40,25,7,7,5,44,1,0,27,46,0.431034,0.568966,13,13
2021020541,2021-12-29,2,BUF,3,4,NJD,19,6,13,3,41,37,15,14,3,69,19,6,13,3,41,37,15,14,3,69,0,1,22,42,0.487179,0.512821,19,7
2021020542,2022-02-17,2,TOR,4,1,PIT,22,9,12,2,45,37,10,6,1,54,22,9,12,2,45,37,10,6,1,54,1,0,29,46,0.555556,0.444444,10,4
2021020543,2022-02-12,2,OTT,0,2,BOS,28,15,17,0,60,28,9,10,2,49,28,14,17,0,59,28,9,9,2,48,0,1,30,37,0.436364,0.563636,6,6
2021020544,2021-12-29,2,FLA,4,3,NYR,26,13,15,4,58,25,6,8,3,42,25,13,13,4,55,23,6,8,3,40,0,1,32,33,0.552239,0.447761,6,6
2021020545,2022-03-24,2,NYI,5,2,DET,19,12,5,4,40,29,10,18,2,59,19,12,5,4,40,29,10,18,2,59,1,0,26,39,0.538462,0.461538,6,2
2021020546,2021-12-29,2,WSH,5,3,NSH,18,4,11,4,37,16,10,13,3,42,18,4,10,4,36,13,10,13,3,39,1,0,37,20,0.440678,0.559322,27,41
2021020547,2021-12-29,2,STL,4,2,EDM,21,10,7,3,41,23,11,9,2,45,21,10,7,3,41,23,11,9,2,45,1,0,33,28,0.56,0.44,2,8
2021020548,2022-02-14,2,WPG,1,3,CHI,28,15,14,1,58,20,10,13,3,46,28,15,14,1,58,20,10,13,3,46,0,1,32,24,0.619048,0.380952,2,2
2021020549,2022-02-15,2,COL,1,4,DAL,36,12,24,1,73,15,8,10,2,35,34,12,24,1,71,15,7,10,2,34,0,1,47,20,0.432836,0.567164,6,8
2021020550,2021-12-29,2,ANA,1,2,VAN,19,16,12,1,48,30,12,10,2,54,18,16,11,1,46,28,12,10,1,51,1,0,23,37,0.491228,0.508772,4,8
2021020551,2021-12-29,2,SEA,2,3,PHI,29,13,10,1,53,16,8,7,2,33,25,13,10,1,49,16,7,7,1,31,0,1,36,22,0.462963,0.537037,6,6
2021020552,2021-12-30,2,FLA,9,3,TBL,25,3,12,7,47,33,7,10,2,52,24,3,12,7,46,32,6,10,2,50,1,0,37,42,0.441176,0.558824,24,42
2021020553,2021-12-30,2,NYI,4,1,BUF,26,7,9,3,45,28,4,10,0,42,26,7,9,3,45,28,4,10,0,42,1,0,32,37,0.659574,0.340426,4,4
2021020554,2021-12-30,2,CAR,4,0,MTL,25,9,10,0,44,17,4,8,0,29,25,9,10,0,44,16,4,8,0,28,1,0,38,26,0.716667,0.283333,10,10
2021020555,2021-12-30,2,CBJ,4,3,NSH,21,11,11,5,48,30,9,11,3,53,18,9,9,3,39,26,8,11,2,47,0,1,29,34,0.457627,0.542373,11,11
2021020556,2021-12-30,2,LAK,2,1,VAN,33,20,16,1,70,16,8,12,0,36,28,20,15,1,64,14,8,10,0,32,1,0,35,18,0.529412,0.470588,6,4
2021020557,2021-12-30,2,SJS,3,2,PHI,32,14,18,2,66,19,10,15,2,46,30,13,15,1,59,17,10,14,2,43,0,1,46,25,0.462963,0.537037,11,13
2021020558,2021-12-30,2,SEA,4,6,CGY,14,7,10,3,34,22,9,14,4,49,14,6,9,3,32,21,9,14,4,48,1,0,22,40,0.4,0.6,12,6
2021020559,2022-02-10,2,OTT,0,2,PIT,22,15,14,0,51,36,11,12,2,61,22,15,14,0,51,36,11,12,2,61,0,1,26,44,0.510638,0.489362,4,2
2021020560,2021-12-31,2,DET,1,3,WSH,14,4,12,1,31,18,8,12,2,40,14,4,12,1,31,18,8,11,2,39,1,0,20,27,0.652174,0.347826,8,8
2021020561,2021-12-31,2,TBL,3,4,NYR,21,13,11,2,47,14,8,8,3,33,18,11,10,2,41,9,5,7,2,23,1,0,28,23,0.508197,0.491803,10,10
2021020562,2021-12-31,2,NJD,6,5,EDM,32,10,14,5,61,30,11,16,5,62,30,10,14,4,58,29,10,16,5,60,1,0,41,37,0.451613,0.548387,2,4
2021020563,2022-02-13,2,DAL,0,4,COL,20,11,14,0,45,22,13,16,4,55,20,11,14,0,45,22,13,16,4,55,0,1,23,30,0.588235,0.411765,2,6
2021020564,2022-02-21,2,CGY,3,1,WPG,22,15,7,2,46,19,5,8,1,33,21,13,7,2,43,19,5,8,1,33,1,0,31,23,0.510638,0.489362,6,8
2021020565,2021-12-31,2,VGK,3,1,ANA,28,14,12,3,57,15,6,10,0,31,27,14,12,3,56,15,6,10,0,31,1,0,45,16,0.509434,0.490566,21,41
2021020566,2022-01-01,2,BOS,4,3,BUF,29,13,5,4,51,13,10,8,2,33,29,13,5,3,50,12,10,8,2,32,0,1,41,22,0.513514,0.486486,8,8
2021020567,2022-01-01,2,TOR,6,0,OTT,24,14,10,3,51,20,4,8,0,32,23,13,10,3,49,19,4,8,0,31,1,0,40,23,0.639344,0.360656,6,12
2021020568,2022-01-01,2,FLA,5,2,MTL,35,8,15,4,62,23,3,14,2,42,35,8,15,4,62,22,3,13,1,39,1,0,48,31,0.561404,0.438596,11,15
2021020569,2022-01-01,2,NYI,3,2,EDM,22,9,15,2,48,17,13,14,2,46,18,8,13,1,40,17,11,13,2,43,1,0,29,19,0.490196,0.509804,2,6
2021020570,2022-01-01,2,CBJ,4,7,CAR,11,6,7,3,27,35,22,14,7,78,11,6,7,3,27,35,22,14,7,78,1,0,18,49,0.377049,0.622951,6,6
2021020571,2022-01-01,2,NSH,6,1,CHI,13,10,10,4,37,25,13,8,1,47,13,9,10,3,35,25,13,8,1,47,1,0,25,38,0.491525,0.508475,10,8
2021020572,2022-01-01,2,MIN,4,6,STL,27,10,14,4,55,21,11,8,5,45,25,9,12,4,50,20,10,8,5,43,0,1,33,32,0.516129,0.483871,6,8
2021020573,2022-01-01,2,LAK,6,3,PHI,21,14,15,5,55,27,7,13,2,49,21,14,15,5,55,26,7,13,2,48,1,0,34,37,0.477612,0.522388,10,16
2021020574,2022-01-01,2,SEA,2,5,VAN,25,4,12,2,43,26,11,8,4,49,25,4,12,2,43,26,11,8,4,49,0,1,32,35,0.515152,0.484848,9,9
2021020575,2022-01-02,2,DET,1,5,BOS,18,5,11,1,35,25,11,8,5,49,17,5,11,1,34,25,9,8,5,47,1,0,24,37,0.509434,0.490566,15,17
2021020576,2022-01-02,2,NYR,4,0,TBL,14,10,3,2,29,27,16,17,0,60,14,9,3,2,28,27,16,17,0,60,1,0,21,38,0.612245,0.387755,6,8
2021020577,2022-01-02,2,PIT,8,5,SJS,28,23,12,7,70,21,12,8,4,45,26,23,11,7,67,21,12,8,4,45,1,0,39,27,0.34375,0.65625,4,6
2021020578,2022-01-02,2,WSH,3,4,NJD,25,12,16,3,56,30,10,13,4,57,23,11,16,2,52,28,9,13,3,53,0,1,30,37,0.467742,0.532258,6,6
2021020579,2022-01-02,2,CHI,1,5,CGY,25,6,16,1,48,23,12,14,3,52,25,6,16,1,48,22,12,14,3,51,1,0,31,42,0.387755,0.612245,6,6
2021020580,2022-01-02,2,COL,4,2,ANA,26,5,12,2,45,23,7,6,1,37,26,5,12,2,45,21,7,6,1,35,0,1,36,31,0.5,0.5,6,12
2021020581,2022-02-20,2,ARI,3,1,DAL,19,6,14,2,41,30,17,11,1,59,18,6,14,2,40,30,17,11,1,59,1,0,27,33,0.395833,0.604167,4,6
2021020582,2022-01-02,2,VGK,4,5,WPG,39,18,20,4,81,26,10,19,4,59,38,17,19,4,78,23,9,19,3,54,1,0,46,37,0.517241,0.482759,6,2
2021020583,2022-02-07,2,TOR,4,3,CAR,22,10,11,3,46,26,10,17,3,56,18,10,10,2,40,24,10,17,3,54,0,1,32,31,0.535211,0.464789,7,13
2021020584,2022-02-22,2,OTT,4,3,MIN,17,15,11,3,46,28,8,14,3,53,17,15,11,3,46,28,8,14,3,53,1,0,34,43,0.509434,0.490566,6,8
2021020585,2022-01-03,2,NYR,4,1,EDM,19,5,3,3,30,29,11,19,1,60,17,4,3,3,27,28,11,19,1,59,1,0,28,34,0.381818,0.618182,4,10
2021020586,2022-01-04,2,BOS,5,3,NJD,27,12,12,5,56,21,7,9,3,40,27,12,12,5,56,21,7,9,3,40,1,0,34,26,0.641791,0.358209,2,2
2021020587,2022-02-10,2,MTL,2,5,WSH,36,8,14,1,59,15,2,8,5,30,35,8,14,1,58,14,2,8,5,29,0,1,44,23,0.491228,0.508772,6,10
2021020588,2022-01-04,2,DET,6,2,SJS,19,6,8,4,37,18,2,10,2,32,18,6,8,4,36,16,1,10,2,29,1,0,31,26,0.47619,0.52381,38,25
2021020589,2022-01-04,2,FLA,6,2,CGY,34,3,22,4,63,42,5,14,2,63,34,3,22,4,63,42,5,14,2,63,1,0,45,49,0.545455,0.454545,4,6
2021020590,2022-01-04,2,CBJ,2,7,TBL,20,12,9,2,43,23,12,11,4,50,20,12,9,2,43,23,12,11,4,50,0,1,22,36,0.508772,0.491228,8,6
2021020591,2022-01-04,2,CHI,3,4,COL,26,7,11,1,45,25,11,20,4,60,25,5,11,1,42,23,10,20,3,56,0,1,31,33,0.466667,0.533333,9,11
2021020592,2022-01-04,2,ARI,1,3,WPG,23,11,15,1,50,28,15,8,2,53,23,11,15,1,50,28,15,8,2,53,0,1,27,49,0.458333,0.541667,10,6
2021020593,2022-01-04,2,VGK,2,3,NSH,36,10,19,2,67,21,10,11,3,45,35,10,17,2,64,20,6,11,3,40,0,1,43,26,0.557143,0.442857,11,13
2021020594,2022-01-04,2,ANA,4,1,PHI,23,10,16,2,51,24,16,14,1,55,22,9,15,2,48,20,11,10,1,42,1,0,30,29,0.47541,0.52459,6,12
2021020595,2022-02-22,2,SEA,2,5,NYI,23,22,17,2,64,30,4,16,5,55,21,22,16,2,61,29,4,16,5,54,0,1,25,36,0.4375,0.5625,2,2
2021020596,2022-01-05,2,TOR,4,2,EDM,27,15,12,3,57,25,15,6,2,48,27,15,12,3,57,25,15,6,2,48,1,0,33,30,0.555556,0.444444,2,4
2021020597,2022-01-05,2,PIT,5,3,STL,31,6,12,3,52,24,6,9,2,41,30,6,12,3,51,23,6,9,1,39,0,1,41,29,0.566667,0.433333,4,22
2021020598,2022-02-09,2,VAN,3,6,NYI,31,14,17,3,65,18,9,16,6,49,31,14,17,3,65,18,9,16,6,49,0,1,37,27,0.452381,0.547619,9,11
2021020599,2022-01-06,2,BOS,2,3,MIN,27,5,9,0,41,14,7,6,1,28,27,5,7,0,39,13,7,6,1,27,1,0,38,30,0.597015,0.402985,28,22
2021020600,2022-01-06,2,BUF,2,3,SJS,29,9,19,1,58,16,9,7,3,35,29,9,19,1,58,16,9,7,3,35,0,1,39,21,0.596491,0.403509,7,11
2021020601,2022-02-21,2,MTL,5,2,TOR,18,4,12,5,39,31,9,15,2,57,18,4,12,5,39,31,9,15,2,57,1,0,24,37,0.413793,0.586207,6,6
2021020602,2022-01-06,2,TBL,4,1,CGY,22,18,10,4,54,18,7,9,1,35,21,17,10,4,52,18,6,7,1,32,1,0,33,27,0.568627,0.431373,25,31
2021020603,2022-01-06,2,NJD,3,1,CBJ,23,16,5,2,46,24,15,9,1,49,22,16,5,2,45,23,15,9,1,48,1,0,28,32,0.5,0.5,8,6
2021020604,2022-01-06,2,PHI,2,6,PIT,17,10,13,2,42,24,12,12,4,52,17,10,12,2,41,20,10,10,3,43,0,1,20,32,0.461538,0.538462,16,10
2021020605,2022-01-06,2,DAL,6,5,FLA,29,10,13,6,58,30,16,14,3,63,25,9,11,4,49,29,13,14,3,59,0,1,36,42,0.597403,0.402597,6,6
2021020606,2022-01-06,2,COL,7,1,WPG,33,4,12,4,53,25,7,13,0,45,32,4,12,4,52,25,7,12,0,44,0,1,42,35,0.471698,0.528302,16,14
2021020607,2022-01-06,2,ARI,6,4,CHI,16,9,7,4,36,24,9,14,3,50,16,9,7,4,36,24,9,14,3,50,1,0,26,36,0.5,0.5,10,10
2021020608,2022-01-06,2,VGK,5,1,NYR,27,10,13,4,54,16,7,13,1,37,27,10,13,4,54,16,7,13,1,37,1,0,35,20,0.531915,0.468085,4,6
2021020609,2022-01-09,2,ANA,4,3,DET,23,10,11,4,48,30,14,13,2,59,22,8,9,2,41,26,10,13,2,51,1,0,27,36,0.483333,0.516667,13,19
2021020610,2022-01-06,2,LAK,2,4,NSH,38,11,7,1,57,14,8,15,2,39,37,10,7,1,55,14,8,13,2,37,0,1,48,20,0.603175,0.396825,13,15
2021020611,2022-04-18,2,SEA,4,2,OTT,15,7,9,3,34,11,10,10,2,33,15,7,9,3,34,11,10,10,2,33,1,0,29,14,0.5,0.5,9,15
2021020612,2022-01-07,2,CAR,6,3,CGY,25,12,7,5,49,31,5,11,3,50,25,12,6,5,48,30,5,11,3,49,0,1,37,39,0.619048,0.380952,10,8
2021020613,2022-01-07,2,STL,5,1,WSH,17,7,8,4,36,23,10,7,1,41,17,7,8,4,36,23,10,7,1,41,0,1,24,27,0.489796,0.510204,6,4
2021020614,2022-02-13,2,MTL,3,5,BUF,25,9,14,3,51,27,7,7,4,45,25,9,14,3,51,26,7,7,4,44,0,1,32,32,0.625,0.375,6,6
2021020615,2022-01-08,2,TBL,2,5,BOS,21,11,8,2,42,22,10,3,5,40,21,11,8,2,42,22,10,3,5,40,0,1,29,30,0.459016,0.540984,4,8
2021020616,2022-01-08,2,PHI,2,3,SJS,26,9,16,1,52,40,10,10,3,63,25,9,16,1,51,40,10,10,2,62,1,0,31,47,0.545455,0.454545,4,4
2021020617,2022-01-08,2,CAR,3,4,FLA,21,12,12,2,47,28,16,10,4,58,20,12,12,2,46,28,16,10,3,57,0,1,27,36,0.463768,0.536232,4,8
2021020618,2022-01-08,2,CBJ,4,3,NJD,25,10,7,3,45,19,9,9,3,40,25,10,7,3,45,19,9,9,3,40,1,0,34,30,0.537313,0.462687,6,6
2021020619,2022-01-08,2,DAL,3,2,PIT,28,12,13,3,56,25,9,14,2,50,27,12,13,3,55,24,9,13,2,48,0,1,32,29,0.517857,0.482143,8,4
2021020620,2022-01-08,2,MIN,3,2,WSH,19,9,16,4,48,24,10,11,1,46,17,7,16,2,42,21,8,11,1,41,0,1,22,31,0.492537,0.507463,10,2
2021020621,2022-02-17,2,WPG,5,3,SEA,22,8,7,4,41,16,14,15,2,47,22,8,7,4,41,16,14,15,2,47,0,1,29,23,0.5,0.5,6,8
2021020622,2022-01-08,2,COL,5,4,TOR,30,7,15,5,57,22,7,10,3,42,28,7,15,4,54,20,7,10,3,40,0,1,49,27,0.353846,0.646154,4,10
2021020623,2022-02-11,2,EDM,3,1,NYI,28,7,16,2,53,32,11,4,0,47,28,7,16,2,53,32,11,4,0,47,1,0,36,38,0.5,0.5,8,6
2021020624,2022-01-08,2,ARI,2,4,NSH,28,11,9,2,50,18,6,7,3,34,24,11,8,2,45,12,5,7,2,26,0,1,40,29,0.514286,0.485714,48,38
2021020625,2022-04-19,2,VAN,3,4,OTT,34,19,18,3,74,27,7,7,5,46,26,16,18,1,61,24,5,7,3,39,1,0,37,31,0.6,0.4,4,10
2021020626,2022-01-08,2,VGK,1,2,CHI,30,9,24,1,64,19,14,15,2,50,30,9,24,1,64,19,14,15,2,50,1,0,31,21,0.52,0.48,2,0
2021020627,2022-01-08,2,ANA,1,4,NYR,10,23,11,1,45,22,5,5,4,36,10,21,9,1,41,21,4,5,4,34,1,0,14,40,0.5,0.5,10,6
2021020628,2022-01-08,2,LAK,4,0,DET,32,9,13,3,57,16,7,15,0,38,32,9,13,3,57,16,7,15,0,38,1,0,42,21,0.553571,0.446429,9,11
2021020629,2022-01-09,2,STL,2,1,DAL,23,9,11,0,43,21,9,3,1,34,23,9,11,0,43,21,9,3,1,34,0,1,31,27,0.469388,0.530612,6,10
2021020630,2022-02-12,2,MTL,1,2,CBJ,26,13,10,1,50,37,13,15,1,66,26,13,10,1,50,35,13,15,1,64,0,1,31,42,0.555556,0.444444,8,4
2021020631,2022-02-15,2,NJD,3,6,TBL,20,11,13,2,46,23,7,9,6,45,20,11,13,2,46,23,7,9,6,45,1,0,25,32,0.47619,0.52381,22,16
2021020632,2022-01-10,2,WSH,3,7,BOS,24,22,11,3,60,20,10,9,5,44,24,22,11,3,60,20,10,9,5,44,1,0,30,31,0.428571,0.571429,8,6
2021020633,2022-02-16,2,WPG,6,3,MIN,20,10,16,5,51,31,21,14,3,69,20,10,16,5,51,31,21,14,3,69,0,1,31,36,0.589286,0.410714,4,4
2021020634,2022-01-10,2,COL,4,3,SEA,28,5,14,4,51,19,9,14,2,44,28,5,14,4,51,19,9,14,2,44,1,0,35,26,0.520833,0.479167,6,8
2021020635,2022-01-15,2,EDM,4,6,OTT,27,9,17,3,56,18,9,8,4,39,27,9,17,3,56,18,9,8,4,39,0,1,37,26,0.546875,0.453125,6,6
2021020636,2022-01-10,2,LAK,3,1,NYR,27,10,11,3,51,20,5,9,1,35,27,10,11,3,51,20,5,9,1,35,1,0,39,23,0.392157,0.607843,4,6
2021020637,2022-01-11,2,BUF,1,6,TBL,12,3,10,0,25,27,7,7,5,46,12,3,9,0,24,27,7,7,5,46,0,1,18,36,0.541667,0.458333,4,8
2021020638,2022-01-11,2,FLA,5,2,VAN,17,13,21,3,54,32,1,20,2,55,17,13,21,3,54,32,1,20,2,55,1,0,26,44,0.414286,0.585714,18,18
2021020639,2022-02-21,2,PHI,3,4,CAR,36,11,6,3,56,22,14,18,4,58,31,11,6,3,51,16,13,17,3,49,0,1,41,31,0.52381,0.47619,9,13
2021020640,2022-01-11,2,CBJ,2,4,CHI,19,3,17,1,40,12,3,6,4,25,19,3,17,1,40,12,3,6,4,25,1,0,26,20,0.395349,0.604651,8,4
2021020641,2022-01-11,2,NSH,5,4,COL,21,15,10,3,49,34,3,13,3,53,20,14,10,3,47,30,3,13,3,49,1,0,32,44,0.492063,0.507937,8,12
2021020642,2022-02-12,2,CGY,5,2,NYI,24,15,22,5,66,17,15,7,1,40,24,15,22,5,66,17,15,7,1,40,1,0,29,21,0.45283,0.54717,11,7
2021020643,2022-01-11,2,VGK,3,4,TOR,30,5,12,1,48,15,6,18,4,43,25,5,11,1,42,12,4,17,3,36,0,1,34,18,0.484375,0.515625,4,10
2021020644,2022-01-11,2,ANA,1,4,PIT,23,6,6,1,36,24,16,16,3,59,23,6,6,1,36,24,16,16,3,59,0,1,26,34,0.345455,0.654545,6,6
2021020645,2022-01-11,2,SJS,3,2,DET,32,10,14,2,58,17,7,5,1,30,32,10,14,1,57,16,7,5,1,29,1,0,40,19,0.519231,0.480769,11,11
2021020646,2022-03-21,2,MTL,2,3,BOS,21,7,11,1,40,31,9,13,3,56,21,7,11,1,40,30,9,13,2,54,0,1,28,46,0.384615,0.615385,10,6
2021020647,2022-01-12,2,DAL,5,2,SEA,18,6,10,4,38,20,14,12,1,47,18,6,10,4,38,20,14,12,1,47,1,0,25,25,0.484848,0.515152,6,4
2021020648,2022-02-20,2,EDM,3,7,MIN,25,13,9,2,49,13,9,8,6,36,25,13,9,2,49,13,9,8,6,36,0,1,33,22,0.622642,0.377358,16,4
2021020649,2022-01-12,2,ARI,2,1,TOR,11,9,12,2,34,32,14,21,1,68,9,9,11,2,31,30,13,21,1,65,1,0,18,46,0.511111,0.488889,6,6
2021020650,2022-01-13,2,BOS,3,2,PHI,28,9,7,1,45,21,8,11,1,41,28,8,6,1,43,19,8,10,1,38,1,0,36,27,0.5,0.5,17,17
2021020651,2022-01-13,2,DET,0,3,WPG,25,5,8,0,38,25,10,20,2,57,22,4,8,0,34,24,10,20,2,56,0,1,33,32,0.603448,0.396552,6,14
2021020652,2022-01-13,2,TBL,4,2,VAN,15,7,7,3,32,23,10,13,2,48,15,7,7,3,32,23,10,13,2,48,1,0,21,26,0.480769,0.519231,10,8
2021020653,2022-01-13,2,NYI,3,2,NJD,17,5,11,2,35,24,5,9,1,39,17,5,11,1,34,20,5,8,1,34,0,1,25,32,0.42,0.58,12,10
2021020654,2022-01-13,2,CAR,0,6,CBJ,30,15,10,0,55,28,11,11,6,56,30,13,9,0,52,27,11,9,6,53,0,1,31,35,0.565217,0.434783,16,6
2021020655,2022-01-13,2,CHI,3,2,MTL,22,4,10,2,38,24,8,12,1,45,22,4,10,1,37,23,7,12,1,43,1,0,31,29,0.458333,0.541667,23,13
2021020656,2022-01-13,2,STL,2,1,SEA,18,6,10,1,35,23,8,6,1,38,18,6,10,1,35,23,8,6,1,38,0,1,27,32,0.553191,0.446809,6,10
2021020657,2022-01-13,2,NSH,1,4,BUF,24,10,11,0,45,12,8,10,3,33,24,10,11,0,45,12,8,10,3,33,0,1,30,21,0.56,0.44,8,8
2021020658,2022-01-13,2,CGY,1,4,OTT,25,17,10,1,53,26,10,9,4,49,25,17,10,1,53,26,10,9,4,49,0,1,28,34,0.521739,0.478261,21,7
2021020659,2022-01-13,2,LAK,6,2,PIT,31,13,6,5,55,27,8,10,2,47,31,13,6,5,55,27,8,10,2,47,0,1,45,29,0.584906,0.415094,2,6
2021020660,2022-01-13,2,SJS,0,3,NYR,35,8,12,0,55,26,6,11,2,45,34,8,12,0,54,23,6,11,2,42,0,1,37,31,0.510204,0.489796,9,11
2021020661,2022-01-14,2,FLA,7,1,DAL,30,4,22,6,62,27,7,8,1,43,30,3,22,6,61,26,7,8,1,42,1,0,39,30,0.527778,0.472222,4,4
2021020662,2022-01-14,2,MIN,7,3,ANA,35,7,17,7,66,36,14,20,3,73,35,7,17,7,66,36,14,20,3,73,1,0,42,42,0.534247,0.465753,7,5
2021020663,2022-01-14,2,COL,4,3,ARI,38,13,16,4,71,21,4,8,2,35,32,12,14,3,61,16,3,8,2,29,1,0,47,26,0.551724,0.448276,10,12
2021020664,2022-02-08,2,EDM,0,4,VGK,24,8,25,0,57,21,10,12,3,46,24,7,24,0,55,19,10,12,3,44,0,1,28,28,0.47619,0.52381,4,8
2021020665,2022-01-15,2,BOS,4,3,NSH,35,9,8,3,55,22,11,8,3,44,33,8,8,2,51,21,10,8,3,42,1,0,44,29,0.391892,0.608108,9,7
2021020666,2022-02-08,2,MTL,1,7,NJD,23,6,13,1,43,24,9,7,6,46,23,6,13,1,43,24,9,7,6,46,0,1,31,34,0.491803,0.508197,4,6
2021020667,2022-01-15,2,DET,4,0,BUF,25,6,6,2,39,13,7,9,0,29,25,6,6,2,39,13,7,9,0,29,1,0,39,22,0.615385,0.384615,10,10
2021020668,2022-01-15,2,TBL,3,1,DAL,22,13,9,2,46,14,6,6,1,27,20,13,9,2,44,14,6,6,1,27,0,1,29,20,0.509434,0.490566,4,8
2021020669,2022-01-15,2,FLA,9,2,CBJ,39,6,13,7,65,24,5,7,1,37,39,6,13,7,65,24,5,7,1,37,1,0,51,30,0.4375,0.5625,8,8
2021020670,2022-01-15,2,NYI,0,2,WSH,16,9,10,0,35,30,6,12,2,50,16,9,10,0,35,30,6,12,2,50,0,1,23,36,0.489796,0.510204,4,6
2021020671,2022-01-15,2,PHI,2,3,NYR,25,7,16,2,50,21,9,13,2,45,25,7,16,2,50,21,9,13,2,45,0,1,28,27,0.5,0.5,4,2
2021020672,2022-01-15,2,CAR,4,1,VAN,23,12,16,3,54,25,10,6,1,42,22,12,16,3,53,24,10,6,1,41,1,0,33,31,0.382353,0.617647,12,6
2021020673,2022-01-15,2,CHI,3,0,ANA,28,3,16,2,49,31,12,13,0,56,28,3,16,2,49,31,12,13,0,56,1,0,36,37,0.586957,0.413043,4,6
2021020674,2022-01-15,2,STL,5,6,TOR,18,6,10,5,39,31,8,8,5,52,18,6,10,5,39,31,8,8,5,52,1,0,25,40,0.389831,0.610169,8,6
2021020675,2022-03-24,2,WPG,2,5,OTT,22,6,18,2,48,27,10,16,4,57,22,6,18,2,48,27,10,16,4,57,1,0,24,33,0.54902,0.45098,2,0
2021020676,2022-02-09,2,CGY,6,0,VGK,24,7,12,5,48,24,5,7,0,36,24,7,12,5,48,24,5,7,0,36,1,0,33,28,0.55,0.45,4,4
2021020677,2022-01-15,2,ARI,0,5,COL,18,9,5,0,32,22,10,14,4,50,18,9,5,0,32,22,10,13,4,49,0,1,20,32,0.469388,0.530612,16,4
2021020678,2022-01-15,2,SJS,1,2,PIT,31,7,13,1,52,21,10,16,2,49,31,6,13,1,51,21,10,16,1,48,1,0,41,27,0.666667,0.333333,2,8
2021020679,2022-01-15,2,SEA,1,3,LAK,14,5,8,0,27,18,11,6,3,38,14,5,8,0,27,18,11,6,3,38,0,1,18,22,0.547619,0.452381,2,8
2021020680,2022-01-16,2,WSH,2,4,VAN,26,8,16,0,50,26,12,18,2,58,26,8,16,0,50,26,12,18,2,58,1,0,33,32,0.411765,0.588235,12,8
2021020681,2022-02-19,2,WPG,2,4,EDM,19,8,8,0,35,26,8,9,3,46,18,8,8,0,34,26,8,9,2,45,0,1,24,40,0.462963,0.537037,12,14
2021020682,2022-01-17,2,BUF,2,3,DET,20,6,5,2,33,31,10,12,2,55,19,5,5,2,31,28,9,12,1,50,1,0,28,35,0.347826,0.652174,6,8
2021020683,2022-01-31,2,TOR,6,4,NJD,22,10,20,4,56,20,5,12,4,41,22,10,20,4,56,20,5,12,4,41,0,1,33,29,0.637931,0.362069,6,6
2021020684,2022-01-17,2,NYI,4,1,PHI,24,10,8,4,46,21,15,11,1,48,24,10,8,4,46,21,15,11,1,48,1,0,31,27,0.522727,0.477273,8,2
2021020685,2022-01-17,2,STL,5,3,NSH,19,5,8,4,36,24,13,10,3,50,19,5,8,4,36,24,13,10,3,50,0,1,29,35,0.490909,0.509091,13,9
2021020686,2022-01-17,2,COL,4,3,MIN,29,7,24,3,63,35,9,13,3,60,23,6,19,2,50,26,8,12,3,49,1,0,38,40,0.463768,0.536232,25,19
2021020687,2022-01-17,2,ARI,5,2,MTL,11,15,12,5,43,18,13,11,1,43,11,15,12,5,43,18,13,11,1,43,1,0,23,26,0.509434,0.490566,6,10
2021020688,2022-01-17,2,VGK,3,5,PIT,21,16,15,2,54,23,7,8,4,42,21,16,15,2,54,23,7,8,4,42,1,0,26,37,0.54386,0.45614,6,4
2021020689,2022-01-17,2,SJS,6,2,LAK,10,10,13,4,37,35,11,19,2,67,10,10,13,4,37,35,11,19,2,67,1,0,17,41,0.470588,0.529412,11,11
2021020690,2022-01-17,2,SEA,3,2,CHI,27,19,18,4,68,12,8,6,1,27,22,14,16,2,54,10,6,6,1,23,0,1,37,27,0.489362,0.510638,15,11
2021020691,2022-01-18,2,BOS,1,7,CAR,25,9,10,0,44,24,8,6,5,43,24,8,10,0,42,24,7,5,5,41,0,1,32,34,0.552239,0.447761,6,10
2021020692,2022-01-18,2,OTT,1,3,BUF,35,14,12,0,61,25,10,16,3,54,33,13,12,0,58,25,10,16,3,54,0,1,44,32,0.47619,0.52381,9,25
2021020693,2022-03-10,2,NYI,6,0,CBJ,24,11,11,3,49,15,5,13,0,33,24,11,10,3,48,15,5,12,0,32,1,0,33,25,0.469697,0.530303,12,8
2021020694,2022-02-09,2,PHI,3,6,DET,12,7,10,3,32,21,15,12,5,53,11,6,10,3,30,20,15,12,5,52,0,1,24,34,0.464286,0.535714,6,10
2021020695,2022-01-18,2,WSH,4,3,WPG,25,15,11,4,55,23,10,11,2,46,24,15,11,3,53,23,10,11,2,46,0,1,31,33,0.460317,0.539683,8,4
2021020696,2022-01-18,2,NSH,1,3,VAN,28,10,12,0,50,14,13,6,2,35,28,10,12,0,50,14,13,6,2,35,1,0,32,24,0.517857,0.482143,20,14
2021020697,2022-01-18,2,DAL,3,5,MTL,24,21,24,2,71,14,6,10,3,33,24,20,24,2,70,14,6,10,3,33,0,1,51,22,0.544118,0.455882,20,39
2021020698,2022-01-18,2,CGY,5,1,FLA,23,5,11,3,42,23,16,6,1,46,22,5,11,3,41,22,15,6,1,44,1,0,31,29,0.615385,0.384615,12,12
2021020699,2022-02-09,2,EDM,1,4,CHI,28,10,19,0,57,22,6,6,2,36,28,10,19,0,57,22,6,6,2,36,0,1,41,30,0.609756,0.390244,8,8
2021020700,2022-01-18,2,LAK,4,6,TBL,24,13,10,2,49,17,3,9,4,33,24,13,10,2,49,17,3,9,4,33,0,1,36,25,0.5,0.5,13,13
2021020701,2022-01-19,2,NJD,1,4,ARI,29,14,16,0,59,9,17,9,4,39,29,14,16,0,59,9,17,9,4,39,1,0,36,17,0.481481,0.518519,4,4
2021020702,2022-01-19,2,NYR,6,3,TOR,18,8,11,6,43,28,6,15,2,51,18,8,11,6,43,28,6,15,2,51,0,1,27,38,0.453125,0.546875,8,4
2021020703,2022-01-19,2,ANA,0,2,COL,30,11,6,0,47,19,15,15,2,51,29,11,6,0,46,18,15,14,2,49,0,1,34,28,0.538462,0.461538,11,15
2021020704,2022-01-20,2,BOS,4,3,WSH,23,6,10,2,41,12,5,14,3,34,23,6,10,2,41,12,5,14,3,34,0,1,33,17,0.553571,0.446429,8,6
2021020705,2022-01-20,2,BUF,4,5,DAL,20,7,5,3,35,39,16,14,1,70,20,7,5,3,35,39,16,14,1,70,1,0,24,47,0.421053,0.578947,10,6
2021020706,2022-01-20,2,PHI,1,2,CBJ,30,7,15,1,53,21,7,7,2,37,30,7,15,1,53,21,7,7,2,37,0,1,34,29,0.531915,0.468085,10,12
2021020707,2022-01-20,2,PIT,6,4,OTT,24,8,8,5,45,34,4,17,4,59,22,8,8,5,43,34,3,16,3,56,1,0,34,43,0.467742,0.532258,18,20
2021020708,2022-01-20,2,NSH,5,2,WPG,14,4,8,5,31,25,8,12,1,46,14,4,8,5,31,24,8,11,1,44,1,0,23,38,0.428571,0.571429,17,13
2021020709,2022-01-20,2,EDM,0,6,FLA,31,17,21,0,69,18,10,17,3,48,31,17,21,0,69,18,10,17,3,48,0,1,40,28,0.590909,0.409091,10,6
2021020710,2022-01-20,2,VGK,4,3,MTL,47,15,17,2,81,20,4,7,2,33,45,15,17,1,78,16,4,7,2,29,1,0,53,27,0.508197,0.491803,6,6
2021020711,2022-01-20,2,LAK,1,4,COL,36,11,18,0,65,18,3,11,3,35,36,11,18,0,65,18,3,11,3,35,0,1,41,27,0.535714,0.464286,2,10
2021020712,2022-01-20,2,SEA,3,2,SJS,11,8,10,3,32,13,12,9,1,35,11,8,10,3,32,13,12,9,1,35,0,1,17,25,0.477273,0.522727,17,11
2021020713,2022-01-21,2,DET,4,5,DAL,18,8,10,3,39,24,8,9,4,45,17,8,9,3,37,21,8,9,4,42,0,1,28,32,0.492537,0.507463,10,8
2021020714,2022-01-21,2,NYI,4,0,ARI,25,7,14,4,50,17,6,13,0,36,25,7,13,4,49,17,6,13,0,36,1,0,35,17,0.456522,0.543478,7,11
2021020715,2022-01-21,2,CAR,6,3,NYR,29,16,14,4,63,18,14,14,1,47,29,16,14,4,63,18,14,14,1,47,1,0,35,23,0.534483,0.465517,8,6
2021020716,2022-01-21,2,CBJ,2,5,PIT,22,7,11,1,41,17,6,12,4,39,22,7,11,1,41,17,6,12,4,39,0,1,27,31,0.509804,0.490196,12,4
2021020717,2022-01-21,2,CHI,1,5,MIN,30,9,10,1,50,22,7,17,5,51,30,9,10,1,50,22,7,17,5,51,0,1,36,30,0.477273,0.522727,24,26
2021020718,2022-01-21,2,VAN,1,2,FLA,25,8,10,1,44,29,8,16,2,55,22,8,10,0,40,24,7,15,0,46,1,0,28,34,0.491228,0.508772,4,8
2021020719,2022-01-21,2,ANA,5,1,TBL,23,14,7,3,47,23,10,12,1,46,23,14,7,3,47,21,9,12,1,43,1,0,35,33,0.4375,0.5625,19,17
2021020720,2022-01-21,2,SEA,0,5,STL,20,8,14,0,42,19,8,10,3,40,20,8,13,0,41,19,8,9,2,38,0,1,27,31,0.419355,0.580645,12,12
2021020721,2022-01-22,2,BOS,3,2,WPG,23,13,11,2,49,19,10,14,2,45,23,13,11,2,49,19,10,14,2,45,0,1,32,24,0.521739,0.478261,18,14
2021020722,2022-01-22,2,BUF,6,3,PHI,16,11,8,3,38,19,9,9,2,39,16,11,7,3,37,19,9,9,2,39,1,0,24,33,0.5,0.5,12,10
2021020723,2022-04-17,2,TOR,4,2,NYI,26,13,20,3,62,25,11,16,1,53,26,13,20,3,62,25,11,16,1,53,0,1,37,29,0.508475,0.491525,9,11
2021020724,2022-01-22,2,NJD,7,4,CAR,30,9,12,6,57,26,8,15,4,53,30,9,12,6,57,26,8,15,4,53,0,1,38,32,0.40625,0.59375,2,6
2021020725,2022-01-22,2,NYR,7,3,ARI,15,12,13,4,44,20,12,15,3,50,15,12,12,4,43,20,12,14,3,49,0,1,27,29,0.38,0.62,10,8
2021020726,2022-01-22,2,WSH,3,2,OTT,22,18,15,3,58,18,15,14,2,49,21,18,15,2,56,18,15,13,2,48,0,1,33,22,0.716981,0.283019,4,4
2021020727,2022-01-22,2,NSH,4,1,DET,19,10,5,3,37,21,7,8,1,37,19,10,5,3,37,20,7,8,1,36,1,0,25,29,0.557692,0.442308,22,18
2021020728,2022-01-22,2,MIN,4,3,CHI,31,14,16,2,63,29,14,9,2,54,30,13,16,1,60,27,14,8,2,51,0,1,44,36,0.441176,0.558824,4,12
2021020729,2022-01-22,2,COL,3,2,MTL,37,7,9,1,54,20,8,13,1,42,35,6,9,0,50,20,8,12,1,41,1,0,46,30,0.5,0.5,6,10
2021020730,2022-01-22,2,EDM,5,3,CGY,24,7,13,3,47,38,8,15,2,63,24,7,13,3,47,38,8,15,2,63,0,1,31,47,0.455882,0.544118,4,6
2021020731,2022-01-22,2,SJS,1,7,TBL,23,21,10,1,55,20,12,15,6,53,23,21,10,1,55,20,12,15,6,53,0,1,28,31,0.392157,0.607843,4,4
2021020732,2022-01-23,2,NJD,2,3,LAK,20,20,11,1,52,30,12,8,3,53,18,19,10,1,48,28,11,8,2,49,1,0,25,37,0.527273,0.472727,10,8
2021020733,2022-01-23,2,PIT,3,2,WPG,30,12,11,2,55,23,8,14,1,46,27,11,11,2,51,18,8,14,1,41,0,1,38,29,0.431373,0.568627,9,13
2021020734,2022-01-23,2,CBJ,1,2,OTT,28,11,13,1,53,24,6,8,2,40,28,11,13,1,53,24,6,8,2,40,0,1,36,33,0.481481,0.518519,6,4
2021020735,2022-01-23,2,VAN,1,3,STL,30,13,14,1,58,14,5,4,2,25,30,13,14,1,58,14,5,4,2,25,1,0,39,17,0.415094,0.584906,6,8
2021020736,2022-01-23,2,SEA,5,3,FLA,21,14,13,5,53,23,12,23,2,60,21,14,13,5,53,23,12,23,2,60,0,1,29,31,0.438596,0.561404,11,13
2021020737,2022-01-24,2,BOS,3,5,ANA,21,11,22,2,56,17,6,0,3,26,21,11,22,2,56,17,6,0,3,26,0,1,26,27,0.586207,0.413793,11,9
2021020738,2022-01-24,2,NYR,3,2,LAK,17,13,7,4,41,31,10,13,3,57,12,11,7,1,31,24,10,12,1,47,1,0,30,36,0.530612,0.469388,10,21
2021020739,2022-01-24,2,PHI,1,3,DAL,27,13,9,1,50,33,8,15,3,59,27,13,9,1,50,33,8,15,3,59,0,1,28,36,0.532258,0.467742,0,0
2021020740,2022-01-24,2,WSH,0,1,VGK,25,6,10,0,41,19,8,11,1,39,25,6,10,0,41,19,8,11,1,39,0,1,34,29,0.491525,0.508475,8,10
2021020741,2022-01-24,2,MIN,8,2,MTL,25,15,10,7,57,17,2,8,2,29,25,15,10,6,56,16,2,8,2,28,0,1,39,21,0.607143,0.392857,29,35
2021020742,2022-01-24,2,COL,2,0,CHI,23,12,18,1,54,23,18,13,0,54,23,12,18,1,54,23,18,13,0,54,1,0,29,24,0.557692,0.442308,2,4
2021020743,2022-01-24,2,CGY,7,1,STL,35,21,10,5,71,14,4,3,1,22,35,21,10,5,71,14,4,3,1,22,0,1,48,21,0.603774,0.396226,4,10
2021020744,2022-01-25,2,OTT,5,0,BUF,32,9,15,4,60,20,2,5,0,27,32,9,15,4,60,19,2,5,0,26,1,0,47,32,0.578125,0.421875,14,12
2021020745,2022-01-25,2,NJD,1,5,DAL,35,15,20,0,70,24,5,7,5,41,34,15,18,0,67,23,5,7,5,40,0,1,37,32,0.43662,0.56338,9,13
2021020746,2022-01-25,2,NYI,4,3,PHI,22,16,12,3,53,13,7,10,3,33,22,16,12,3,53,12,7,10,2,31,0,1,33,17,0.574074,0.425926,4,10
2021020747,2022-01-25,2,PIT,6,3,ARI,28,4,10,4,46,11,8,6,2,27,28,4,10,4,46,10,8,6,2,26,0,1,36,16,0.52,0.48,4,6
2021020748,2022-01-25,2,CAR,4,3,VGK,25,14,18,3,60,23,7,7,3,40,23,13,16,2,54,20,7,6,2,35,1,0,30,29,0.540984,0.459016,8,10
2021020749,2022-01-25,2,WPG,3,5,FLA,24,9,5,2,40,23,11,5,5,44,24,9,5,2,40,23,11,5,5,44,0,1,35,32,0.58,0.42,8,6
2021020750,2022-01-25,2,VAN,2,3,EDM,23,6,10,1,40,38,17,22,3,80,22,3,10,0,35,28,16,22,2,68,1,0,27,50,0.403846,0.596154,8,4
2021020751,2022-01-25,2,SEA,2,4,NSH,29,8,12,1,50,16,9,7,3,35,27,8,12,1,48,16,9,7,3,35,1,0,35,27,0.45283,0.54717,10,10
2021020752,2022-01-26,2,TOR,4,3,ANA,36,12,12,2,62,19,11,8,4,42,31,9,12,0,52,15,9,7,3,34,0,1,44,20,0.625,0.375,4,8
2021020753,2022-01-26,2,DET,5,8,CHI,26,9,17,4,56,29,5,12,6,52,25,8,17,4,54,29,5,12,5,51,0,1,33,38,0.492308,0.507692,18,8
2021020754,2022-01-26,2,WSH,1,4,SJS,24,15,20,1,60,26,12,11,4,53,24,15,20,1,60,26,12,11,4,53,0,1,33,30,0.457627,0.542373,7,11
2021020755,2022-01-26,2,CBJ,0,6,CGY,20,9,11,0,40,46,12,12,6,76,20,9,11,0,40,46,12,12,6,76,0,1,23,62,0.373134,0.626866,6,2
2021020756,2022-01-26,2,COL,4,3,BOS,32,9,14,3,58,20,11,3,2,36,31,9,12,3,55,20,11,2,1,34,1,0,41,32,0.416667,0.583333,12,12
2021020757,2022-01-27,2,MTL,4,5,ANA,33,7,7,3,50,13,5,8,3,29,33,7,7,2,49,13,5,8,3,29,0,1,40,24,0.568966,0.431034,8,4
2021020758,2022-01-27,2,OTT,2,3,CAR,33,9,16,2,60,22,22,11,2,57,32,9,16,2,59,21,21,10,2,54,0,1,39,29,0.466667,0.533333,4,4
2021020759,2022-01-27,2,TBL,3,2,NJD,26,11,6,1,44,27,4,12,1,44,26,11,6,1,44,27,4,12,1,44,0,1,35,33,0.583333,0.416667,6,2
2021020760,2022-01-27,2,FLA,4,1,VGK,26,7,12,3,48,20,10,12,1,43,26,7,12,3,48,20,10,11,1,42,0,1,32,25,0.369565,0.630435,6,4
2021020761,2022-01-27,2,NYI,2,3,LAK,21,5,13,2,41,22,11,7,3,43,21,5,13,2,41,22,11,7,3,43,0,1,25,30,0.54902,0.45098,2,2
2021020762,2022-01-27,2,PIT,1,2,SEA,20,10,15,0,45,20,10,14,2,46,20,8,15,0,43,19,10,14,1,44,1,0,24,29,0.630435,0.369565,4,4
2021020763,2022-01-27,2,CBJ,5,3,NYR,13,8,12,4,37,29,9,9,2,49,13,8,12,4,37,29,9,9,2,49,0,1,19,36,0.4,0.6,6,4
2021020764,2022-01-27,2,STL,5,1,CGY,19,9,5,4,37,22,16,10,1,49,18,9,4,4,35,22,16,8,1,47,1,0,28,29,0.392857,0.607143,8,10
2021020765,2022-01-27,2,WPG,1,5,VAN,25,13,12,1,51,25,13,10,3,51,25,13,12,1,51,25,13,10,3,51,0,1,34,33,0.377049,0.622951,9,11
2021020766,2022-01-27,2,EDM,3,2,NSH,36,11,20,2,69,28,6,12,2,48,33,9,19,2,63,24,6,12,2,44,0,1,46,30,0.538462,0.461538,6,6
2021020767,2022-01-28,2,NYR,2,3,MIN,19,5,8,2,34,31,12,15,2,60,19,5,8,2,34,30,11,15,2,58,1,0,27,34,0.470588,0.529412,6,6
2021020768,2022-01-28,2,PIT,2,3,DET,31,10,9,1,51,27,8,17,2,54,28,9,8,1,46,22,8,13,1,44,0,1,38,32,0.580645,0.419355,6,8
2021020769,2022-01-28,2,CHI,4,6,COL,34,10,12,4,60,18,9,19,4,50,34,10,12,4,60,18,9,19,4,50,0,1,43,27,0.535211,0.464789,11,11
2021020770,2022-01-28,2,DAL,0,5,WSH,22,12,16,0,50,22,14,12,3,51,22,12,16,0,50,22,14,12,3,51,0,1,29,29,0.627451,0.372549,4,6
2021020771,2022-01-28,2,ARI,1,2,BOS,22,11,8,1,42,23,6,9,1,39,22,11,8,1,42,22,6,7,1,36,0,1,31,37,0.410714,0.589286,10,8
2021020772,2022-01-29,2,MTL,2,7,EDM,20,9,9,1,39,16,10,7,7,40,20,9,9,1,39,16,10,7,7,40,0,1,23,24,0.5,0.5,17,9
2021020773,2022-01-29,2,OTT,1,2,ANA,35,10,15,1,61,17,10,4,2,33,35,10,15,1,61,17,10,4,2,33,0,1,45,20,0.470588,0.529412,14,16
2021020774,2022-01-29,2,DET,4,7,TOR,30,8,11,3,52,29,12,13,6,60,28,8,11,3,50,28,12,13,6,59,1,0,35,37,0.4,0.6,6,4
2021020775,2022-01-29,2,TBL,2,3,VGK,23,17,14,5,59,25,7,11,6,49,17,14,14,2,47,20,6,10,2,38,0,1,29,27,0.462963,0.537037,2,6
2021020776,2022-01-29,2,FLA,5,4,SJS,41,15,23,5,84,28,6,4,2,40,41,14,21,4,80,27,5,4,2,38,0,1,50,34,0.492063,0.507937,6,4
2021020777,2022-02-02,2,NYI,0,3,SEA,18,11,20,0,49,27,8,15,3,53,18,11,20,0,49,27,8,15,3,53,0,1,19,31,0.382979,0.617021,4,2
2021020778,2022-01-29,2,PHI,4,3,LAK,26,7,5,3,41,26,10,16,2,54,25,6,5,2,38,26,10,15,2,53,1,0,36,40,0.471698,0.528302,6,4
2021020779,2022-01-29,2,CAR,2,1,NJD,18,15,14,2,49,21,12,15,1,49,16,15,14,2,47,21,12,14,1,48,1,0,23,25,0.471698,0.528302,6,6
2021020780,2022-01-29,2,STL,1,4,WPG,21,11,10,0,42,17,13,9,3,42,21,9,10,0,40,14,13,6,3,36,1,0,29,24,0.458333,0.541667,8,12
2021020781,2022-01-29,2,CGY,1,0,VAN,23,18,12,1,54,14,9,6,0,29,22,18,12,0,52,14,9,6,0,29,0,0,32,15,0.476923,0.523077,8,18
2021020782,2022-01-29,2,ARI,1,3,BUF,24,12,13,0,49,24,4,9,2,39,24,12,13,0,49,24,3,9,2,38,0,1,28,35,0.511111,0.488889,8,6
2021020783,2022-01-30,2,MTL,3,6,CBJ,26,10,7,2,45,28,13,17,5,63,26,9,6,2,43,25,13,16,5,59,1,0,35,36,0.45614,0.54386,8,8
2021020784,2022-01-30,2,NYI,3,4,MIN,29,12,6,2,49,16,5,13,3,37,29,12,6,2,49,16,5,13,3,37,0,1,43,21,0.526316,0.473684,6,10
2021020785,2022-01-30,2,NYR,3,2,SEA,19,7,11,2,39,32,10,19,1,62,18,7,11,2,38,31,9,19,1,60,1,0,24,42,0.561404,0.438596,10,6
2021020786,2022-01-30,2,PIT,3,4,LAK,17,10,11,1,39,28,7,11,4,50,17,9,11,1,38,27,6,11,3,47,0,1,26,38,0.508475,0.491525,6,8
2021020787,2022-01-30,2,CAR,2,1,SJS,26,16,25,2,69,24,8,15,1,48,26,16,25,2,69,24,8,15,1,48,1,0,29,28,0.569231,0.430769,6,6
2021020788,2022-02-12,2,STL,5,1,CHI,23,13,19,4,59,15,6,10,0,31,22,12,18,4,56,15,6,10,0,31,1,0,31,16,0.511111,0.488889,6,6
2021020789,2022-01-30,2,DAL,6,1,BOS,22,14,12,5,53,23,6,14,1,44,22,14,12,5,53,23,6,14,1,44,1,0,29,26,0.557377,0.442623,2,6
2021020790,2022-01-30,2,COL,4,1,BUF,23,5,10,3,41,25,6,16,1,48,23,5,10,3,41,25,6,16,1,48,1,0,36,31,0.515152,0.484848,13,13
2021020791,2022-01-31,2,OTT,3,2,EDM,28,11,11,2,52,33,7,15,2,57,25,11,11,1,48,30,6,15,2,53,1,0,31,39,0.517241,0.482759,11,9
2021020792,2022-01-31,2,DET,2,1,ANA,24,9,14,2,49,14,12,16,1,43,21,7,14,1,43,12,11,15,1,39,1,0,28,15,0.595745,0.404255,2,4
2021020793,2022-01-31,2,CBJ,4,8,FLA,26,5,14,4,49,29,9,20,7,65,26,5,14,3,48,28,9,18,7,62,0,1,36,40,0.461538,0.538462,8,6
2021020794,2022-01-31,2,CHI,1,3,VAN,17,5,11,1,34,24,7,21,3,55,17,5,11,1,34,24,6,21,3,54,0,1,21,32,0.425532,0.574468,8,4
2021020795,2022-02-01,2,BOS,3,2,SEA,20,6,6,1,33,16,8,9,2,35,20,6,6,1,33,16,8,9,2,35,1,0,26,27,0.509091,0.490909,19,13
2021020796,2022-02-17,2,MTL,3,2,STL,19,9,17,3,48,21,7,10,1,39,17,9,15,2,43,21,5,8,1,35,1,0,30,27,0.544118,0.455882,10,14
2021020797,2022-02-01,2,TBL,3,2,SJS,26,16,8,2,52,14,8,6,1,29,25,15,8,1,49,13,8,5,1,27,1,0,32,21,0.466667,0.533333,10,12
2021020798,2022-02-01,2,NJD,1,7,TOR,26,8,11,1,46,26,7,5,7,45,26,8,11,1,46,26,7,5,7,45,0,1,32,36,0.449275,0.550725,4,6
2021020799,2022-02-01,2,NYI,4,1,OTT,23,10,7,3,43,25,10,11,1,47,23,8,7,2,40,22,9,10,1,42,0,1,30,27,0.543478,0.456522,6,8
2021020800,2022-02-01,2,NYR,5,2,FLA,29,7,13,2,51,29,11,10,1,51,29,7,13,2,51,29,11,10,1,51,1,0,35,36,0.45283,0.54717,11,15
2021020801,2022-02-01,2,PHI,3,1,WPG,21,10,7,3,41,28,7,14,1,50,21,10,7,3,41,28,7,14,1,50,0,1,36,33,0.59322,0.40678,4,8
2021020802,2022-02-01,2,PIT,3,4,WSH,34,14,15,0,63,21,7,10,2,40,32,14,15,0,61,19,6,9,1,35,0,1,47,32,0.514706,0.485294,4,10
2021020803,2022-02-01,2,NSH,4,2,VAN,21,12,10,3,46,28,14,14,2,58,21,12,10,3,46,28,14,14,2,58,0,1,28,32,0.607843,0.392157,4,6
2021020804,2022-02-01,2,DAL,3,4,CGY,18,11,8,3,40,33,17,14,4,68,18,11,8,3,40,33,17,14,4,68,0,1,28,40,0.581818,0.418182,4,6
2021020805,2022-02-01,2,COL,2,3,ARI,27,13,13,2,55,21,6,8,3,38,24,11,12,2,49,18,4,8,2,32,1,0,40,24,0.409836,0.590164,8,8
2021020806,2022-02-01,2,VGK,5,2,BUF,21,14,8,3,46,28,10,19,2,59,21,14,8,3,46,28,10,19,2,59,1,0,35,32,0.46875,0.53125,14,18
2021020807,2022-02-02,2,DET,3,5,LAK,20,8,9,3,40,36,9,8,5,58,20,8,9,3,40,36,9,8,5,58,1,0,25,45,0.461538,0.538462,16,14
2021020808,2022-02-02,2,WSH,3,5,EDM,24,15,13,3,55,21,16,13,3,53,24,15,13,3,55,21,16,13,3,53,0,1,27,27,0.528302,0.471698,2,6
2021020809,2022-02-02,2,CHI,0,5,MIN,27,9,23,0,59,29,5,14,4,52,27,9,23,0,59,29,5,14,4,52,0,1,30,35,0.525,0.475,2,2
2021020810,2022-02-02,2,ARI,2,4,CGY,24,12,13,2,51,41,15,21,4,81,24,12,13,2,51,41,15,21,4,81,0,1,28,50,0.465517,0.534483,9,7
2021020811,2022-02-12,2,DET,4,2,PHI,18,6,8,3,35,24,18,6,1,49,18,6,8,3,35,24,18,6,1,49,1,0,23,34,0.520833,0.479167,6,4
2021020812,2022-02-23,2,TBL,5,3,EDM,14,8,8,4,34,23,18,12,2,55,12,8,7,4,31,22,17,12,2,53,1,0,23,30,0.433962,0.566038,4,8
2021020813,2022-02-23,2,DAL,3,2,WPG,26,15,9,2,52,15,6,8,1,30,26,15,9,1,51,14,6,8,1,29,0,1,39,22,0.517857,0.482143,6,10
2021020814,2022-02-23,2,ARI,2,3,LAK,15,9,10,2,36,28,11,13,3,55,15,9,10,2,36,28,11,13,3,55,1,0,19,35,0.509804,0.490196,14,4
2021020815,2022-02-24,2,TOR,3,1,MIN,19,10,10,3,42,23,7,14,1,45,19,10,10,3,42,22,7,14,1,44,0,1,25,30,0.698413,0.301587,8,4
2021020816,2022-02-24,2,FLA,3,6,CBJ,34,6,16,3,59,18,8,4,6,36,34,6,16,3,59,18,8,4,6,36,1,0,42,28,0.559322,0.440678,4,8
2021020817,2022-02-13,2,NJD,2,4,PIT,25,6,5,2,38,25,14,20,4,63,25,6,5,2,38,25,14,20,4,63,1,0,30,35,0.446809,0.553191,6,4
2021020818,2022-02-24,2,NYR,4,1,WSH,16,4,9,4,33,30,7,8,1,46,15,4,9,4,32,30,7,7,1,45,1,0,21,37,0.372549,0.627451,12,8
2021020819,2022-02-24,2,NSH,2,1,DAL,18,4,9,2,33,26,12,10,1,49,13,4,7,1,25,20,11,9,1,41,1,0,20,28,0.425532,0.574468,13,15
2021020820,2022-02-24,2,VAN,7,1,CGY,22,7,11,3,43,26,12,24,1,63,22,7,11,2,42,26,12,24,1,63,1,0,38,30,0.471429,0.528571,2,34
2021020821,2022-02-24,2,SJS,4,3,NYI,25,9,9,2,45,42,13,16,3,74,23,8,9,1,41,35,11,16,3,65,0,1,28,47,0.478873,0.521127,16,14
2021020822,2022-02-24,2,SEA,2,3,BOS,19,9,8,1,37,24,14,6,3,47,19,9,8,1,37,24,14,6,2,46,1,0,27,39,0.388889,0.611111,10,6
2021020823,2022-02-25,2,CAR,4,0,CBJ,40,10,6,3,59,19,8,4,0,31,40,10,6,3,59,19,8,4,0,31,1,0,50,19,0.586207,0.413793,10,20
2021020824,2022-02-25,2,CHI,8,5,NJD,24,7,10,5,46,29,8,17,5,59,24,6,10,5,45,29,8,17,5,59,1,0,37,36,0.424242,0.575758,13,27
2021020825,2022-02-25,2,STL,5,3,BUF,11,10,9,4,34,29,6,12,2,49,11,9,8,4,32,29,6,12,2,49,0,1,23,38,0.509804,0.490196,12,8
2021020826,2022-02-25,2,COL,6,3,WPG,28,11,20,6,65,20,5,8,2,35,28,11,20,6,65,20,5,8,2,35,0,1,42,29,0.470588,0.529412,6,20
2021020827,2022-02-25,2,ARI,3,1,VGK,25,7,12,3,47,37,19,14,1,71,25,7,12,3,47,37,19,14,1,71,0,1,32,44,0.403846,0.596154,4,6
2021020828,2022-02-25,2,ANA,1,4,LAK,20,15,10,1,46,21,11,12,3,47,19,15,10,1,45,20,11,12,2,45,0,1,25,32,0.44898,0.55102,8,8
2021020829,2022-04-26,2,TOR,3,0,DET,27,15,10,2,54,16,5,7,0,28,27,15,10,2,54,16,5,7,0,28,1,0,36,20,0.531915,0.468085,6,4
2021020830,2022-02-26,2,OTT,1,2,MTL,20,9,9,0,38,27,9,9,2,47,19,9,9,0,37,26,8,9,2,45,0,1,27,32,0.454545,0.545455,8,8
2021020831,2022-02-26,2,FLA,3,4,EDM,32,10,14,1,57,18,5,9,3,35,32,10,14,1,57,18,5,9,3,35,0,1,47,22,0.538462,0.461538,4,10
2021020832,2022-02-26,2,PHI,2,1,WSH,19,13,16,2,50,23,16,16,0,55,19,13,16,2,50,23,16,16,0,55,1,0,22,28,0.603448,0.396552,11,9
2021020833,2022-02-26,2,PIT,1,0,NYR,22,9,15,0,46,19,6,14,0,39,19,8,15,0,42,15,5,12,0,32,1,0,26,27,0.458333,0.541667,10,10
2021020834,2022-02-26,2,NSH,2,3,TBL,22,12,15,0,49,23,8,9,1,41,22,12,15,0,49,23,8,9,1,41,1,0,28,33,0.592593,0.407407,18,18
2021020835,2022-02-26,2,CGY,7,3,MIN,22,16,11,4,53,20,10,4,3,37,21,15,11,4,51,16,10,2,3,31,0,1,35,25,0.537313,0.462687,10,16
2021020836,2022-02-26,2,VGK,2,3,COL,30,13,15,2,60,17,5,9,3,34,30,13,15,2,60,17,5,9,3,34,1,0,36,21,0.584906,0.415094,6,4
2021020837,2022-02-26,2,LAK,5,2,NYI,22,12,18,5,57,19,5,7,2,33,22,12,18,5,57,19,5,7,2,33,1,0,35,28,0.52381,0.47619,6,10
2021020838,2022-02-26,2,SJS,1,3,BOS,12,8,15,0,35,27,7,11,3,48,10,8,14,0,32,27,7,11,3,48,0,1,16,37,0.45283,0.54717,8,10
2021020839,2022-02-27,2,NYR,2,5,VAN,26,14,11,2,53,26,11,7,4,48,26,14,11,2,53,26,11,7,4,48,0,1,33,34,0.462963,0.537037,2,6
2021020840,2022-02-27,2,CAR,2,1,EDM,19,10,9,1,39,22,9,10,1,42,18,10,9,1,38,20,9,10,1,40,1,0,29,30,0.603774,0.396226,10,8
2021020841,2022-02-27,2,CBJ,2,3,PIT,25,9,5,2,41,31,14,11,2,58,25,9,5,2,41,30,13,11,2,56,1,0,34,40,0.457627,0.542373,20,4
2021020842,2022-02-27,2,CHI,0,4,STL,28,6,12,0,46,21,5,6,3,35,28,6,11,0,45,21,5,6,3,35,0,1,30,35,0.5,0.5,8,8
2021020843,2022-02-27,2,DAL,4,2,BUF,25,9,5,3,42,33,14,17,2,66,25,9,5,3,42,33,14,17,2,66,1,0,31,40,0.571429,0.428571,2,6
2021020844,2022-02-27,2,ARI,3,5,WPG,26,21,17,3,67,33,15,15,5,68,25,20,17,3,65,30,15,13,5,63,0,1,29,38,0.509804,0.490196,2,2
2021020845,2022-02-27,2,ANA,0,4,NYI,31,9,17,0,57,14,10,6,4,34,24,9,16,0,49,14,9,6,4,33,0,1,34,22,0.471698,0.528302,8,8
2021020846,2022-02-27,2,SJS,3,1,SEA,16,7,6,3,32,36,12,19,1,68,16,7,6,3,32,35,11,18,1,65,1,0,24,40,0.54386,0.45614,9,15
2021020847,2022-02-28,2,NJD,7,2,VAN,22,13,8,6,49,34,13,7,2,56,22,13,8,6,49,34,13,7,2,56,1,0,33,38,0.476923,0.523077,2,4
2021020848,2022-02-22,2,PHI,1,4,STL,23,12,12,1,48,21,16,15,4,56,23,12,12,1,48,21,16,15,4,56,0,1,26,26,0.666667,0.333333,2,4
2021020849,2022-02-28,2,WSH,3,5,TOR,24,10,10,1,45,19,15,13,5,52,22,9,10,1,42,18,14,13,4,49,0,1,33,28,0.5,0.5,10,8
2021020850,2022-02-28,2,LAK,0,7,BOS,30,8,12,0,50,24,12,11,5,52,30,8,12,0,50,24,12,11,5,52,0,1,34,32,0.5,0.5,11,9
2021020851,2022-03-01,2,DET,4,3,CAR,30,4,10,3,47,27,7,11,2,47,27,3,9,3,42,26,6,10,2,44,0,1,41,30,0.493151,0.506849,4,8
2021020852,2022-03-01,2,TBL,5,2,OTT,11,9,6,4,30,15,5,5,2,27,11,9,6,4,30,14,4,5,2,25,0,1,22,27,0.527273,0.472727,26,26
2021020853,2022-03-01,2,PHI,0,3,EDM,31,13,15,0,59,24,8,13,2,47,31,13,15,0,59,24,8,13,2,47,0,1,39,32,0.525424,0.474576,10,4
2021020854,2022-03-01,2,CBJ,4,3,NJD,21,12,5,3,41,25,9,20,1,55,20,12,5,3,40,24,9,20,1,54,0,1,31,33,0.586667,0.413333,13,11
2021020855,2022-03-01,2,MIN,1,5,CGY,26,14,13,1,54,19,10,9,3,41,24,14,12,1,51,18,10,9,3,40,0,1,33,27,0.467742,0.532258,15,17
2021020856,2022-03-01,2,WPG,8,4,MTL,16,3,7,4,30,21,5,14,3,43,15,3,7,2,27,20,5,14,3,42,1,0,30,35,0.633333,0.366667,19,19
2021020857,2022-03-01,2,COL,5,3,NYI,33,11,19,4,67,24,11,10,3,48,33,11,19,4,67,24,11,10,3,48,1,0,43,31,0.46,0.54,4,6
2021020858,2022-03-01,2,VGK,3,1,SJS,26,5,18,3,52,16,6,15,1,38,26,5,18,3,52,16,6,15,1,38,1,0,31,17,0.58,0.42,2,4
2021020859,2022-03-01,2,ANA,4,3,BOS,23,11,13,2,49,29,11,16,3,59,23,11,13,2,49,29,11,16,3,59,1,0,28,34,0.508475,0.491525,7,11
2021020860,2022-03-02,2,TOR,1,5,BUF,25,15,12,1,53,25,5,9,4,43,25,15,12,1,53,25,5,9,4,43,0,1,30,31,0.54902,0.45098,4,2
2021020861,2022-03-02,2,NYR,5,3,STL,22,17,6,4,49,24,8,20,3,55,21,17,5,4,47,24,7,20,3,54,1,0,29,32,0.333333,0.666667,11,9
2021020862,2022-03-02,2,DAL,4,3,LAK,35,11,9,3,58,26,7,18,2,53,33,11,8,3,55,24,7,18,2,51,0,1,43,31,0.557377,0.442623,8,14
2021020863,2022-03-02,2,SEA,4,3,NSH,24,13,15,3,55,19,14,10,2,45,24,13,15,3,55,19,14,10,2,45,0,1,31,22,0.372881,0.627119,6,0
2021020864,2022-03-03,2,TBL,1,5,PIT,19,12,12,1,44,29,17,14,4,64,19,12,12,1,44,29,17,14,4,64,0,1,21,40,0.491525,0.508475,25,21
2021020865,2022-03-03,2,FLA,3,0,OTT,24,14,11,1,50,9,6,5,0,20,21,13,10,1,45,8,6,5,0,19,1,0,48,18,0.526316,0.473684,23,55
2021020866,2022-03-03,2,NYI,3,4,VAN,24,11,21,3,59,32,10,15,4,61,24,11,21,3,59,32,10,15,4,61,1,0,27,38,0.409836,0.590164,4,0
2021020867,2022-03-03,2,PHI,4,5,MIN,21,4,18,3,46,30,9,16,5,60,21,4,18,3,46,30,9,16,5,60,1,0,30,38,0.634921,0.365079,2,6
2021020868,2022-03-03,2,WSH,4,0,CAR,22,4,7,2,35,29,7,12,0,48,22,4,7,2,35,29,7,12,0,48,1,0,33,36,0.541667,0.458333,6,12
2021020869,2022-03-03,2,CHI,4,3,EDM,25,8,12,3,48,27,8,16,2,53,25,8,12,3,48,26,7,16,1,50,1,0,32,32,0.4,0.6,10,6
2021020870,2022-03-03,2,CGY,4,5,MTL,23,12,13,3,51,22,12,5,4,43,23,12,13,3,51,21,12,5,3,41,1,0,34,35,0.52459,0.47541,12,6
2021020871,2022-03-03,2,ARI,2,1,COL,22,5,12,2,41,37,6,15,1,59,22,5,12,2,41,37,6,15,1,59,0,1,29,43,0.525424,0.474576,18,14
2021020872,2022-03-03,2,VGK,2,5,BOS,28,8,19,2,57,29,7,18,5,59,28,8,19,2,57,29,7,18,5,59,0,1,36,36,0.557692,0.442308,2,4
2021020873,2022-03-04,2,BUF,5,4,MIN,22,8,8,3,41,27,9,15,3,54,22,8,8,3,41,27,9,15,3,54,1,0,38,33,0.430769,0.569231,21,13
2021020874,2022-03-04,2,TBL,3,1,DET,27,16,6,0,49,19,7,10,1,37,27,16,6,0,49,19,7,10,1,37,1,0,38,23,0.528302,0.471698,4,8
2021020875,2022-03-04,2,NYR,3,1,NJD,25,12,9,3,49,22,6,16,1,45,24,10,8,3,45,22,6,16,1,45,1,0,32,33,0.6,0.4,13,13
2021020876,2022-03-04,2,CAR,3,2,PIT,32,19,14,2,67,20,6,8,2,36,31,18,14,2,65,19,6,8,2,35,0,1,42,24,0.5,0.5,9,11
2021020877,2022-03-04,2,CBJ,3,4,LAK,23,5,13,3,44,35,11,9,4,59,21,5,12,3,41,35,8,9,3,55,0,1,29,43,0.456522,0.543478,2,2
2021020878,2022-03-04,2,WPG,3,4,DAL,26,9,10,2,47,22,7,8,4,41,24,7,8,2,41,16,6,6,3,31,0,1,42,34,0.40678,0.59322,8,14
2021020879,2022-03-04,2,ANA,4,5,VGK,17,12,12,2,43,25,9,8,5,47,17,12,11,2,42,25,9,8,5,47,1,0,24,35,0.515152,0.484848,8,8
2021020880,2022-03-05,2,TOR,4,6,VAN,33,22,15,3,73,22,9,14,5,50,33,22,15,3,73,22,9,14,5,50,0,1,38,29,0.580645,0.419355,4,4
2021020881,2022-03-05,2,FLA,6,2,DET,29,11,14,4,58,21,5,7,2,35,29,11,14,4,58,21,5,7,2,35,1,0,39,25,0.642857,0.357143,4,6
2021020882,2022-03-05,2,NYI,2,1,STL,11,7,15,1,34,27,7,21,1,56,10,5,14,1,30,27,7,20,1,55,1,0,20,31,0.510638,0.489362,13,15
2021020883,2022-03-05,2,PHI,4,3,CHI,18,8,13,4,43,25,8,11,3,47,18,8,13,4,43,25,7,11,3,46,1,0,27,29,0.54902,0.45098,10,16
2021020884,2022-03-05,2,WSH,5,2,SEA,13,5,10,3,31,22,10,19,2,53,13,5,10,3,31,22,10,19,2,53,1,0,25,31,0.5,0.5,6,4
2021020885,2022-03-05,2,CBJ,4,5,BOS,19,16,15,2,52,29,16,10,4,59,15,13,14,2,44,27,13,10,3,53,0,1,24,32,0.509091,0.490909,4,6
2021020886,2022-03-05,2,COL,3,4,CGY,32,7,17,2,58,29,14,14,3,60,30,6,17,2,55,28,14,13,2,57,1,0,36,37,0.376812,0.623188,11,11
2021020887,2022-03-05,2,EDM,2,5,MTL,22,10,7,2,41,19,7,3,2,31,21,10,7,2,40,19,7,3,2,31,0,1,30,29,0.583333,0.416667,8,8
2021020888,2022-03-05,2,ARI,8,5,OTT,19,8,12,6,45,30,13,15,4,62,19,8,12,6,45,30,13,15,4,62,1,0,31,46,0.3125,0.6875,9,15
2021020889,2022-03-05,2,SJS,0,8,NSH,17,7,17,0,41,23,11,5,7,46,17,7,12,0,36,19,11,5,7,42,0,1,20,36,0.483333,0.516667,22,20
2021020890,2022-03-06,2,BUF,0,3,LAK,17,13,6,0,36,29,9,7,3,48,17,13,6,0,36,29,9,7,3,48,0,1,19,32,0.382979,0.617021,2,2
2021020891,2022-03-06,2,NJD,3,2,STL,26,12,8,3,49,17,14,8,2,41,25,12,6,2,45,17,13,7,2,39,1,0,33,21,0.444444,0.555556,4,12
2021020892,2022-03-06,2,CAR,3,2,SEA,22,13,12,1,48,24,10,9,1,44,22,13,12,1,48,24,10,9,1,44,0,1,33,30,0.661017,0.338983,6,6
2021020893,2022-03-06,2,CHI,3,6,TBL,14,7,14,3,38,21,8,11,6,46,14,7,14,3,38,21,8,11,6,46,1,0,27,32,0.434783,0.565217,4,6
2021020894,2022-03-06,2,MIN,3,6,DAL,30,17,17,3,67,17,12,6,4,39,29,17,15,3,64,15,9,6,4,34,1,0,35,26,0.393939,0.606061,8,10
2021020895,2022-03-06,2,WPG,1,4,NYR,29,9,4,0,42,15,9,8,3,35,29,9,4,0,42,15,9,8,3,35,0,1,46,22,0.609756,0.390244,4,12
2021020896,2022-03-06,2,VGK,2,1,OTT,37,7,18,1,63,33,9,15,0,57,37,7,18,1,63,33,9,15,0,57,1,0,42,40,0.492063,0.507937,4,4
2021020897,2022-03-06,2,ANA,3,2,SJS,28,17,21,3,69,15,6,6,2,29,28,17,21,2,68,15,6,6,2,29,0,1,36,22,0.618182,0.381818,11,15
2021020898,2022-03-07,2,BOS,2,3,LAK,27,10,18,2,57,23,14,11,3,51,26,10,17,2,55,22,14,11,2,49,1,0,32,28,0.421053,0.578947,8,6
2021020899,2022-03-07,2,BUF,1,6,FLA,20,8,7,1,36,18,3,5,4,30,19,8,7,1,35,17,2,5,4,28,0,1,30,31,0.527273,0.472727,18,12
2021020900,2022-03-07,2,NYI,4,5,COL,28,9,17,2,56,38,10,8,4,60,28,9,17,2,56,35,10,7,4,56,1,0,36,49,0.484848,0.515152,10,12
2021020901,2022-03-07,2,CBJ,4,5,TOR,27,10,15,3,55,27,15,14,5,61,27,10,15,2,54,27,15,14,5,61,0,1,35,33,0.48,0.52,9,13
2021020902,2022-03-08,2,TOR,6,4,SEA,20,16,10,3,49,22,4,9,3,38,18,16,9,3,46,21,4,9,3,37,1,0,32,30,0.557377,0.442623,8,14
2021020903,2022-03-08,2,DET,2,9,ARI,21,6,8,0,35,21,4,10,9,44,21,5,8,0,34,21,4,10,9,44,0,1,28,30,0.645161,0.354839,8,14
2021020904,2022-03-08,2,NJD,5,3,COL,36,13,9,2,60,19,11,14,1,45,36,13,9,2,60,19,11,14,1,45,0,1,43,26,0.521739,0.478261,8,8
2021020905,2022-03-08,2,PHI,2,1,VGK,15,7,18,2,42,34,13,15,0,62,15,7,18,2,42,34,13,15,0,62,1,0,21,48,0.455882,0.544118,10,8
2021020906,2022-03-08,2,PIT,3,4,FLA,26,11,10,3,50,19,5,14,3,41,26,11,10,3,50,19,5,14,3,41,0,1,35,29,0.578125,0.421875,4,6
2021020907,2022-03-08,2,CHI,8,3,ANA,19,4,10,7,40,26,4,12,2,44,19,4,10,7,40,26,4,12,2,44,1,0,32,32,0.56,0.44,10,6
2021020908,2022-03-08,2,STL,1,4,OTT,20,11,10,1,42,24,16,16,2,58,20,11,10,1,42,24,16,16,2,58,0,1,23,28,0.595238,0.404762,4,2
2021020909,2022-03-08,2,NSH,2,1,DAL,25,17,14,2,58,20,10,9,1,40,23,17,14,1,55,17,10,8,1,36,0,1,31,23,0.422222,0.577778,4,6
2021020910,2022-03-08,2,MIN,5,2,NYR,22,10,10,4,46,23,12,10,1,46,22,10,10,4,46,23,12,10,1,46,1,0,28,25,0.557692,0.442308,0,2
2021020911,2022-03-08,2,WPG,7,4,TBL,19,15,12,5,51,14,5,6,4,29,19,15,12,4,50,13,5,6,4,28,1,0,33,24,0.44898,0.55102,8,10
2021020912,2022-03-08,2,CGY,4,5,WSH,31,12,8,4,55,18,15,4,5,42,31,12,8,4,55,18,15,4,5,42,1,0,35,27,0.461538,0.538462,6,2
2021020913,2022-03-09,2,EDM,4,3,WSH,25,10,15,3,53,20,12,8,2,42,25,9,14,2,50,19,11,6,2,38,0,1,40,32,0.442623,0.557377,8,8
2021020914,2022-03-09,2,VAN,5,3,MTL,21,21,13,3,58,14,10,8,3,35,21,21,13,3,58,14,10,8,3,35,0,1,33,25,0.59322,0.40678,8,8
2021020915,2022-03-10,2,BOS,4,3,CHI,27,9,7,2,45,19,5,8,2,34,24,8,7,2,41,18,5,8,2,33,1,0,36,25,0.52381,0.47619,8,8
2021020916,2022-03-10,2,BUF,3,1,VGK,17,7,10,2,36,28,8,12,1,49,17,7,10,2,36,28,8,12,1,49,1,0,24,31,0.34,0.66,20,20
2021020917,2022-03-10,2,TOR,4,5,ARI,34,19,25,4,82,17,4,10,5,36,33,18,25,4,80,16,3,10,4,33,0,1,38,23,0.5,0.5,2,0
2021020918,2022-03-10,2,OTT,4,3,SEA,22,10,9,3,44,27,7,14,3,51,22,10,9,3,44,27,7,13,3,50,1,0,27,33,0.5,0.5,2,6
2021020919,2022-03-10,2,DET,5,6,MIN,26,14,9,4,53,33,8,9,6,56,23,10,7,4,44,25,7,9,4,45,0,1,34,40,0.610169,0.389831,8,14
2021020920,2022-03-10,2,FLA,6,3,PHI,29,13,20,3,65,24,6,15,2,47,28,12,20,3,63,24,6,15,2,47,1,0,37,37,0.507042,0.492958,18,28
2021020921,2022-03-10,2,NJD,1,2,WPG,28,18,12,0,58,27,9,9,2,47,28,18,12,0,58,27,9,9,2,47,0,1,34,30,0.377778,0.622222,4,6
2021020922,2022-04-12,2,NYI,5,4,PIT,30,7,16,3,56,44,6,12,3,65,25,5,16,2,48,39,5,11,3,58,0,1,37,47,0.568966,0.431034,10,6
2021020923,2022-03-10,2,CAR,2,0,COL,30,9,6,2,47,29,11,10,0,50,30,9,6,2,47,29,11,10,0,50,1,0,37,36,0.448276,0.551724,6,18
2021020924,2022-03-10,2,STL,6,2,NYR,24,7,9,6,46,21,11,10,0,42,21,7,9,6,43,21,11,10,0,42,1,0,35,29,0.6,0.4,13,13
2021020925,2022-03-10,2,NSH,4,1,ANA,25,14,7,3,49,23,11,17,1,52,25,14,7,3,49,23,11,17,1,52,1,0,30,28,0.474576,0.525424,11,9
2021020926,2022-03-10,2,CGY,4,1,TBL,22,10,11,3,46,26,9,12,1,48,22,10,11,3,46,26,9,12,1,48,1,0,32,31,0.5,0.5,6,10
2021020927,2022-03-10,2,LAK,3,4,SJS,25,10,14,2,51,19,12,15,2,48,25,10,14,2,51,19,12,15,1,47,0,1,36,30,0.483333,0.516667,12,8
2021020928,2022-03-11,2,NYI,5,2,WPG,28,8,17,4,57,24,10,13,2,49,27,8,17,3,55,23,10,13,2,48,1,0,38,29,0.559322,0.440678,2,10
2021020929,2022-03-11,2,PIT,5,2,VGK,18,6,11,4,39,36,8,10,2,56,18,6,11,4,39,34,8,8,1,51,1,0,33,42,0.472727,0.527273,6,8
2021020930,2022-03-11,2,CBJ,3,2,MIN,22,6,15,2,45,33,11,10,1,55,17,4,12,1,34,25,8,9,1,43,1,0,28,38,0.545455,0.454545,16,12
2021020931,2022-03-11,2,VAN,3,4,WSH,22,11,21,2,56,29,11,11,2,53,22,11,21,2,56,29,11,11,1,52,0,1,26,34,0.672727,0.327273,6,6
2021020932,2022-03-12,2,BOS,3,2,ARI,34,10,8,3,55,20,7,13,2,42,34,10,8,3,55,20,7,13,2,42,1,0,40,29,0.54717,0.45283,4,2
2021020933,2022-03-12,2,MTL,3,4,SEA,27,11,11,3,52,30,7,9,2,48,19,6,10,3,38,22,6,7,1,36,0,1,33,34,0.558824,0.441176,6,12
2021020934,2022-03-12,2,OTT,3,6,CHI,16,8,13,2,39,17,8,15,5,45,16,8,13,2,39,17,8,15,5,45,1,0,23,28,0.434783,0.565217,24,7
2021020935,2022-03-12,2,NJD,2,1,ANA,34,18,14,3,69,30,8,13,1,52,32,17,11,1,61,26,8,13,1,48,0,1,40,34,0.403846,0.596154,4,6
2021020936,2022-03-12,2,CAR,3,1,PHI,31,20,16,3,70,24,6,9,1,40,27,19,16,3,65,24,6,9,1,40,1,0,36,29,0.557692,0.442308,4,4
2021020937,2022-03-12,2,NSH,4,7,STL,28,9,10,3,50,21,9,8,5,43,27,9,9,2,47,21,9,8,5,43,0,1,35,35,0.483871,0.516129,6,6
2021020938,2022-03-12,2,DAL,4,7,NYR,25,11,12,3,51,21,6,10,6,43,25,11,12,3,51,21,6,10,6,43,1,0,33,29,0.627451,0.372549,4,4
2021020939,2022-03-12,2,CGY,3,0,DET,37,17,15,1,70,16,12,14,0,42,37,17,15,1,70,16,12,14,0,42,1,0,43,19,0.589286,0.410714,9,11
2021020940,2022-03-12,2,EDM,4,1,TBL,28,7,9,3,47,19,14,5,1,39,28,7,9,3,47,19,14,5,1,39,1,0,49,32,0.575342,0.424658,13,19
2021020941,2022-03-12,2,SJS,5,0,LAK,22,6,10,3,41,26,12,25,0,63,22,6,10,3,41,25,10,25,0,60,1,0,27,29,0.446809,0.553191,4,8
2021020942,2022-03-13,2,BUF,5,2,TOR,25,9,7,4,45,27,16,15,2,60,25,9,7,4,45,26,16,13,2,57,0,1,38,36,0.384615,0.615385,30,32
2021020943,2022-03-13,2,NYI,4,3,ANA,20,5,13,4,42,35,8,17,3,63,17,5,13,4,39,33,8,17,2,60,1,0,29,42,0.553571,0.446429,8,8
2021020944,2022-03-13,2,PHI,3,4,MTL,20,10,13,3,46,25,10,16,2,53,17,10,13,3,43,25,10,15,1,51,1,0,30,35,0.596491,0.403509,8,4
2021020945,2022-03-13,2,PIT,4,2,CAR,15,3,4,4,26,38,11,17,2,68,15,3,4,4,26,38,11,17,2,68,1,0,22,43,0.596774,0.403226,2,6
2021020946,2022-03-13,2,CBJ,6,4,VGK,25,4,5,5,39,20,10,15,3,48,25,4,5,5,39,20,10,15,3,48,1,0,38,27,0.508197,0.491803,10,8
2021020947,2022-03-13,2,STL,3,4,WPG,25,10,11,2,48,30,16,14,4,64,24,10,11,2,47,28,16,13,3,60,1,0,31,37,0.392157,0.607843,4,14
2021020948,2022-03-13,2,MIN,2,6,NSH,24,11,25,2,62,14,10,7,5,36,24,11,25,2,62,14,10,7,5,36,0,1,28,25,0.471698,0.528302,11,11
2021020949,2022-03-13,2,COL,3,0,CGY,28,16,18,2,64,41,8,14,0,63,28,16,18,2,64,41,8,14,0,63,1,0,32,46,0.55,0.45,6,4
2021020950,2022-03-13,2,VAN,1,2,TBL,26,9,14,1,50,25,11,6,2,44,25,9,13,1,48,25,10,6,2,43,0,1,36,31,0.490909,0.509091,6,6
2021020951,2022-03-13,2,LAK,3,2,FLA,28,18,15,3,64,27,8,11,2,48,25,15,15,1,56,19,7,9,1,36,1,0,37,32,0.6,0.4,6,10
2021020952,2022-03-14,2,OTT,3,5,ARI,36,22,16,2,76,7,7,5,3,22,36,22,16,2,76,7,7,5,3,22,1,0,43,15,0.6,0.4,4,8
2021020953,2022-03-15,2,TOR,4,0,DAL,28,16,12,3,59,26,14,12,0,52,28,16,12,3,59,26,14,12,0,52,1,0,40,35,0.444444,0.555556,6,4
2021020954,2022-03-15,2,MTL,3,6,ARI,35,7,19,2,63,12,3,13,5,33,34,7,18,2,61,8,3,12,5,28,0,1,39,19,0.465517,0.534483,8,6
2021020955,2022-03-15,2,NYR,4,3,ANA,31,6,9,3,49,16,9,6,2,33,31,6,9,2,48,16,8,6,2,32,1,0,38,23,0.519231,0.480769,6,4
2021020956,2022-03-15,2,WSH,4,3,NYI,31,17,10,5,63,33,15,13,4,65,20,13,10,3,46,27,11,12,3,53,1,0,32,32,0.581818,0.418182,4,2
2021020957,2022-03-15,2,CHI,1,2,BOS,17,2,16,1,36,38,9,9,2,58,17,2,16,1,36,37,9,9,1,56,0,1,20,48,0.482759,0.517241,8,6
2021020958,2022-03-15,2,NSH,4,1,PIT,13,8,8,4,33,30,9,10,1,50,10,8,8,4,30,28,9,10,1,48,1,0,25,36,0.521739,0.478261,10,12
2021020959,2022-03-15,2,WPG,7,3,VGK,13,7,11,5,36,29,18,14,2,63,13,7,11,5,36,29,18,14,2,63,1,0,23,38,0.566038,0.433962,9,21
2021020960,2022-03-15,2,EDM,7,5,DET,18,6,9,6,39,30,15,19,4,68,18,6,9,6,39,29,14,17,4,64,1,0,32,35,0.612903,0.387097,4,8
2021020961,2022-03-15,2,VAN,6,3,NJD,23,4,12,5,44,27,8,11,3,49,23,4,12,5,44,27,8,11,3,49,1,0,31,35,0.530303,0.469697,6,2
2021020962,2022-03-15,2,LAK,0,3,COL,17,11,17,0,45,21,7,13,1,42,17,11,17,0,45,21,7,13,1,42,0,1,23,27,0.490566,0.509434,4,8
2021020963,2022-03-15,2,SJS,2,3,FLA,14,3,8,1,26,26,16,24,2,68,13,3,7,1,24,24,16,24,1,65,1,0,26,34,0.55,0.45,8,14
2021020964,2022-03-16,2,OTT,1,4,CBJ,30,8,9,1,48,28,10,9,4,51,30,8,9,1,48,28,10,9,4,51,1,0,31,39,0.603448,0.396552,4,4
2021020965,2022-03-16,2,MIN,4,2,BOS,27,12,19,3,61,21,6,11,1,39,26,12,17,3,58,21,6,10,1,38,1,0,34,26,0.515152,0.484848,11,13
2021020966,2022-03-16,2,CGY,6,3,NJD,31,12,17,6,66,27,3,5,3,38,31,12,17,6,66,27,3,5,3,38,1,0,40,33,0.442623,0.557377,8,0
2021020967,2022-03-16,2,SEA,1,4,TBL,19,7,8,0,34,30,11,14,2,57,19,7,7,0,33,28,11,13,2,54,1,0,25,42,0.481481,0.518519,12,10
2021020968,2022-03-17,2,TOR,3,2,CAR,13,10,13,3,39,27,14,19,2,62,13,10,13,3,39,27,14,19,2,62,1,0,21,36,0.465116,0.534884,6,2
2021020969,2022-03-17,2,MTL,3,4,DAL,20,5,19,2,46,23,11,11,4,49,16,5,19,1,41,21,9,10,3,43,0,1,31,35,0.545455,0.454545,10,12
2021020970,2022-03-17,2,PHI,5,4,NSH,23,9,7,4,43,25,9,16,3,53,22,9,7,3,41,24,9,15,3,51,1,0,33,34,0.478873,0.521127,15,15
2021020971,2022-03-17,2,CBJ,2,7,WSH,24,10,10,1,45,23,7,8,5,43,24,10,9,1,44,23,7,7,4,41,0,1,41,33,0.466667,0.533333,14,14
2021020972,2022-03-17,2,STL,2,3,PIT,16,7,3,2,28,31,15,14,2,62,12,5,3,2,22,27,13,14,2,56,0,1,25,45,0.517857,0.482143,10,10
2021020973,2022-03-17,2,EDM,6,1,BUF,26,15,13,4,58,25,4,11,1,41,26,15,13,4,58,25,4,11,1,41,1,0,36,28,0.448276,0.551724,2,6
2021020974,2022-03-17,2,VAN,0,1,DET,38,8,11,0,57,32,6,14,1,53,38,8,11,0,57,32,6,14,1,53,0,1,43,35,0.533333,0.466667,2,16
2021020975,2022-03-17,2,VGK,5,3,FLA,20,13,15,4,52,32,9,16,2,59,20,13,15,4,52,32,9,16,2,59,0,1,33,36,0.546875,0.453125,2,16
2021020976,2022-03-17,2,LAK,3,0,SJS,15,13,12,2,42,16,6,8,0,30,15,13,11,2,41,15,6,8,0,29,1,0,27,29,0.5,0.5,6,12
2021020977,2022-03-18,2,OTT,3,1,PHI,30,11,26,1,68,17,8,12,1,38,30,11,24,1,66,17,8,12,1,38,1,0,36,29,0.492308,0.507692,10,10
2021020978,2022-03-18,2,CAR,3,4,WSH,13,17,7,3,40,34,12,8,2,56,11,16,7,3,37,27,11,7,2,47,1,0,20,40,0.5375,0.4625,10,10
2021020979,2022-03-18,2,WPG,2,4,BOS,20,8,15,2,45,35,12,12,2,61,17,7,15,2,41,33,11,12,2,58,0,1,29,45,0.466667,0.533333,28,10
2021020980,2022-03-18,2,CGY,0,1,BUF,22,18,8,0,48,29,7,8,1,45,22,17,7,0,46,25,5,8,0,38,0,0,24,34,0.509804,0.490196,8,4
2021020981,2022-03-18,2,ANA,0,3,FLA,15,7,11,0,33,34,19,16,2,71,14,7,11,0,32,31,18,16,2,67,0,1,17,42,0.454545,0.545455,29,11
2021020982,2022-03-18,2,SJS,3,5,COL,18,5,9,3,35,19,12,11,4,46,17,4,9,3,33,19,11,10,3,43,0,1,28,29,0.537037,0.462963,9,17
2021020983,2022-03-19,2,MTL,5,1,OTT,20,7,12,4,43,25,10,23,0,58,20,7,12,4,43,25,10,23,0,58,1,0,27,30,0.655172,0.344828,8,6
2021020984,2022-03-19,2,TBL,1,2,NYR,24,6,10,0,40,21,3,6,1,31,24,6,10,0,40,21,3,5,1,30,1,0,29,27,0.56,0.44,19,13
2021020985,2022-03-19,2,NYI,4,2,DAL,19,2,10,3,34,32,9,14,2,57,19,2,10,3,34,32,9,14,2,57,1,0,25,39,0.561404,0.438596,4,4
2021020986,2022-03-19,2,CBJ,5,4,STL,17,11,3,4,35,22,13,12,2,49,17,11,3,4,35,22,13,12,2,49,1,0,27,28,0.327586,0.672414,6,8
2021020987,2022-03-19,2,NSH,6,3,TOR,19,7,7,5,38,29,8,15,3,55,19,7,7,5,38,29,8,15,3,55,1,0,34,41,0.5,0.5,6,8
2021020988,2022-03-19,2,MIN,3,1,CHI,25,12,15,3,55,17,1,9,1,28,24,12,15,3,54,16,1,9,1,27,1,0,34,22,0.375,0.625,6,8
2021020989,2022-03-19,2,EDM,6,3,NJD,28,11,12,5,56,22,13,10,3,48,28,11,11,5,55,21,13,10,3,47,1,0,40,28,0.585714,0.414286,13,9
2021020990,2022-03-19,2,VAN,2,5,CGY,20,11,12,1,44,32,16,12,4,64,20,11,12,1,44,32,16,12,4,64,0,1,25,44,0.490909,0.509091,4,4
2021020991,2022-03-19,2,ARI,1,4,PIT,18,10,8,1,37,37,18,15,4,74,18,10,8,1,37,37,18,15,4,74,0,1,21,49,0.510204,0.489796,6,4
2021020992,2022-03-19,2,VGK,5,1,LAK,16,10,9,3,38,31,12,20,1,64,16,10,9,3,38,31,12,20,1,64,1,0,24,39,0.349206,0.650794,6,4
2021020993,2022-03-19,2,SEA,4,2,DET,30,12,12,4,58,18,8,8,1,35,30,12,12,4,58,18,8,8,1,35,0,1,42,23,0.484375,0.515625,7,15
2021020994,2022-03-20,2,PHI,2,1,NYI,29,6,15,1,51,25,8,19,1,53,29,6,15,1,51,25,8,19,1,53,0,1,37,27,0.490909,0.509091,2,8
2021020995,2022-03-20,2,WSH,2,3,DAL,28,13,10,1,52,20,13,13,1,47,28,13,10,1,52,20,13,13,1,47,0,1,38,23,0.370968,0.629032,8,12
2021020996,2022-03-20,2,CAR,0,2,NYR,34,22,21,0,77,14,8,5,2,29,34,22,21,0,77,14,8,5,2,29,0,1,44,18,0.55102,0.44898,4,6
2021020997,2022-03-20,2,CHI,4,6,WPG,32,9,17,3,61,23,10,16,5,54,32,9,17,3,61,23,10,16,5,54,0,1,36,32,0.388889,0.611111,6,4
2021020998,2022-03-20,2,VAN,2,3,BUF,26,3,5,1,35,23,7,10,3,43,25,3,5,1,34,23,6,10,1,40,0,1,32,29,0.545455,0.454545,6,8
2021020999,2022-03-20,2,SJS,4,2,ARI,18,17,9,4,48,15,8,12,1,36,18,17,9,4,48,15,8,12,1,36,1,0,29,25,0.509804,0.490196,4,6
2021021000,2022-01-12,2,BOS,5,1,MTL,30,10,7,4,51,16,5,2,1,24,29,10,7,4,50,14,5,2,1,22,1,0,41,25,0.521739,0.478261,21,21
2021021001,2022-03-21,2,MIN,3,0,VGK,28,10,18,3,59,25,9,11,0,45,27,10,17,3,57,25,9,11,0,45,1,0,36,28,0.416667,0.583333,6,6
2021021002,2022-03-21,2,COL,3,2,EDM,19,10,15,1,45,19,6,17,2,44,16,10,15,0,41,18,6,17,2,43,1,0,31,25,0.438596,0.561404,6,12
2021021003,2022-03-21,2,ANA,3,6,NSH,22,20,11,3,56,19,11,7,3,40,22,20,11,3,56,19,11,7,3,40,1,0,29,31,0.481481,0.518519,22,20
2021021004,2022-03-22,2,DET,6,3,PHI,24,7,15,6,52,28,3,9,3,43,24,7,15,6,52,28,3,9,3,43,1,0,31,33,0.507937,0.492063,14,10
2021021005,2022-03-22,2,NJD,7,4,NYR,23,6,6,6,41,29,6,17,3,55,23,6,6,6,41,29,6,17,3,55,0,1,31,35,0.517857,0.482143,2,6
2021021006,2022-02-17,2,NYI,4,1,BOS,23,5,10,3,41,21,8,11,1,41,23,5,10,3,41,21,8,11,1,41,0,1,29,27,0.4,0.6,4,4
2021021007,2022-03-22,2,PIT,5,1,CBJ,25,4,11,4,44,17,10,10,0,37,25,4,11,4,44,17,10,10,0,37,0,1,37,27,0.607843,0.392157,8,8
2021021008,2022-03-22,2,WSH,2,5,STL,19,11,11,1,42,26,9,11,4,50,19,11,11,1,42,25,9,11,4,49,1,0,21,38,0.44186,0.55814,12,8
2021021009,2022-03-22,2,CAR,3,2,TBL,32,13,11,1,57,26,11,10,2,49,32,13,11,1,57,24,10,10,1,45,1,0,41,29,0.371429,0.628571,8,12
2021021010,2022-03-22,2,DAL,5,3,EDM,21,6,10,4,41,18,16,17,2,53,21,6,10,4,41,18,16,17,2,53,0,1,28,25,0.483333,0.516667,6,8
2021021011,2022-03-22,2,WPG,4,0,VGK,21,14,12,3,50,36,10,10,0,56,17,13,12,2,44,36,10,10,0,56,1,0,26,42,0.5,0.5,8,6
2021021012,2022-03-22,2,CGY,3,4,SJS,27,19,17,2,65,25,8,8,4,45,24,19,17,2,62,25,8,8,4,45,1,0,31,38,0.545455,0.454545,6,16
2021021013,2022-03-22,2,LAK,6,1,NSH,26,12,12,4,54,23,16,16,1,56,26,12,12,4,54,23,16,16,1,56,1,0,35,25,0.489796,0.510204,9,9
2021021014,2022-03-23,2,BUF,4,3,PIT,25,7,13,5,50,20,12,7,1,40,23,7,12,3,45,16,11,6,1,34,1,0,33,26,0.517857,0.482143,4,6
2021021015,2022-03-23,2,TOR,3,2,NJD,25,12,5,1,43,17,9,17,1,44,25,12,5,1,43,17,9,17,1,44,0,1,31,22,0.65,0.35,8,6
2021021016,2022-03-23,2,COL,1,3,VAN,24,6,13,0,43,20,8,8,3,39,22,6,12,0,40,19,8,8,3,38,0,1,33,27,0.434783,0.565217,4,12
2021021017,2022-03-22,2,ARI,2,4,SEA,20,6,12,1,39,29,12,11,3,55,20,6,12,1,39,29,12,11,3,55,1,0,26,39,0.442308,0.557692,6,6
2021021018,2022-03-23,2,ANA,2,4,CHI,27,10,14,2,53,20,9,9,2,40,27,10,14,2,53,20,9,9,2,40,0,1,29,28,0.491525,0.508475,11,7
2021021019,2022-03-24,2,BOS,3,2,TBL,29,9,6,3,47,19,7,10,1,37,26,9,5,3,43,18,6,10,1,35,0,1,39,24,0.564516,0.435484,10,14
2021021020,2022-03-24,2,MTL,3,4,FLA,23,7,11,2,43,32,9,18,3,62,20,7,11,2,40,32,9,18,3,62,1,0,31,42,0.540984,0.459016,12,10
2021021021,2022-03-22,2,NYI,3,0,OTT,22,7,16,3,48,24,5,12,0,41,22,7,16,3,48,24,5,12,0,41,1,0,27,24,0.645833,0.354167,4,4
2021021022,2022-03-24,2,CAR,3,4,DAL,45,24,10,2,81,13,5,7,4,29,38,22,10,2,72,11,4,7,3,25,0,1,47,15,0.6,0.4,23,11
2021021023,2022-03-24,2,STL,2,5,PHI,21,14,8,1,44,17,6,4,5,32,21,14,7,1,43,17,6,4,5,32,0,1,28,27,0.534884,0.465116,10,8
2021021024,2022-03-24,2,MIN,3,2,VAN,28,6,11,3,48,23,8,8,1,40,27,5,9,2,43,22,7,8,1,38,0,1,36,28,0.40625,0.59375,13,11
2021021025,2022-03-24,2,EDM,5,2,SJS,35,14,17,3,69,22,5,14,2,43,35,14,17,3,69,22,5,14,2,43,0,1,41,30,0.514706,0.485294,4,4
2021021026,2022-03-24,2,VGK,6,1,NSH,37,11,21,3,72,27,12,9,0,48,37,11,21,3,72,27,12,9,0,48,1,0,50,36,0.476923,0.523077,13,17
2021021027,2022-03-24,2,LAK,3,4,CHI,40,19,17,1,77,29,7,5,4,45,37,16,15,1,69,24,7,4,3,38,0,1,46,31,0.568966,0.431034,8,4
2021021028,2022-03-25,2,BUF,3,4,WSH,20,13,11,4,48,36,16,9,5,66,13,10,10,3,36,26,13,8,3,50,0,1,23,40,0.46,0.54,4,4
2021021029,2022-03-25,2,NYR,5,1,PIT,24,8,13,4,49,18,10,11,0,39,24,8,13,4,49,18,10,11,0,39,1,0,33,21,0.380952,0.619048,8,2
2021021030,2022-03-25,2,WPG,4,3,CBJ,27,9,12,2,50,29,7,20,1,57,26,9,12,1,48,28,7,20,1,56,1,0,33,36,0.561404,0.438596,6,6
2021021031,2022-03-25,2,COL,6,3,PHI,38,14,16,5,73,26,1,8,3,38,38,14,16,5,73,26,1,8,3,38,1,0,51,31,0.594203,0.405797,9,11
2021021032,2022-03-25,2,CGY,4,2,ARI,24,10,13,2,49,11,6,6,2,25,24,10,13,2,49,11,6,6,2,25,1,0,33,18,0.482143,0.517857,6,8
2021021033,2022-02-11,2,ANA,3,4,SEA,21,17,13,2,53,16,13,11,4,44,21,17,13,2,53,15,13,11,4,43,0,1,27,27,0.444444,0.555556,11,11
2021021034,2022-03-26,2,BOS,6,3,NYI,32,17,15,5,69,20,5,4,1,30,32,17,15,5,69,20,5,4,1,30,1,0,44,27,0.509091,0.490909,15,13
2021021035,2022-03-26,2,MTL,4,2,TOR,12,5,8,3,28,43,7,15,1,66,12,5,8,3,28,43,7,15,1,66,0,1,18,51,0.590164,0.409836,6,4
2021021036,2022-03-26,2,OTT,3,4,FLA,17,15,11,3,46,47,11,17,3,78,13,12,11,3,39,43,11,17,2,73,1,0,22,49,0.478261,0.521739,4,8
2021021037,2022-03-26,2,DET,1,2,TBL,18,10,15,1,44,25,10,17,0,52,18,10,15,1,44,25,10,16,0,51,1,0,27,36,0.360656,0.639344,6,10
2021021038,2022-03-26,2,WSH,4,3,NJD,16,13,8,3,40,29,20,17,3,69,16,13,8,3,40,28,20,17,2,67,0,1,22,38,0.428571,0.571429,11,11
2021021039,2022-03-26,2,STL,2,7,CAR,27,13,4,1,45,17,7,6,5,35,27,13,4,0,44,17,7,6,5,35,0,1,32,28,0.413793,0.586207,7,25
2021021040,2022-03-26,2,DAL,1,4,VAN,28,12,8,1,49,23,18,12,3,56,28,12,8,1,49,23,18,12,3,56,1,0,36,31,0.5,0.5,4,6
2021021041,2022-03-26,2,MIN,3,2,CBJ,30,10,6,2,48,21,11,8,2,42,28,9,6,1,44,19,10,8,1,38,1,0,38,25,0.537313,0.462687,10,10
2021021042,2022-03-26,2,CGY,9,5,EDM,25,17,13,9,64,22,11,6,2,41,25,17,13,9,64,22,11,6,2,41,0,1,38,31,0.544118,0.455882,14,12
2021021043,2022-03-26,2,VGK,5,4,CHI,28,15,24,5,72,30,9,13,4,56,26,15,23,4,68,26,8,13,4,51,0,1,34,34,0.62069,0.37931,2,4
2021021044,2022-03-26,2,LAK,4,2,SEA,20,16,11,3,50,23,10,10,2,45,20,16,11,3,50,23,10,10,2,45,1,0,27,25,0.644444,0.355556,4,6
2021021045,2022-03-26,2,SJS,4,1,ANA,16,13,11,3,43,21,7,16,1,45,16,13,11,3,43,21,7,16,1,45,1,0,24,28,0.428571,0.571429,17,15
2021021046,2022-03-27,2,TOR,5,2,FLA,18,8,7,3,36,26,8,16,2,52,18,8,7,3,36,26,8,16,2,52,1,0,25,36,0.469697,0.530303,8,6
2021021047,2022-03-27,2,NJD,3,2,MTL,31,13,12,5,61,23,11,9,5,48,29,8,12,1,50,19,8,8,2,37,1,0,32,33,0.403509,0.596491,10,4
2021021048,2022-03-27,2,NYI,1,4,TBL,15,12,11,1,39,26,12,14,3,55,14,12,11,1,38,26,12,14,3,55,1,0,24,34,0.540984,0.459016,17,15
2021021049,2022-03-27,2,NYR,5,4,BUF,21,18,9,5,53,13,5,14,3,35,19,17,9,4,49,13,5,14,3,35,1,0,31,17,0.584906,0.415094,2,2
2021021050,2022-03-27,2,PIT,11,2,DET,17,8,7,7,39,22,9,15,1,47,16,8,7,7,38,22,9,15,1,47,1,0,35,35,0.45,0.55,10,12
2021021051,2022-03-27,2,NSH,5,4,PHI,25,19,14,5,63,15,10,8,4,37,25,19,14,5,63,15,10,8,4,37,0,1,35,23,0.6,0.4,12,14
2021021052,2022-03-27,2,MIN,3,2,COL,20,14,11,1,46,34,6,13,1,54,20,14,11,1,46,34,6,13,1,54,1,0,29,42,0.513514,0.486486,11,13
2021021053,2022-03-27,2,WPG,2,1,ARI,37,18,13,2,70,28,10,13,1,52,31,18,10,1,60,23,9,13,1,46,1,0,40,29,0.55102,0.44898,0,4
2021021054,2022-03-28,2,WSH,1,6,CAR,18,11,6,1,36,21,10,10,5,46,18,11,6,1,36,20,10,9,4,43,0,1,26,29,0.387755,0.612245,15,15
2021021055,2022-03-28,2,CHI,5,6,BUF,11,4,12,3,30,31,8,16,4,59,11,4,12,3,30,31,8,16,4,59,1,0,21,37,0.510204,0.489796,6,4
2021021056,2022-03-28,2,STL,4,1,VAN,22,10,6,4,42,33,14,15,1,63,22,10,6,4,42,33,14,15,1,63,1,0,29,36,0.489362,0.510638,4,6
2021021057,2022-03-28,2,EDM,6,1,ARI,24,13,9,5,51,26,7,8,0,41,21,12,9,5,47,26,7,8,0,41,1,0,42,32,0.482759,0.517241,10,8
2021021058,2022-03-28,2,LAK,1,6,SEA,36,12,10,0,58,26,9,11,6,52,36,12,10,0,58,26,9,11,6,52,0,1,37,38,0.465753,0.534247,7,7
2021021059,2022-03-29,2,BOS,4,6,TOR,23,11,6,3,43,19,12,4,5,40,20,8,4,3,35,18,10,4,4,36,0,1,30,32,0.526316,0.473684,22,12
2021021060,2022-03-29,2,TBL,4,3,CAR,24,11,7,1,43,14,8,8,3,33,23,10,7,0,40,13,8,7,3,31,0,1,32,19,0.52459,0.47541,8,12
2021021061,2022-03-29,2,FLA,7,4,MTL,34,14,16,6,70,17,5,7,4,33,33,14,15,6,68,17,5,6,4,32,0,1,46,24,0.550725,0.449275,6,10
2021021062,2022-03-29,2,PIT,2,3,NYR,19,10,13,1,43,19,12,19,2,52,19,10,13,1,43,19,12,19,2,52,1,0,24,26,0.541667,0.458333,4,8
2021021063,2022-03-29,2,CBJ,3,4,NYI,37,10,12,3,62,21,9,5,3,38,37,10,12,3,62,21,9,5,3,38,1,0,45,29,0.566038,0.433962,8,6
2021021064,2022-03-29,2,NSH,4,1,OTT,21,9,10,3,43,25,7,15,0,47,20,9,9,3,41,24,7,15,0,46,0,1,32,37,0.540541,0.459459,12,4
2021021065,2022-03-29,2,MIN,4,1,PHI,27,8,7,3,45,26,6,10,0,42,27,8,7,3,45,26,6,10,0,42,1,0,37,33,0.596154,0.403846,13,11
2021021066,2022-03-29,2,CGY,1,2,COL,29,12,9,0,50,26,6,11,0,43,29,12,8,0,49,25,6,11,0,42,1,0,45,30,0.680556,0.319444,8,12
2021021067,2022-03-29,2,ANA,2,3,DAL,26,11,10,2,49,24,18,15,3,60,25,11,10,2,48,24,18,14,3,59,0,1,28,32,0.416667,0.583333,6,2
2021021068,2022-03-30,2,BUF,2,3,WPG,32,14,9,4,59,23,12,5,5,45,25,14,9,2,50,22,9,4,2,37,1,0,37,27,0.46,0.54,4,6
2021021069,2022-03-30,2,DET,4,5,NYR,17,6,10,2,35,25,10,14,4,53,15,6,10,2,33,25,10,13,3,51,0,1,26,34,0.488889,0.511111,4,6
2021021070,2022-03-30,2,EDM,4,3,LAK,31,13,18,5,67,32,9,11,3,55,25,11,17,3,56,26,8,10,3,47,0,1,33,41,0.45,0.55,6,4
2021021071,2022-03-30,2,VAN,3,4,STL,21,13,18,3,55,20,7,14,2,43,21,13,18,3,55,20,7,14,2,43,1,0,25,24,0.454545,0.545455,2,2
2021021072,2022-03-30,2,ARI,5,2,SJS,18,8,8,5,39,37,12,15,1,65,18,8,8,5,39,37,12,15,1,65,0,1,24,41,0.528302,0.471698,4,2
2021021073,2022-03-30,2,SEA,0,3,VGK,21,7,12,0,40,23,18,8,3,52,21,7,12,0,40,23,18,8,3,52,0,1,22,30,0.477273,0.522727,11,7
2021021074,2022-03-31,2,BOS,8,1,NJD,28,8,12,7,55,23,9,5,1,38,28,8,12,7,55,23,9,5,1,38,1,0,40,26,0.608696,0.391304,23,23
2021021075,2022-03-31,2,TOR,7,3,WPG,20,9,12,3,44,18,10,7,2,37,19,9,12,3,43,18,10,7,2,37,0,1,38,23,0.545455,0.454545,23,39
2021021076,2022-03-31,2,FLA,4,0,CHI,36,8,9,3,56,31,19,10,0,60,36,8,9,3,56,31,19,10,0,60,1,0,44,37,0.464286,0.535714,6,6
2021021077,2022-03-31,2,NYI,5,2,CBJ,31,9,11,5,56,27,11,9,2,49,31,9,11,5,56,27,11,9,2,49,1,0,36,32,0.428571,0.571429,6,2
2021021078,2022-03-31,2,CAR,4,0,MTL,32,12,14,3,61,25,6,4,0,35,32,12,14,3,61,25,6,4,0,35,1,0,44,32,0.65,0.35,6,8
2021021079,2022-03-31,2,MIN,3,4,PIT,24,18,5,2,49,30,11,13,3,57,22,17,5,2,46,22,10,11,2,45,0,1,31,39,0.447761,0.552239,10,8
2021021080,2022-03-31,2,COL,4,2,SJS,33,12,14,3,62,22,5,6,2,35,33,12,14,3,62,22,5,6,2,35,1,0,46,27,0.627451,0.372549,6,10
2021021081,2022-03-31,2,CGY,2,3,LAK,25,15,17,1,58,25,14,9,3,51,22,15,17,1,55,22,13,7,2,44,0,1,28,32,0.457627,0.542373,4,6
2021021082,2022-03-31,2,ANA,2,3,DAL,17,8,8,2,35,29,13,21,2,65,16,8,8,2,34,28,13,21,1,63,0,1,23,35,0.396552,0.603448,2,6
2021021083,2022-04-01,2,BUF,4,3,NSH,27,8,6,3,44,21,8,10,3,42,27,8,6,3,44,21,8,10,3,42,1,0,35,25,0.56,0.44,2,4
2021021084,2022-04-01,2,DET,2,5,OTT,21,5,8,2,36,25,10,13,3,51,20,5,8,2,35,25,10,13,3,51,0,1,29,32,0.566038,0.433962,6,12
2021021085,2022-04-01,2,TBL,5,2,CHI,32,12,11,5,60,16,7,5,1,29,32,12,11,5,60,16,7,5,1,29,1,0,43,23,0.456522,0.543478,8,4
2021021086,2022-04-01,2,NYR,0,3,NYI,23,10,12,0,45,9,7,7,3,26,23,10,12,0,45,9,7,7,3,26,0,1,27,18,0.520833,0.479167,10,8
2021021087,2022-04-01,2,EDM,6,5,STL,31,10,13,5,59,27,6,12,5,50,29,10,12,4,55,24,6,12,5,47,1,0,40,36,0.393939,0.606061,8,4
2021021088,2022-04-01,2,ARI,0,5,ANA,21,17,19,0,57,26,9,11,5,51,21,16,18,0,55,24,9,11,4,48,0,1,22,37,0.510638,0.489362,38,13
2021021089,2022-04-01,2,SEA,2,5,VGK,21,14,22,2,59,20,7,6,4,37,21,14,22,2,59,20,7,6,4,37,0,1,28,26,0.527273,0.472727,12,14
2021021090,2022-04-02,2,BOS,5,2,CBJ,36,12,11,4,63,19,8,16,2,45,36,12,11,4,63,19,8,16,2,45,1,0,42,24,0.607843,0.392157,2,2
2021021091,2022-04-02,2,TBL,4,5,MTL,30,17,12,1,60,28,10,12,5,55,24,15,10,1,50,25,10,12,4,51,1,0,41,31,0.467742,0.532258,4,6
2021021092,2022-04-02,2,NJD,6,7,FLA,20,5,7,5,37,29,8,18,7,62,19,5,7,5,36,28,7,18,6,59,1,0,31,41,0.339286,0.660714,6,4
2021021093,2022-04-02,2,PHI,3,6,TOR,28,7,15,3,53,19,8,12,5,44,28,7,15,3,53,19,8,12,5,44,1,0,32,28,0.392857,0.607143,7,9
2021021094,2022-04-02,2,CAR,1,3,MIN,34,14,14,1,63,13,12,5,2,32,34,14,14,1,63,13,12,5,2,32,0,1,38,19,0.597015,0.402985,4,4
2021021095,2022-02-15,2,NSH,1,4,WSH,30,20,15,1,66,22,10,8,3,43,29,20,15,1,65,22,10,8,3,43,0,1,34,28,0.548387,0.451613,8,4
2021021096,2022-04-02,2,WPG,2,3,LAK,14,10,14,2,40,21,9,11,1,42,14,10,14,2,40,21,9,11,1,42,0,1,27,38,0.54386,0.45614,6,12
2021021097,2022-04-02,2,COL,3,2,PIT,35,9,6,3,53,38,10,14,2,64,35,9,6,3,53,38,10,14,2,64,1,0,38,40,0.555556,0.444444,2,0
2021021098,2022-04-02,2,CGY,4,6,STL,36,13,15,4,68,18,8,10,5,41,36,13,15,4,68,18,8,10,5,41,0,1,43,25,0.367647,0.632353,2,2
2021021099,2022-04-02,2,SJS,4,5,DAL,23,14,12,4,53,20,12,13,5,50,23,14,12,4,53,20,12,13,5,50,1,0,28,29,0.468085,0.531915,6,2
2021021100,2022-04-03,2,BUF,3,5,FLA,24,10,6,1,41,33,9,6,4,52,24,10,6,1,41,33,9,6,4,52,1,0,29,40,0.526316,0.473684,6,4
2021021101,2022-04-03,2,OTT,5,2,DET,24,11,19,4,58,25,9,3,2,39,24,11,19,4,58,25,9,3,2,39,0,1,36,32,0.509091,0.490909,4,8
2021021102,2022-04-03,2,NJD,3,4,NYI,25,16,10,3,54,24,7,9,3,43,25,16,10,3,54,24,7,9,3,43,0,1,30,29,0.415094,0.584906,31,9
2021021103,2022-04-03,2,NYR,3,4,PHI,38,18,14,3,73,20,8,2,4,34,32,15,12,3,62,15,6,2,3,26,0,1,46,26,0.411765,0.588235,6,6
2021021104,2022-04-03,2,WSH,1,5,MIN,22,9,15,1,47,12,10,10,5,37,22,9,15,1,47,12,10,10,5,37,0,1,26,19,0.566667,0.433333,6,2
2021021105,2022-04-03,2,CHI,2,3,ARI,26,14,16,1,57,32,9,14,2,57,24,12,16,1,53,27,8,14,2,51,1,0,31,35,0.615385,0.384615,4,6
2021021106,2022-04-03,2,VAN,2,3,VGK,20,13,16,1,50,23,10,12,3,48,18,13,16,1,48,20,9,12,2,43,0,1,28,30,0.557692,0.442308,6,6
2021021107,2022-04-03,2,ANA,1,6,EDM,31,12,15,1,59,37,15,2,5,59,31,12,15,1,59,37,15,2,5,59,0,1,32,46,0.526316,0.473684,6,4
2021021108,2022-04-03,2,SEA,4,1,DAL,20,13,8,3,44,29,16,12,1,58,20,13,8,3,44,29,15,11,0,55,1,0,29,30,0.412698,0.587302,6,2
2021021109,2022-04-04,2,TBL,2,6,TOR,30,14,8,2,54,29,9,9,6,53,30,14,8,2,54,29,9,9,6,53,0,1,34,39,0.57377,0.42623,12,14
2021021110,2022-04-04,2,CBJ,2,3,BOS,13,9,7,2,31,30,6,7,3,46,11,8,7,2,28,24,6,6,2,38,1,0,22,37,0.373134,0.626866,26,18
2021021111,2022-04-04,2,STL,5,1,ARI,21,13,13,3,50,20,7,9,1,37,21,13,13,3,50,20,7,9,1,37,1,0,29,22,0.588235,0.411765,4,4
2021021112,2022-04-04,2,LAK,2,3,CGY,18,12,6,1,37,22,18,11,3,54,18,12,6,1,37,21,18,11,3,53,0,1,29,33,0.418182,0.581818,8,16
2021021113,2022-04-05,2,BUF,4,2,CAR,15,8,5,3,31,24,13,10,2,49,15,8,5,3,31,24,13,10,2,49,0,1,22,34,0.428571,0.571429,4,6
2021021114,2022-04-05,2,MTL,3,6,OTT,23,10,11,2,46,21,7,9,4,41,23,10,11,2,46,21,7,9,4,41,1,0,30,32,0.489362,0.510638,28,16
2021021115,2022-04-05,2,DET,5,3,BOS,17,8,7,4,36,35,12,7,2,56,15,8,7,4,34,34,12,7,1,54,0,1,29,50,0.39726,0.60274,22,34
2021021116,2022-04-05,2,FLA,7,6,TOR,37,15,18,3,73,22,18,7,2,49,32,12,15,2,61,22,15,7,2,46,1,0,49,35,0.511905,0.488095,16,14
2021021117,2022-04-05,2,NJD,1,3,NYR,20,13,5,1,39,14,11,8,1,34,20,13,5,1,39,14,11,8,1,34,1,0,21,17,0.413043,0.586957,21,9
2021021118,2022-04-05,2,PHI,2,4,CBJ,38,8,14,2,62,23,13,14,4,54,38,8,14,2,62,23,13,14,4,54,0,1,49,30,0.555556,0.444444,2,8
2021021119,2022-04-05,2,PIT,4,6,COL,37,8,12,4,61,20,8,8,6,42,35,7,12,4,58,20,8,8,6,42,0,1,45,32,0.629032,0.370968,6,4
2021021120,2022-04-05,2,NSH,6,2,MIN,20,10,7,3,40,34,5,14,1,54,20,10,7,3,40,34,5,14,1,54,1,0,33,49,0.507246,0.492754,32,28
2021021121,2022-04-05,2,DAL,3,2,NYI,35,9,14,2,60,18,9,13,2,42,33,8,14,2,57,18,9,12,2,41,1,0,40,21,0.509091,0.490909,4,6
2021021122,2022-04-05,2,SJS,1,2,EDM,28,13,11,0,52,22,14,11,1,48,27,13,11,0,51,21,14,11,0,46,1,0,32,24,0.54,0.46,4,6
2021021123,2022-04-06,2,WSH,4,3,TBL,17,14,14,2,47,19,5,20,2,46,17,14,14,2,47,18,5,19,2,44,1,0,28,28,0.548387,0.451613,10,12
2021021124,2022-04-06,2,STL,4,1,SEA,22,8,4,3,37,25,17,9,1,52,22,8,4,3,37,25,17,9,1,52,1,0,36,29,0.478261,0.521739,2,12
2021021125,2022-04-06,2,WPG,1,3,DET,27,13,5,1,46,23,9,16,2,50,26,12,5,1,44,23,9,16,2,50,0,1,33,35,0.52,0.48,8,6
2021021126,2022-04-06,2,VGK,1,5,VAN,27,6,12,1,46,23,5,18,3,49,27,6,12,1,46,23,5,18,3,49,1,0,34,31,0.416667,0.583333,6,6
2021021127,2022-04-06,2,ANA,2,4,CGY,23,10,9,1,43,24,14,19,4,61,23,10,9,1,43,24,14,19,4,61,0,1,28,28,0.466667,0.533333,4,6
2021021128,2022-02-07,2,OTT,4,1,NJD,20,11,15,4,50,32,14,27,0,73,20,11,15,4,50,32,14,27,0,73,0,1,24,33,0.413043,0.586957,2,0
2021021129,2022-04-07,2,NYR,3,0,PIT,21,6,16,3,46,24,11,13,0,48,21,6,16,3,46,24,11,13,0,48,1,0,24,30,0.520833,0.479167,8,6
2021021130,2022-04-07,2,CAR,5,3,BUF,19,12,6,5,42,15,8,4,3,30,19,12,6,5,42,15,8,4,3,30,0,1,32,21,0.64,0.36,6,4
2021021131,2022-04-07,2,CBJ,1,4,PHI,20,7,9,0,36,20,11,5,4,40,20,7,9,0,36,20,11,5,4,40,1,0,27,31,0.428571,0.571429,8,4
2021021132,2022-04-07,2,CHI,0,2,SEA,24,11,11,0,46,28,5,12,2,47,24,11,11,0,46,28,5,12,2,47,0,1,29,31,0.560976,0.439024,2,8
2021021133,2022-04-07,2,DAL,3,4,TOR,12,9,15,3,39,29,4,17,3,53,11,8,14,3,36,26,4,17,2,49,0,1,18,41,0.466667,0.533333,8,6
2021021134,2022-04-07,2,ARI,1,5,VAN,21,8,13,1,43,22,11,3,3,39,21,8,13,1,43,22,11,3,3,39,0,1,28,32,0.275,0.725,4,6
2021021135,2022-04-07,2,LAK,2,3,EDM,25,9,19,1,54,20,7,10,3,40,25,9,19,1,54,20,7,10,3,40,0,1,33,30,0.5,0.5,4,6
2021021136,2022-04-07,2,SJS,2,4,CGY,27,10,10,2,49,30,16,16,4,66,27,10,10,2,49,30,16,16,4,66,0,1,33,41,0.47541,0.52459,6,6
2021021137,2022-04-08,2,TBL,1,2,BOS,18,9,10,1,38,30,4,9,2,45,16,9,10,1,36,28,4,8,1,41,0,1,29,37,0.517857,0.482143,6,10
2021021138,2022-04-08,2,FLA,4,3,BUF,34,10,13,2,59,11,9,13,2,35,34,10,13,2,59,11,9,13,2,35,0,1,43,22,0.489796,0.510204,10,4
2021021139,2022-04-08,2,CAR,1,2,NYI,15,18,13,1,47,15,8,6,2,31,14,18,13,1,46,15,8,6,2,31,0,1,21,21,0.568182,0.431818,8,8
2021021140,2022-04-08,2,STL,4,3,MIN,21,4,16,3,44,32,6,13,3,54,20,4,16,2,42,29,5,13,3,50,1,0,28,38,0.522388,0.477612,6,6
2021021141,2022-04-08,2,WPG,4,5,COL,36,10,14,3,63,24,8,9,4,45,36,10,14,3,63,24,7,9,4,44,0,1,43,37,0.516129,0.483871,6,6
2021021142,2022-04-09,2,TOR,3,2,MTL,30,11,16,3,60,18,6,5,2,31,28,11,16,3,58,16,6,5,2,29,1,0,40,26,0.603774,0.396226,10,22
2021021143,2022-04-09,2,DET,4,5,CBJ,27,6,15,4,52,22,10,10,5,47,24,5,14,4,47,20,10,10,3,43,0,1,38,33,0.525424,0.474576,14,6
2021021144,2022-04-09,2,NYR,5,1,OTT,26,13,18,5,62,21,9,3,1,34,26,13,18,5,62,21,9,3,1,34,0,1,33,22,0.526316,0.473684,2,2
2021021145,2022-04-09,2,PHI,3,5,ANA,26,7,12,3,48,25,13,16,4,58,26,7,12,3,48,25,13,16,4,58,1,0,33,34,0.571429,0.428571,4,4
2021021146,2022-04-09,2,PIT,3,6,WSH,26,17,14,3,60,30,9,10,4,53,26,17,14,3,60,30,9,10,4,53,1,0,32,45,0.478261,0.521739,13,11
2021021147,2022-04-09,2,STL,6,1,NYI,17,13,4,6,40,21,13,7,1,42,17,13,4,6,40,21,13,7,1,42,1,0,31,31,0.509434,0.490566,4,8
2021021148,2022-04-09,2,NSH,1,4,FLA,20,12,19,1,52,15,7,14,4,40,20,12,19,1,52,15,7,14,4,40,0,1,25,25,0.555556,0.444444,21,9
2021021149,2022-04-09,2,DAL,1,3,NJD,22,10,8,0,40,18,7,4,3,32,21,10,8,0,39,17,7,4,3,31,1,0,28,23,0.551724,0.448276,6,12
2021021150,2022-04-10,2,MIN,6,3,LAK,25,5,12,5,47,24,14,10,1,49,25,5,12,5,47,24,14,10,1,49,0,1,33,34,0.563636,0.436364,11,11
2021021151,2022-04-09,2,EDM,1,2,COL,41,7,16,1,65,29,15,9,2,55,35,7,16,1,59,28,15,9,1,53,1,0,50,34,0.6,0.4,4,4
2021021152,2022-04-09,2,VAN,4,2,SJS,20,7,14,3,44,26,9,10,1,46,18,7,14,3,42,24,9,10,1,44,1,0,39,37,0.454545,0.545455,15,19
2021021153,2022-04-09,2,VGK,6,1,ARI,32,8,12,6,58,27,9,11,1,48,32,8,12,6,58,27,9,11,1,48,1,0,39,30,0.526316,0.473684,2,6
2021021154,2022-04-09,2,SEA,1,4,CGY,16,6,14,1,37,20,9,8,2,39,16,6,14,1,37,20,9,8,2,39,0,1,28,29,0.518519,0.481481,8,10
2021021155,2022-04-10,2,OTT,3,4,WPG,24,4,11,1,40,16,8,6,2,32,22,4,11,1,38,16,8,6,2,32,1,0,34,25,0.52381,0.47619,8,8
2021021156,2022-04-10,2,TBL,5,0,BUF,20,10,8,5,43,26,12,8,0,46,20,10,8,5,43,25,12,8,0,45,1,0,28,28,0.603774,0.396226,4,4
2021021157,2022-04-10,2,PIT,3,2,NSH,25,16,12,3,56,30,8,17,2,57,24,15,12,2,53,30,8,15,2,55,1,0,30,35,0.473684,0.526316,15,9
2021021158,2022-04-10,2,WSH,4,2,BOS,21,14,9,4,48,24,11,20,2,57,21,14,9,4,48,24,11,20,2,57,1,0,33,30,0.394366,0.605634,8,4
2021021159,2022-04-10,2,CAR,5,2,ANA,32,18,7,5,62,20,6,4,2,32,31,17,7,5,60,20,6,4,2,32,1,0,43,25,0.491228,0.508772,12,10
2021021160,2022-04-10,2,CHI,4,6,DAL,31,9,11,3,54,20,10,15,4,49,31,9,11,3,54,20,10,15,4,49,0,1,40,30,0.473684,0.526316,4,4
2021021161,2022-02-20,2,SJS,1,4,VGK,29,11,13,1,54,24,12,18,4,58,29,11,11,1,52,23,12,17,3,55,0,1,36,35,0.375,0.625,22,22
2021021162,2022-04-11,2,MTL,2,4,WPG,23,7,13,2,45,31,8,13,4,56,23,7,13,2,45,31,8,13,4,56,1,0,25,35,0.454545,0.545455,2,2
2021021163,2022-04-12,2,MIN,5,1,EDM,12,3,6,5,26,23,7,20,0,50,12,3,6,5,26,23,7,20,0,50,1,0,23,28,0.5,0.5,18,18
2021021164,2022-04-12,2,BOS,2,4,STL,35,10,13,2,60,17,4,4,3,28,35,10,13,2,60,17,4,4,3,28,0,1,41,30,0.557377,0.442623,8,4
2021021165,2022-04-12,2,TOR,2,5,BUF,20,6,8,2,36,19,11,10,3,43,19,6,8,2,35,19,10,9,3,41,0,1,26,28,0.688525,0.311475,8,10
2021021166,2022-04-12,2,DET,1,4,OTT,21,4,14,0,39,24,10,5,4,43,20,4,14,0,38,24,10,5,4,43,0,1,25,32,0.508772,0.491228,4,8
2021021167,2022-04-12,2,FLA,3,2,ANA,45,16,17,2,80,20,6,5,2,33,41,15,17,1,74,19,6,5,2,32,0,1,55,24,0.622951,0.377049,4,6
2021021168,2022-04-12,2,NYR,2,4,CAR,24,10,10,2,46,18,11,14,4,47,23,9,10,2,44,18,10,14,4,46,1,0,30,25,0.448276,0.551724,4,8
2021021169,2022-04-29,2,PIT,5,3,CBJ,40,13,8,5,66,24,10,17,1,52,38,13,5,5,61,24,10,17,1,52,1,0,50,36,0.655738,0.344262,14,10
2021021170,2022-04-12,2,WSH,9,2,PHI,23,8,12,8,51,17,8,12,1,38,23,8,12,8,51,17,8,12,1,38,1,0,37,21,0.551724,0.448276,16,28
2021021171,2022-04-14,2,CHI,5,4,SJS,27,12,13,4,56,33,8,19,4,64,19,11,13,2,45,29,6,17,4,56,1,0,32,37,0.639344,0.360656,11,15
2021021172,2022-04-14,2,NSH,0,4,EDM,26,9,6,0,41,25,6,9,1,41,25,9,6,0,40,25,6,9,1,41,0,1,30,32,0.492754,0.507246,8,6
2021021173,2022-04-12,2,DAL,1,0,TBL,22,8,12,1,43,19,8,19,0,46,22,8,12,1,43,19,8,19,0,46,1,0,29,25,0.508475,0.491525,11,11
2021021174,2022-04-12,2,CGY,5,3,SEA,15,5,14,3,37,15,12,6,3,36,15,5,14,3,37,15,12,6,3,36,0,1,31,22,0.576271,0.423729,4,20
2021021175,2022-04-12,2,VAN,5,4,VGK,20,7,5,3,35,38,9,10,4,61,19,5,5,2,31,38,9,10,4,61,1,0,27,45,0.482759,0.517241,6,6
2021021176,2022-04-12,2,ARI,2,6,NJD,15,17,12,1,45,21,9,9,6,45,14,16,12,1,43,20,9,9,5,43,1,0,21,38,0.509804,0.490196,12,10
2021021177,2022-04-13,2,PHI,0,4,NYR,23,11,14,0,48,21,9,11,3,44,21,11,14,0,46,20,9,11,3,43,0,1,28,34,0.44186,0.55814,20,18
2021021178,2022-04-13,2,CBJ,5,1,MTL,18,10,16,4,48,17,12,12,0,41,18,10,16,4,48,17,12,12,0,41,1,0,31,21,0.37037,0.62963,8,6
2021021179,2022-05-01,2,WPG,4,3,SEA,22,11,8,4,45,26,11,9,2,48,22,11,8,4,45,26,11,9,2,48,1,0,27,30,0.590909,0.409091,2,2
2021021180,2022-04-13,2,COL,9,3,LAK,22,12,11,7,52,26,14,10,3,53,22,12,11,7,52,26,14,10,3,53,1,0,35,32,0.480769,0.519231,4,4
2021021181,2022-04-14,2,BOS,2,3,OTT,31,9,5,2,47,19,5,5,1,30,31,9,5,2,47,19,5,5,1,30,1,0,42,32,0.68254,0.31746,12,10
2021021182,2022-04-14,2,BUF,2,6,STL,33,17,12,2,64,19,6,4,4,33,33,17,12,2,64,19,6,4,4,33,1,0,37,28,0.54902,0.45098,6,4
2021021183,2022-04-14,2,TOR,7,3,WSH,19,13,11,7,50,18,5,11,3,37,15,13,10,5,43,15,5,9,1,30,1,0,32,25,0.6,0.4,15,17
2021021184,2022-04-14,2,TBL,4,3,ANA,20,10,14,4,48,22,13,7,3,45,19,9,13,3,44,20,12,7,3,42,1,0,31,26,0.519231,0.480769,2,6
2021021185,2022-04-14,2,PIT,6,3,NYI,22,9,11,6,48,29,4,16,3,52,21,9,10,6,46,27,4,15,3,49,1,0,28,39,0.472727,0.527273,10,6
2021021186,2022-04-14,2,CAR,0,3,DET,43,24,11,0,78,18,7,7,3,35,43,22,11,0,76,18,7,7,3,35,0,1,46,22,0.583333,0.416667,4,8
2021021187,2022-04-12,2,CHI,2,5,LAK,13,6,12,2,33,29,7,12,5,53,13,6,12,2,33,29,7,12,5,53,0,1,20,36,0.55102,0.44898,6,10
2021021188,2022-04-12,2,NSH,1,0,SJS,37,18,18,1,74,23,10,8,0,41,37,18,18,0,73,20,10,8,0,38,0,0,41,25,0.571429,0.428571,16,18
2021021189,2022-04-14,2,DAL,2,3,MIN,32,12,8,1,53,23,11,16,2,52,32,12,8,1,53,23,11,16,1,51,0,1,36,27,0.596491,0.403509,0,6
2021021190,2022-04-14,2,COL,3,1,NJD,25,10,16,2,53,23,17,8,1,49,25,10,16,2,53,23,17,8,1,49,1,0,30,27,0.636364,0.363636,4,4
2021021191,2022-04-14,2,CGY,1,6,VGK,29,11,9,0,49,12,4,5,5,26,28,11,9,0,48,10,4,5,5,24,1,0,36,25,0.45283,0.54717,10,8
2021021192,2022-04-14,2,VAN,7,1,ARI,17,10,9,4,40,19,8,18,0,45,17,10,9,4,40,19,8,18,0,45,1,0,27,22,0.527273,0.472727,4,8
2021021193,2022-04-15,2,MTL,0,3,NYI,39,14,25,0,78,13,4,12,3,32,39,14,25,0,78,13,4,11,3,31,0,1,44,20,0.604167,0.395833,9,11
2021021194,2022-04-15,2,FLA,6,1,WPG,31,7,5,6,49,20,9,8,1,38,31,7,5,6,49,20,9,8,1,38,1,0,43,31,0.466667,0.533333,10,4
2021021195,2022-04-16,2,EDM,4,0,VGK,27,10,13,3,53,33,10,15,0,58,27,10,13,3,53,33,10,15,0,58,1,0,36,39,0.530303,0.469697,6,2
2021021196,2022-04-16,2,BOS,2,1,PIT,25,5,9,2,41,17,8,5,1,31,25,5,9,2,41,17,8,5,1,31,1,0,29,24,0.446429,0.553571,6,4
2021021197,2022-04-16,2,BUF,4,3,PHI,20,9,12,2,43,12,3,4,3,22,20,9,12,2,43,12,3,4,3,22,0,1,29,21,0.518519,0.481481,10,10
2021021198,2022-04-16,2,MTL,4,8,WSH,22,9,9,4,44,27,14,14,6,61,21,9,9,3,42,24,13,13,4,54,0,1,32,41,0.56,0.44,16,8
2021021199,2022-04-16,2,OTT,4,5,TOR,23,12,10,4,49,30,16,16,5,67,21,12,9,4,46,29,11,16,4,60,1,0,29,41,0.492063,0.507937,4,2
2021021200,2022-04-16,2,TBL,7,4,WPG,25,7,13,6,51,12,7,9,3,31,22,7,13,5,47,11,6,7,3,27,0,1,37,18,0.488889,0.511111,16,18
2021021201,2022-04-16,2,NYR,4,0,DET,30,10,14,3,57,16,8,9,0,33,30,10,14,3,57,16,8,9,0,33,1,0,37,20,0.6,0.4,2,8
2021021202,2022-04-16,2,STL,6,5,MIN,19,6,10,5,40,23,9,9,4,45,18,6,10,3,37,21,8,9,4,42,1,0,30,36,0.528571,0.471429,12,14
2021021203,2022-04-16,2,NSH,4,3,CHI,28,12,7,3,50,23,3,9,3,38,28,12,7,2,49,21,3,9,3,36,1,0,34,31,0.46875,0.53125,10,16
2021021204,2022-04-16,2,DAL,2,1,SJS,19,10,17,1,47,20,12,11,1,44,19,10,17,1,47,20,12,11,1,44,1,0,26,24,0.590164,0.409836,4,2
2021021205,2022-04-16,2,COL,7,4,CAR,27,9,14,5,55,25,9,19,3,56,27,8,14,5,54,25,9,18,3,55,1,0,37,33,0.538462,0.461538,6,20
2021021206,2022-04-16,2,CGY,9,1,ARI,29,14,12,9,64,23,10,4,1,38,29,14,12,9,64,23,10,4,1,38,0,1,41,26,0.574074,0.425926,4,4
2021021207,2022-04-29,2,EDM,3,2,VAN,30,13,19,3,65,36,15,15,2,68,26,10,19,2,57,27,14,13,2,56,0,1,33,41,0.45283,0.54717,4,2
2021021208,2022-04-16,2,LAK,2,1,CBJ,29,12,6,2,49,18,10,23,1,52,28,12,6,2,48,18,7,21,1,47,1,0,38,22,0.5,0.5,10,12
2021021209,2022-04-16,2,SEA,4,3,NJD,17,14,12,2,45,18,14,16,3,51,17,14,12,2,45,17,14,16,3,50,0,1,26,26,0.551724,0.448276,6,6
2021021210,2022-04-17,2,DET,1,6,FLA,26,5,7,1,39,30,13,6,5,54,26,5,7,1,39,30,13,6,5,54,0,1,34,39,0.553571,0.446429,4,6
2021021211,2022-01-22,2,NYI,1,3,TOR,23,9,8,1,41,18,5,12,2,37,23,9,8,1,41,18,5,12,2,37,0,1,28,23,0.489362,0.510638,4,6
2021021212,2022-04-17,2,PHI,3,5,BUF,28,9,14,3,54,31,13,15,3,62,28,9,14,3,54,31,13,15,3,62,1,0,35,40,0.564516,0.435484,4,4
2021021213,2022-04-17,2,NSH,3,8,STL,30,15,10,3,58,25,7,12,7,51,30,15,10,3,58,25,7,12,7,51,1,0,36,33,0.459016,0.540984,2,4
2021021214,2022-04-17,2,MIN,5,4,SJS,19,10,16,5,50,17,11,8,3,39,18,9,15,4,46,16,9,8,3,36,1,0,28,30,0.571429,0.428571,6,10
2021021215,2022-04-17,2,ANA,6,4,CBJ,24,9,10,6,49,25,12,10,4,51,24,9,10,6,49,25,12,10,4,51,1,0,32,35,0.403509,0.596491,4,2
2021021216,2022-04-18,2,COL,2,3,WSH,19,9,20,2,50,23,9,12,2,46,19,8,20,2,49,23,9,12,2,46,0,1,26,27,0.509434,0.490566,4,6
2021021217,2022-04-18,2,VAN,6,2,DAL,22,16,11,6,55,27,7,14,0,48,22,16,11,6,55,27,7,14,0,48,1,0,31,30,0.45,0.55,7,9
2021021218,2022-04-18,2,ARI,3,5,CAR,20,10,11,3,44,45,13,9,5,72,20,10,11,3,44,45,13,9,5,72,0,1,26,51,0.421875,0.578125,2,8
2021021219,2022-04-18,2,VGK,2,3,NJD,38,21,23,2,84,24,6,16,3,49,38,21,23,2,84,24,6,16,3,49,0,1,44,28,0.508475,0.491525,2,2
2021021220,2022-04-19,2,TOR,5,2,PHI,21,9,11,4,45,26,7,7,2,42,21,9,11,4,45,25,7,7,2,41,1,0,29,39,0.533333,0.466667,11,15
2021021221,2022-04-19,2,MTL,0,2,MIN,22,9,13,0,44,24,13,18,1,56,22,9,13,0,44,24,12,18,1,55,0,1,26,30,0.555556,0.444444,8,6
2021021222,2022-04-19,2,TBL,3,4,DET,35,17,14,2,68,26,12,10,4,52,35,17,14,2,68,26,12,10,4,52,1,0,41,31,0.542373,0.457627,4,6
2021021223,2022-04-19,2,NYI,2,3,FLA,20,10,8,1,39,34,13,12,2,61,20,10,8,1,39,32,13,12,0,57,1,0,26,42,0.482759,0.517241,10,16
2021021224,2022-04-19,2,NYR,3,0,WPG,26,8,12,2,48,31,8,14,0,53,26,8,12,2,48,31,8,14,0,53,1,0,34,31,0.555556,0.444444,2,4
2021021225,2022-04-19,2,STL,2,3,BOS,17,9,12,1,39,31,10,13,3,57,16,8,11,1,36,30,10,12,2,54,1,0,22,35,0.4,0.6,6,8
2021021226,2022-04-19,2,ANA,1,2,LAK,18,5,13,0,36,24,14,6,2,46,18,5,13,0,36,21,13,6,2,42,0,1,30,28,0.489796,0.510204,4,10
2021021227,2022-04-19,2,SJS,3,2,CBJ,20,5,13,2,40,20,13,15,1,49,20,5,13,2,40,19,13,15,1,48,1,0,28,24,0.545455,0.454545,8,6
2021021228,2022-02-17,2,BUF,1,3,OTT,14,2,9,0,25,22,13,10,3,48,13,2,9,0,24,22,13,10,3,48,1,0,24,28,0.446429,0.553571,19,17
2021021229,2022-04-20,2,EDM,5,2,DAL,42,14,12,5,73,28,6,15,2,51,42,14,12,5,73,28,6,15,2,51,1,0,50,36,0.476923,0.523077,4,2
2021021230,2022-04-20,2,ARI,3,4,CHI,26,11,10,3,50,29,13,14,4,60,23,11,10,2,46,26,10,14,3,53,0,1,35,40,0.389831,0.610169,17,9
2021021231,2022-04-20,2,VGK,4,3,WSH,24,12,19,3,58,24,9,10,3,46,24,12,18,2,56,24,9,10,3,46,0,1,30,28,0.466667,0.533333,2,4
2021021232,2022-04-20,2,SEA,3,2,COL,23,11,11,3,48,24,10,20,2,56,23,11,11,3,48,24,10,20,2,56,1,0,29,27,0.543478,0.456522,4,2
2021021233,2022-04-21,2,MTL,3,6,PHI,26,8,15,3,52,23,6,14,6,49,23,8,15,3,49,21,6,14,6,47,0,1,34,34,0.586207,0.413793,8,4
2021021234,2022-04-21,2,TBL,8,1,TOR,19,14,11,5,49,27,4,11,0,42,19,13,11,4,47,26,4,11,0,41,1,0,36,37,0.507692,0.492308,49,65
2021021235,2022-04-21,2,FLA,5,2,DET,15,8,15,3,41,22,5,15,2,44,15,8,15,3,41,22,5,15,2,44,0,1,27,30,0.666667,0.333333,8,23
2021021236,2022-04-21,2,NJD,2,5,BUF,22,13,9,2,46,21,6,6,3,36,21,12,9,2,44,21,6,6,3,36,0,1,31,28,0.5,0.5,4,8
2021021237,2022-04-21,2,NYI,3,6,NYR,24,11,10,2,47,16,5,13,5,39,24,11,10,2,47,16,5,12,4,37,0,1,29,23,0.55,0.45,4,4
2021021238,2022-04-21,2,PIT,4,0,BOS,22,13,5,4,44,46,8,13,0,67,22,13,5,4,44,46,8,13,0,67,1,0,32,52,0.484375,0.515625,4,2
2021021239,2022-04-21,2,CAR,4,2,WPG,34,14,10,3,61,18,9,6,2,35,31,14,8,3,56,18,9,6,1,34,0,1,46,22,0.603774,0.396226,6,12
2021021240,2022-04-21,2,MIN,6,3,VAN,20,9,7,6,42,17,13,12,3,45,20,9,7,6,42,16,11,12,3,42,1,0,32,24,0.42,0.58,11,13
2021021241,2022-04-21,2,CGY,4,2,DAL,20,11,5,3,39,19,10,8,1,38,20,11,5,3,39,18,10,8,1,37,1,0,37,23,0.5,0.5,10,10
2021021242,2022-04-21,2,LAK,4,1,CHI,23,15,20,3,61,12,4,10,0,26,22,15,19,3,59,12,4,9,0,25,1,0,36,16,0.47619,0.52381,8,8
2021021243,2022-04-21,2,SJS,1,3,STL,14,4,5,1,24,19,7,7,2,35,14,4,5,1,24,14,7,7,2,30,1,0,21,28,0.531915,0.468085,12,4
2021021244,2022-04-22,2,CBJ,1,2,OTT,33,12,12,0,57,20,17,15,2,54,26,8,12,0,46,18,14,15,1,48,1,0,34,26,0.508772,0.491228,4,4
2021021245,2022-04-22,2,MIN,6,3,SEA,21,4,5,3,33,20,7,14,2,43,21,4,5,3,33,20,7,14,2,43,0,1,35,28,0.568966,0.431034,9,15
2021021246,2022-04-22,2,EDM,6,3,COL,18,7,14,6,45,17,12,14,3,46,17,7,14,5,43,15,11,14,3,43,0,1,27,37,0.54902,0.45098,16,8
2021021247,2022-04-22,2,ARI,0,2,WSH,18,6,9,0,33,21,13,11,2,47,18,6,9,0,33,21,13,11,2,47,0,1,19,29,0.490909,0.509091,8,0
2021021248,2022-04-23,2,BOS,3,1,NYR,23,5,13,3,44,23,4,10,0,37,23,5,13,3,44,22,4,10,0,36,1,0,35,31,0.62,0.38,8,8
2021021249,2022-04-23,2,BUF,5,3,NYI,23,9,9,4,45,17,4,10,3,34,23,9,9,4,45,17,4,10,3,34,1,0,35,22,0.4,0.6,16,34
2021021250,2022-04-23,2,OTT,6,4,MTL,13,10,10,5,38,34,2,11,4,51,13,10,10,5,38,34,2,11,4,51,1,0,26,48,0.389831,0.610169,25,27
2021021251,2022-04-23,2,DET,2,7,PIT,23,5,11,1,40,30,12,8,6,56,23,5,11,1,40,30,12,8,6,56,0,1,25,38,0.37037,0.62963,2,6
2021021252,2022-04-23,2,TBL,6,2,NSH,26,12,12,4,54,14,8,13,0,35,25,10,12,4,51,13,6,13,0,32,1,0,39,21,0.442623,0.557377,17,13
2021021253,2022-04-23,2,FLA,3,2,TOR,29,6,12,2,49,30,12,15,2,59,27,6,12,1,46,28,11,15,2,56,0,1,35,36,0.45614,0.54386,8,8
2021021254,2022-04-23,2,NJD,2,3,CAR,12,8,10,1,31,25,14,13,3,55,11,8,10,1,30,24,14,12,2,52,1,0,19,29,0.473684,0.526316,6,8
2021021255,2022-04-23,2,DAL,3,2,SEA,27,11,17,2,57,25,16,14,2,57,27,9,17,2,55,24,15,14,2,55,0,1,31,32,0.634921,0.365079,4,6
2021021256,2022-04-23,2,CGY,6,3,VAN,25,17,15,5,62,24,9,5,3,41,25,17,15,5,62,23,8,4,3,38,1,0,31,31,0.539683,0.460317,4,6
2021021257,2022-04-23,2,ARI,4,5,STL,15,11,5,4,35,26,9,11,4,50,15,11,5,4,35,25,8,11,3,47,0,1,20,33,0.333333,0.666667,8,4
2021021258,2022-04-23,2,LAK,4,2,ANA,26,9,9,3,47,16,7,9,1,33,26,9,9,3,47,16,7,9,1,33,1,0,40,21,0.490566,0.509434,23,16
2021021259,2022-04-23,2,SJS,4,1,CHI,12,9,6,3,30,23,9,14,1,47,12,9,6,3,30,22,9,14,1,46,1,0,19,28,0.391304,0.608696,4,6
2021021260,2022-04-24,2,FLA,4,8,TBL,29,14,14,3,60,17,5,10,4,36,29,14,14,3,60,17,5,10,4,36,0,1,39,33,0.479452,0.520548,66,24
2021021261,2022-04-24,2,NJD,0,3,DET,17,14,4,0,35,19,8,7,3,37,17,14,4,0,35,19,8,7,3,37,0,1,17,24,0.477273,0.522727,6,4
2021021262,2022-04-24,2,NYI,2,5,CAR,24,9,10,1,44,27,14,9,4,54,22,8,9,1,40,27,14,9,4,54,0,1,26,34,0.425532,0.574468,6,10
2021021263,2022-02-15,2,NYR,2,1,BOS,36,12,13,4,65,35,7,13,3,58,24,10,13,1,48,26,5,13,1,45,0,1,34,32,0.547619,0.452381,6,6
2021021264,2022-04-24,2,PHI,4,1,PIT,32,6,9,3,50,30,9,17,1,57,32,6,9,3,50,30,9,17,1,57,1,0,43,38,0.5,0.5,4,6
2021021265,2022-04-24,2,WSH,3,4,TOR,26,14,17,3,60,24,10,10,3,47,24,12,16,3,55,22,10,10,3,45,1,0,37,30,0.384615,0.615385,4,6
2021021266,2022-04-24,2,CBJ,5,2,EDM,18,8,8,4,38,30,7,9,1,47,18,8,8,4,38,30,7,9,1,47,0,1,31,35,0.517857,0.482143,8,20
2021021267,2022-04-24,2,NSH,4,5,MIN,11,9,7,2,29,29,10,10,3,52,9,9,7,2,27,28,9,9,2,48,0,1,25,47,0.415385,0.584615,14,10
2021021268,2022-04-24,2,WPG,4,1,COL,35,16,4,4,59,30,17,18,1,66,35,16,4,4,59,30,17,18,1,66,0,1,44,31,0.415385,0.584615,4,4
2021021269,2022-04-24,2,VGK,4,5,SJS,36,11,24,3,74,22,16,14,4,56,33,10,23,3,69,21,16,13,4,54,0,1,46,29,0.575342,0.424658,2,8
2021021270,2022-04-24,2,ANA,3,6,STL,14,11,6,3,34,27,12,11,6,56,14,11,6,3,34,27,12,11,6,56,1,0,17,37,0.413043,0.586957,2,2
2021021271,2022-04-25,2,CHI,3,1,PHI,18,6,11,3,38,20,10,11,1,42,18,6,11,3,38,20,10,11,1,42,1,0,33,34,0.538462,0.461538,10,12
2021021272,2022-04-26,2,BOS,4,2,FLA,27,13,5,4,49,18,10,11,1,40,27,13,5,4,49,18,10,11,1,40,0,1,38,21,0.55,0.45,8,10
2021021273,2022-02-23,2,MTL,4,0,BUF,25,7,7,4,43,28,5,17,0,50,25,7,7,3,42,28,4,16,0,48,1,0,29,32,0.557692,0.442308,11,9
2021021274,2022-04-26,2,OTT,5,4,NJD,27,10,8,2,47,34,6,17,4,61,25,9,8,1,43,34,6,17,4,61,1,0,34,41,0.514286,0.485714,4,6
2021021275,2022-02-26,2,DET,7,10,TOR,23,9,5,7,44,29,6,16,9,60,23,9,5,7,44,29,6,16,9,60,0,1,33,39,0.410714,0.589286,0,6
2021021276,2022-04-26,2,TBL,4,1,CBJ,26,5,7,3,41,18,14,20,0,52,26,5,7,3,41,18,14,20,0,52,1,0,32,21,0.5,0.5,6,4
2021021277,2022-04-26,2,NYR,3,4,CAR,26,4,9,3,42,21,14,7,4,46,24,4,9,3,40,21,14,7,3,45,0,1,34,36,0.350877,0.649123,11,13
2021021278,2022-04-26,2,PIT,1,5,EDM,25,6,15,1,47,29,9,11,3,52,25,6,15,1,47,28,8,10,3,49,0,1,34,42,0.517857,0.482143,8,8
2021021279,2022-04-26,2,WSH,1,4,NYI,26,13,15,1,55,17,11,9,1,38,26,13,15,1,55,17,11,9,1,38,1,0,33,26,0.520833,0.479167,4,8
2021021280,2022-04-26,2,NSH,4,5,CGY,15,7,11,2,35,26,10,13,4,53,13,6,11,2,32,21,10,13,2,46,0,1,23,38,0.564516,0.435484,26,30
2021021281,2022-04-26,2,DAL,3,2,VGK,33,9,22,3,67,37,11,24,1,73,25,9,20,2,56,27,8,22,1,58,0,1,30,35,0.57971,0.42029,4,4
2021021282,2022-04-26,2,MIN,3,5,ARI,30,7,14,3,54,16,13,9,4,42,30,7,14,3,54,16,13,9,4,42,1,0,38,26,0.457627,0.542373,18,12
2021021283,2022-04-26,2,COL,5,3,STL,28,19,16,5,68,23,7,17,2,49,28,19,15,5,67,22,7,15,2,46,1,0,34,32,0.52381,0.47619,8,6
2021021284,2022-04-26,2,VAN,5,2,SEA,16,7,9,4,36,20,10,10,1,41,16,7,9,4,36,20,9,10,1,40,1,0,27,32,0.588235,0.411765,16,6
2021021285,2022-04-26,2,SJS,2,5,ANA,28,16,17,1,62,26,7,12,4,49,28,16,17,1,62,26,7,12,4,49,0,1,33,31,0.480769,0.519231,9,11
2021021286,2022-04-27,2,CHI,4,3,VGK,39,9,14,4,66,42,14,16,3,75,29,8,13,3,53,34,13,15,3,65,1,0,40,40,0.490566,0.509434,2,4
2021021287,2022-04-27,2,DAL,3,4,ARI,16,16,12,2,46,28,7,5,3,43,15,16,12,2,45,28,7,5,2,42,1,0,29,37,0.597222,0.402778,6,8
2021021288,2022-04-27,2,WPG,4,0,PHI,18,13,5,2,38,24,6,15,0,45,18,13,5,2,38,24,6,15,0,45,1,0,27,35,0.490196,0.509804,8,10
2021021289,2022-04-27,2,SEA,3,5,LAK,34,14,12,3,63,21,11,12,5,49,34,14,12,3,63,21,11,12,5,49,1,0,40,28,0.589286,0.410714,2,10
2021021290,2022-04-28,2,BOS,5,0,BUF,19,5,2,3,29,29,7,8,0,44,18,5,2,3,28,28,7,7,0,42,1,0,32,37,0.589286,0.410714,8,14
2021021291,2022-04-28,2,OTT,0,4,FLA,23,8,15,0,46,21,8,10,4,43,23,8,15,0,46,21,8,10,4,43,0,1,27,30,0.547619,0.452381,21,11
2021021292,2022-04-29,2,NYI,4,6,TBL,32,13,13,3,61,26,12,12,5,55,32,13,13,3,61,26,12,12,5,55,1,0,37,34,0.491228,0.508772,2,2
2021021293,2022-02-08,2,WSH,4,5,CBJ,21,14,13,3,51,18,11,10,3,42,21,14,13,3,51,18,11,10,3,42,1,0,33,26,0.619048,0.380952,6,8
2021021294,2022-04-28,2,CAR,6,3,NJD,23,15,10,6,54,26,10,13,3,52,23,15,10,6,54,26,10,13,3,52,1,0,36,30,0.509804,0.490196,4,6
2021021295,2022-04-28,2,MIN,3,2,CGY,21,12,7,1,41,25,6,13,2,46,20,11,7,1,39,25,6,13,2,46,0,1,25,33,0.5625,0.4375,8,4
2021021296,2022-04-28,2,COL,4,5,NSH,37,13,13,3,66,33,10,11,4,58,31,10,13,3,57,28,6,10,3,47,1,0,46,37,0.408451,0.591549,10,14
2021021297,2022-04-28,2,EDM,5,4,SJS,18,14,13,4,49,38,16,16,3,73,17,14,13,3,47,38,15,16,3,72,0,1,31,44,0.423729,0.576271,2,8
2021021298,2022-04-29,2,BUF,3,2,CHI,29,13,7,3,52,17,7,3,2,29,25,13,7,2,47,17,6,3,2,28,0,1,36,21,0.478261,0.521739,2,6
2021021299,2022-04-29,2,TOR,5,2,BOS,21,4,12,4,41,20,12,8,1,41,21,4,12,4,41,20,12,8,1,41,0,1,27,26,0.471698,0.528302,4,8
2021021300,2022-04-29,2,MTL,10,2,FLA,24,8,9,9,50,35,11,21,1,68,24,8,9,9,50,35,11,21,1,68,1,0,37,39,0.546875,0.453125,2,4
2021021301,2022-04-29,2,NJD,3,5,DET,19,8,15,3,45,28,12,10,5,55,19,8,15,3,45,28,12,10,5,55,0,1,23,35,0.56,0.44,4,2
2021021302,2022-04-29,2,NYR,3,2,WSH,26,9,6,3,44,29,8,14,1,52,24,9,5,3,41,29,8,13,1,51,1,0,33,36,0.609375,0.390625,12,6
2021021303,2022-04-29,2,PHI,2,4,OTT,28,11,9,0,48,24,5,10,3,42,28,11,9,0,48,24,5,10,3,42,1,0,34,36,0.59322,0.40678,8,6
2021021304,2022-02-20,2,PIT,3,4,CAR,30,8,7,2,47,20,10,4,3,37,30,8,7,2,47,20,10,4,3,37,0,1,34,30,0.474576,0.525424,4,8
2021021305,2022-04-28,2,CBJ,5,2,TBL,23,15,7,4,49,15,10,10,0,35,23,15,7,4,49,15,9,10,0,34,1,0,35,27,0.625,0.375,16,10
2021021306,2022-04-29,2,STL,4,7,VGK,14,14,11,2,41,36,16,14,6,72,14,14,11,2,41,36,16,14,6,72,0,1,18,45,0.462963,0.537037,4,6
2021021307,2022-04-29,2,DAL,4,2,ANA,15,14,14,3,46,16,10,12,2,40,14,14,14,3,45,16,10,12,2,40,0,1,19,21,0.702128,0.297872,2,4
2021021308,2022-04-29,2,MIN,4,1,COL,11,6,4,4,25,23,9,12,1,45,11,5,4,4,24,23,9,12,1,45,1,0,22,28,0.568627,0.431373,27,32
2021021309,2022-04-29,2,WPG,3,1,CGY,33,13,14,3,63,25,10,9,1,45,33,13,14,3,63,25,10,9,1,45,0,1,43,33,0.472727,0.527273,4,8
2021021310,2022-04-28,2,VAN,3,2,LAK,23,13,20,2,58,27,8,6,2,43,21,12,19,1,53,22,7,5,2,36,0,1,29,35,0.652174,0.347826,10,6
2021021311,2022-04-29,2,ARI,5,4,NSH,16,9,11,5,41,25,20,12,4,61,16,9,11,5,41,25,20,12,4,61,0,1,27,33,0.507937,0.492063,9,11
2021021312,2022-04-29,2,SEA,3,0,SJS,25,14,17,3,59,21,6,7,0,34,25,14,17,3,59,21,6,7,0,34,1,0,31,24,0.583333,0.416667,4,2
2021030111,2022-05-03,3,FLA,2,4,WSH,26,15,10,2,53,25,9,7,3,44,25,15,10,2,52,24,9,7,3,43,0,1,32,38,0.528302,0.471698,10,8
2021030112,2022-05-05,3,FLA,5,1,WSH,27,9,13,5,54,20,8,11,0,39,27,9,12,5,53,19,8,11,0,38,1,0,36,27,0.528571,0.471429,8,20
2021030113,2022-05-07,3,WSH,6,1,FLA,19,6,11,4,40,25,17,8,1,51,19,6,11,4,40,25,17,8,1,51,0,1,31,30,0.45,0.55,8,14
2021030114,2022-05-09,3,WSH,2,3,FLA,10,9,9,1,29,23,13,20,3,59,9,9,9,1,28,19,13,20,2,54,1,0,16,32,0.431373,0.568627,12,14
2021030115,2022-05-11,3,FLA,5,3,WSH,30,11,10,5,56,26,10,8,2,46,29,11,10,5,55,26,10,6,2,44,0,1,38,33,0.521739,0.478261,11,11
2021030116,2022-05-13,3,WSH,3,4,FLA,28,10,16,2,56,25,8,12,4,49,28,10,16,2,56,24,8,12,4,48,1,0,37,31,0.487179,0.512821,6,10
2021030121,2022-05-02,3,TOR,5,0,TBL,20,8,5,3,36,15,7,22,0,44,17,8,5,3,33,15,7,22,0,44,1,0,32,24,0.557692,0.442308,62,51
2021030122,2022-05-04,3,TOR,3,5,TBL,20,10,10,2,42,19,9,6,2,36,20,10,10,2,42,19,9,6,2,36,0,1,34,34,0.551724,0.448276,14,8
2021030123,2022-05-06,3,TBL,2,5,TOR,26,9,16,1,52,18,6,4,4,32,26,9,16,1,52,18,6,4,4,32,0,1,34,36,0.491803,0.508197,10,6
2021030124,2022-05-08,3,TBL,7,3,TOR,16,7,15,6,44,21,8,4,2,35,12,6,14,6,38,19,7,4,1,31,1,0,28,25,0.410714,0.589286,22,30
2021030125,2022-05-10,3,TOR,4,3,TBL,19,15,12,3,49,24,3,6,2,35,18,14,12,1,45,24,3,5,2,34,0,1,25,35,0.618182,0.381818,10,12
2021030126,2022-05-12,3,TBL,4,3,TOR,27,12,20,2,61,26,16,21,3,66,27,12,20,1,60,25,16,20,3,64,1,0,35,33,0.465753,0.534247,4,8
2021030127,2022-05-14,3,TOR,1,2,TBL,23,13,24,1,61,16,3,12,2,33,23,13,24,1,61,16,3,12,2,33,0,1,31,25,0.612903,0.387097,4,6
2021030131,2022-05-02,3,CAR,5,1,BOS,15,16,15,5,51,29,12,15,1,57,15,16,15,5,51,29,12,15,1,57,1,0,25,36,0.569231,0.430769,6,16
2021030132,2022-05-04,3,CAR,5,2,BOS,15,5,8,3,31,25,11,10,1,47,15,5,7,3,30,25,11,10,1,47,1,0,34,38,0.55,0.45,18,28
2021030133,2022-05-06,3,BOS,4,2,CAR,16,11,7,1,35,19,6,16,2,43,16,11,7,1,35,19,6,16,2,43,0,1,28,27,0.566667,0.433333,12,12
2021030134,2022-05-08,3,BOS,5,2,CAR,12,7,4,3,26,20,12,13,2,47,11,7,4,3,25,17,11,13,2,43,0,1,28,26,0.461538,0.538462,10,18
2021030135,2022-05-10,3,CAR,5,1,BOS,22,12,17,3,54,28,10,18,1,57,22,12,17,3,54,28,10,18,1,57,1,0,38,34,0.457143,0.542857,6,10
2021030136,2022-05-12,3,BOS,5,2,CAR,21,10,16,4,51,20,9,6,1,36,21,10,16,4,51,20,9,6,1,36,1,0,34,25,0.481481,0.518519,12,6
2021030137,2022-05-14,3,CAR,3,2,BOS,22,14,13,3,52,27,14,12,2,55,21,14,12,3,50,24,13,12,2,51,1,0,31,29,0.515625,0.484375,6,10
2021030141,2022-05-03,3,NYR,3,4,PIT,63,9,21,1,94,69,28,25,3,125,63,9,21,1,94,69,28,25,3,125,1,0,68,83,0.470588,0.529412,8,2
2021030142,2022-05-05,3,NYR,5,2,PIT,25,15,9,4,53,36,18,7,2,63,22,15,9,4,50,36,17,6,2,61,1,0,40,41,0.465517,0.534483,8,12
2021030143,2022-05-07,3,PIT,7,4,NYR,28,15,8,5,56,26,14,11,3,54,28,15,8,5,56,26,14,11,3,54,1,0,37,36,0.589286,0.410714,6,6
2021030144,2022-05-09,3,PIT,7,2,NYR,30,9,7,6,52,20,8,17,2,47,30,9,7,6,52,20,8,17,2,47,0,1,41,24,0.604167,0.395833,2,6
2021030145,2022-05-11,3,NYR,5,3,PIT,25,9,17,4,55,24,13,10,3,50,25,9,17,4,55,24,13,10,3,50,0,1,34,32,0.327586,0.672414,8,8
2021030146,2022-05-13,3,PIT,3,5,NYR,26,13,15,3,57,27,9,9,3,48,25,12,15,3,55,26,8,8,3,45,1,0,34,38,0.581818,0.418182,8,8
2021030147,2022-05-15,3,NYR,4,3,PIT,20,14,13,3,50,30,9,11,0,50,20,14,12,3,49,30,7,11,0,48,1,0,30,42,0.491525,0.508475,12,10
2021030151,2022-05-03,3,COL,7,2,NSH,31,11,19,4,65,21,6,10,1,38,29,10,19,4,62,21,5,10,1,37,1,0,45,25,0.583333,0.416667,22,34
2021030152,2022-05-05,3,COL,2,1,NSH,39,15,28,2,84,21,5,9,1,36,39,15,28,2,84,21,5,9,1,36,1,0,51,26,0.441176,0.558824,8,8
2021030153,2022-05-07,3,NSH,3,7,COL,24,9,19,1,53,29,10,17,3,59,24,9,19,1,53,29,10,17,3,59,0,1,30,42,0.482759,0.517241,10,6
2021030154,2022-05-09,3,NSH,3,5,COL,27,5,17,3,52,27,7,14,4,52,27,5,17,3,52,27,7,14,4,52,0,1,31,38,0.530303,0.469697,4,4
2021030161,2022-05-02,3,MIN,0,4,STL,25,12,12,0,49,15,1,4,2,22,23,9,12,0,44,14,0,3,2,19,0,1,37,31,0.520833,0.479167,28,18
2021030162,2022-05-04,3,MIN,6,2,STL,17,5,8,4,34,23,10,17,1,51,14,3,7,3,27,21,10,14,1,46,1,0,28,34,0.491803,0.508197,16,12
2021030163,2022-05-06,3,STL,1,5,MIN,25,11,16,0,52,24,11,11,5,51,24,11,16,0,51,24,11,11,5,51,0,1,30,33,0.491525,0.508475,8,6
2021030164,2022-05-08,3,STL,5,2,MIN,18,7,12,4,41,23,15,9,2,49,18,7,12,4,41,23,15,9,2,49,1,0,34,30,0.57377,0.42623,10,10
2021030165,2022-05-10,3,MIN,2,5,STL,30,16,19,0,65,22,11,17,4,54,30,16,19,0,65,22,11,17,4,54,0,1,32,32,0.5,0.5,4,4
2021030166,2022-05-12,3,STL,5,1,MIN,12,6,4,3,25,17,10,11,1,39,12,6,4,3,25,17,10,11,1,39,1,0,27,26,0.54386,0.45614,10,12
2021030171,2022-05-03,3,CGY,1,0,DAL,19,9,10,0,38,10,11,7,0,28,19,9,10,0,38,10,11,7,0,28,1,0,26,16,0.56,0.44,30,30
2021030172,2022-05-05,3,CGY,0,2,DAL,24,13,17,0,54,19,6,4,2,31,16,13,14,0,43,13,4,4,2,23,0,1,29,23,0.42623,0.57377,12,14
2021030173,2022-05-07,3,DAL,4,2,CGY,21,6,23,3,53,24,16,16,2,58,20,6,20,2,48,20,15,13,2,50,1,0,32,41,0.52459,0.47541,19,19
2021030174,2022-05-09,3,DAL,1,4,CGY,26,9,6,0,41,41,14,21,3,79,25,9,6,0,40,40,14,20,2,76,0,1,35,54,0.4375,0.5625,12,14
2021030175,2022-05-11,3,CGY,3,1,DAL,24,16,12,3,55,17,14,3,1,35,24,16,12,3,55,17,14,3,1,35,0,1,32,21,0.433962,0.566038,6,4
2021030176,2022-05-13,3,DAL,4,2,CGY,34,10,14,4,62,33,11,20,2,66,34,10,14,4,62,33,11,20,2,66,1,0,40,38,0.676923,0.323077,16,28
2021030177,2022-05-15,3,CGY,3,2,DAL,56,33,29,3,121,24,16,13,2,55,55,33,28,3,119,24,16,13,2,55,0,1,67,28,0.545455,0.454545,2,6
2021030181,2022-05-02,3,EDM,3,4,LAK,23,9,16,1,49,21,11,15,4,51,23,7,16,1,47,19,10,15,4,48,0,1,39,35,0.492308,0.507692,10,10
2021030182,2022-05-04,3,EDM,6,0,LAK,26,15,14,3,58,22,8,7,0,37,26,15,14,3,58,22,8,7,0,37,1,0,36,30,0.555556,0.444444,10,10
2021030183,2022-05-06,3,LAK,2,8,EDM,34,14,18,1,67,29,16,15,7,67,31,13,17,1,62,28,16,15,6,65,0,1,46,37,0.484375,0.515625,20,12
2021030184,2022-05-08,3,LAK,4,0,EDM,36,13,10,4,63,27,17,16,0,60,33,12,9,3,57,27,16,13,0,56,1,0,46,31,0.559322,0.440678,42,42
2021030185,2022-05-10,3,EDM,4,5,LAK,21,8,28,1,58,26,10,13,4,53,21,8,28,1,58,26,10,13,4,53,0,1,28,43,0.530303,0.469697,14,10
2021030186,2022-05-12,3,LAK,2,4,EDM,23,15,12,1,51,31,13,13,4,61,23,15,12,1,51,31,13,13,4,61,0,1,32,37,0.459459,0.540541,2,8
2021030187,2022-05-14,3,EDM,2,0,LAK,35,16,21,2,74,29,9,26,0,64,35,16,21,2,74,29,9,26,0,64,1,0,41,29,0.460317,0.539683,0,2
2021030211,2022-05-17,3,FLA,1,4,TBL,25,16,8,1,50,20,2,9,1,32,23,15,8,1,47,20,2,9,1,32,1,0,34,36,0.508475,0.491525,14,8
2021030212,2022-05-19,3,FLA,1,2,TBL,27,13,20,1,61,19,10,12,1,42,27,13,20,1,61,19,10,12,1,42,0,1,36,28,0.568182,0.431818,6,8
2021030213,2022-05-22,3,TBL,5,1,FLA,26,11,9,5,51,29,14,14,0,57,26,11,9,5,51,29,14,14,0,57,1,0,36,35,0.446429,0.553571,6,4
2021030214,2022-05-23,3,TBL,2,0,FLA,17,10,8,2,37,36,13,15,0,64,17,10,8,2,37,36,13,15,0,64,1,0,26,49,0.581818,0.418182,6,8
2021030221,2022-05-18,3,CAR,2,1,NYR,24,21,18,2,65,27,14,13,1,55,24,20,17,2,63,26,14,12,1,53,0,1,26,28,0.591837,0.408163,2,2
2021030222,2022-05-20,3,CAR,2,0,NYR,14,12,12,1,39,19,13,21,0,53,14,12,12,1,39,17,10,19,0,46,1,0,22,21,0.564516,0.435484,12,10
2021030223,2022-05-22,3,NYR,3,1,CAR,27,10,8,2,47,36,13,13,1,63,27,10,8,2,47,36,13,13,1,63,1,0,33,44,0.412698,0.587302,6,6
2021030224,2022-05-24,3,NYR,4,1,CAR,16,5,8,3,32,24,8,13,1,46,16,5,8,3,32,24,8,13,1,46,1,0,28,31,0.352941,0.647059,13,27
2021030225,2022-05-26,3,CAR,3,1,NYR,26,12,19,1,58,16,14,19,0,49,26,12,19,1,58,16,14,19,0,49,1,0,34,17,0.553571,0.446429,4,4
2021030226,2022-05-28,3,NYR,5,2,CAR,20,12,11,3,46,30,6,19,2,57,17,11,11,3,42,30,6,18,2,56,1,0,25,39,0.392857,0.607143,12,14
2021030227,2022-05-30,3,CAR,2,6,NYR,32,14,21,1,68,23,5,7,4,39,32,14,21,1,68,23,5,7,4,39,0,1,39,31,0.666667,0.333333,6,8
2021030231,2022-05-17,3,COL,3,2,STL,46,24,25,3,98,22,7,11,1,41,46,24,25,3,98,22,7,11,1,41,0,1,54,25,0.641509,0.358491,2,6
2021030232,2022-05-19,3,COL,1,4,STL,28,9,14,0,51,25,9,4,3,41,28,9,14,0,51,25,9,4,3,41,0,1,31,32,0.393443,0.606557,4,4
2021030233,2022-05-21,3,STL,2,5,COL,26,9,11,2,48,20,11,9,5,45,25,8,10,2,45,20,10,8,5,43,1,0,31,27,0.555556,0.444444,4,6
2021030234,2022-05-23,3,STL,3,6,COL,14,8,10,1,33,29,13,15,6,63,14,8,10,1,33,29,13,15,6,63,1,0,20,37,0.553571,0.446429,6,8
2021030235,2022-05-25,3,COL,4,5,STL,24,10,12,3,49,20,5,20,5,50,24,10,12,3,49,20,5,20,5,50,1,0,34,30,0.483871,0.516129,6,6
2021030236,2022-05-27,3,STL,2,3,COL,16,10,6,2,34,33,15,11,2,61,16,10,6,2,34,33,15,11,2,61,1,0,20,39,0.461538,0.538462,4,4
2021030241,2022-05-18,3,CGY,9,6,EDM,28,13,12,8,61,15,7,8,6,36,28,13,12,8,61,15,7,8,6,36,1,0,48,28,0.472973,0.527027,16,12
2021030242,2022-05-20,3,CGY,3,5,EDM,30,13,13,2,58,22,8,8,3,41,27,12,13,2,54,20,7,8,2,37,1,0,40,40,0.666667,0.333333,22,22
2021030243,2022-05-22,3,EDM,4,1,CGY,24,11,6,4,45,24,8,14,1,47,22,10,6,4,42,24,8,14,1,47,1,0,41,33,0.45098,0.54902,16,27
2021030244,2022-05-24,3,EDM,5,3,CGY,17,4,9,3,33,22,18,19,1,60,17,4,9,3,33,22,18,19,1,60,1,0,26,32,0.431373,0.568627,6,8
2021030245,2022-05-26,3,CGY,4,5,EDM,28,14,16,4,62,29,17,13,4,63,28,14,16,4,62,29,17,13,4,63,1,0,36,35,0.666667,0.333333,2,4
2021030311,2022-06-01,3,NYR,6,2,TBL,22,8,13,5,48,29,10,12,2,53,22,8,13,5,48,29,10,12,2,53,1,0,34,39,0.6,0.4,16,14
2021030312,2022-06-03,3,NYR,3,2,TBL,16,8,9,3,36,28,7,17,1,53,16,8,9,3,36,28,7,17,1,53,0,1,28,31,0.416667,0.583333,2,8
2021030313,2022-06-05,3,TBL,3,2,NYR,39,13,14,1,67,21,9,7,0,37,36,13,13,1,63,21,8,7,0,36,0,1,52,30,0.490909,0.509091,12,12
2021030314,2022-06-07,3,TBL,4,1,NYR,21,16,10,4,51,30,8,17,0,55,21,16,10,4,51,29,8,16,0,53,1,0,31,35,0.517241,0.482759,11,13
2021030315,2022-06-09,3,NYR,1,3,TBL,22,7,14,1,44,17,10,16,3,46,22,7,14,1,44,17,10,16,3,46,1,0,25,27,0.442308,0.557692,13,9
2021030316,2022-06-11,3,TBL,2,1,NYR,28,14,17,2,61,19,5,13,0,37,28,14,17,2,61,18,5,13,0,36,1,0,31,21,0.423077,0.576923,6,4
2021030321,2022-05-31,3,COL,8,6,EDM,37,16,13,7,73,26,12,20,5,63,37,16,13,7,73,26,12,20,5,63,0,1,47,37,0.462687,0.537313,4,4
2021030322,2022-06-02,3,COL,4,0,EDM,28,10,11,3,52,22,8,11,0,41,25,10,11,3,49,22,8,11,0,41,1,0,40,24,0.451613,0.548387,6,16
2021030323,2022-06-04,3,EDM,2,4,COL,22,12,13,2,49,22,2,3,4,31,22,12,13,2,49,22,2,3,4,31,1,0,29,43,0.419355,0.580645,23,4
2021030324,2022-06-06,3,EDM,5,6,COL,24,12,14,4,54,31,10,10,4,55,24,12,14,4,54,31,10,10,4,55,0,1,35,42,0.59375,0.40625,4,10
2021030411,2022-06-15,3,COL,4,3,TBL,29,14,17,3,63,17,9,23,3,52,29,14,17,3,63,16,9,23,3,51,1,0,38,23,0.4,0.6,8,8
2021030412,2022-06-18,3,COL,7,0,TBL,17,7,14,4,42,7,3,9,0,19,16,7,14,4,41,6,2,9,0,17,1,0,30,16,0.482759,0.517241,26,28
2021030413,2022-06-20,3,TBL,6,2,COL,14,9,9,5,37,30,8,27,0,65,12,8,9,5,34,22,8,26,0,56,0,1,33,39,0.581081,0.418919,27,31
2021030414,2022-06-22,3,TBL,2,3,COL,32,7,19,2,60,27,15,29,2,73,32,7,19,2,60,27,15,29,2,73,1,0,39,37,0.5,0.5,4,4
2021030415,2022-06-24,3,COL,2,3,TBL,31,6,13,2,52,20,12,11,2,45,31,6,13,2,52,20,12,11,2,45,0,1,37,29,0.459459,0.540541,10,6
2021030416,2022-06-26,3,TBL,1,2,COL,21,8,18,1,48,26,15,18,2,61,21,8,18,1,48,26,15,18,2,61,1,0,23,30,0.528302,0.471698,2,2
