gameId,gameDate,gameType,Team Home,Score Home,Score Away,Team Away,Shot Home EV,Miss Home EV,Block Home EV,Goal Home EV,CF EV,Shot Away EV,Miss Away EV,Block Away EV,Goal Away EV,CA EV,Shot Home 5v5,Miss Home 5v5,Block Home 5v5,Goal Home 5V5,CF 5v5,Shot Away 5v5,Miss Away 5v5,Block Away 5v5,Goal Away 5v5,CA 5v5,First Goal Home,First Goal Away,SOG Home,SOG Away,Faceoff Home,Faceoff Away,Pim Home,Pim Away
2019020001,2019-10-02,2,TOR,5.0,3.0,OTT,28,13,14,4,59,21,11,8,3,43,28,13,14,4,59,21,11,8,3,43,0,1,42,26,0.424658,0.575342,6,10
2019020002,2019-10-02,2,STL,2.0,3.0,WSH,16,6,5,1,28,26,9,7,2,44,16,6,5,1,28,23,9,7,1,40,1,0,22,34,0.508197,0.491803,6,4
2019020003,2019-10-02,2,EDM,3.0,2.0,VAN,16,5,11,3,35,24,16,17,2,59,16,5,11,3,35,24,16,17,2,59,1,0,22,33,0.489796,0.510204,8,4
2019020004,2019-10-02,2,VGK,4.0,1.0,S.J,24,14,10,2,50,15,8,10,1,34,21,14,7,2,44,15,8,9,1,33,1,0,35,22,0.528302,0.471698,10,8
2019020005,2019-10-03,2,T.B,5.0,2.0,FLA,18,5,15,4,42,28,7,10,1,46,17,5,12,4,38,28,7,10,1,46,1,0,30,37,0.610169,0.389831,8,6
2019020006,2019-10-03,2,NYR,6.0,4.0,WPG,22,6,10,4,42,32,13,13,3,61,22,6,10,4,42,32,13,13,3,61,1,0,32,47,0.466667,0.533333,10,4
2019020007,2019-10-03,2,PIT,1.0,3.0,BUF,21,9,14,0,44,30,5,17,2,54,21,9,14,0,44,30,5,17,2,54,0,1,29,41,0.492063,0.507937,4,10
2019020008,2019-10-03,2,CAR,4.0,3.0,MTL,36,15,13,3,67,32,14,11,2,59,33,14,11,2,60,26,12,11,2,51,1,0,43,36,0.508197,0.491803,6,6
2019020009,2019-10-03,2,NSH,5.0,2.0,MIN,20,17,15,5,57,21,8,10,1,40,20,17,15,5,57,21,8,10,1,40,1,0,32,24,0.576923,0.423077,6,4
2019020010,2019-10-03,2,DAL,1.0,2.0,BOS,21,9,13,1,44,16,9,14,1,40,21,9,13,1,44,16,8,13,1,38,0,1,29,20,0.526316,0.473684,8,4
2019020011,2019-10-03,2,COL,5.0,3.0,CGY,21,8,12,3,44,23,12,15,1,51,21,8,12,3,44,23,12,15,1,51,1,0,32,30,0.457143,0.542857,15,29
2019020012,2019-10-03,2,ANA,2.0,1.0,ARI,27,20,13,2,62,31,16,20,1,68,27,20,13,2,62,31,16,20,1,68,1,0,29,33,0.510204,0.489796,2,2
2019020013,2019-10-04,2,N.J,4.0,5.0,WPG,29,14,5,5,53,28,10,7,6,51,25,10,5,4,44,23,9,6,4,42,1,0,39,30,0.509091,0.490909,4,4
2019020014,2019-10-04,2,NYI,1.0,2.0,WSH,21,8,9,1,39,25,11,17,1,54,21,8,9,1,39,25,11,17,1,54,0,1,26,28,0.48,0.52,4,2
2019020015,2019-10-04,2,CBJ,1.0,4.0,TOR,24,8,11,0,43,22,5,17,2,46,23,8,10,0,41,18,5,16,1,40,0,1,29,29,0.413793,0.586207,12,12
2019020016,2019-10-04,2,PHI,4.0,3.0,CHI,32,14,10,3,59,27,3,14,2,46,30,14,10,2,56,27,3,14,2,46,1,0,38,31,0.62069,0.37931,4,6
2019020017,2019-10-04,2,S.J,1.0,5.0,VGK,23,10,5,1,39,18,5,14,3,40,22,10,5,1,38,18,5,14,3,40,0,1,35,29,0.631579,0.368421,36,40
2019020018,2019-10-05,2,BUF,7.0,2.0,N.J,23,10,9,4,46,13,8,9,2,32,23,10,9,4,46,13,8,9,2,32,1,0,36,20,0.489796,0.510204,16,20
2019020019,2019-10-05,2,TOR,5.0,6.0,MTL,25,12,13,4,54,36,15,14,5,70,19,11,10,4,44,27,14,13,4,58,0,1,37,42,0.541667,0.458333,6,10
2019020020,2019-10-05,2,OTT,1.0,4.0,NYR,24,10,18,1,53,21,10,17,1,49,24,10,18,1,53,21,10,17,1,49,0,1,32,30,0.333333,0.666667,6,10
2019020021,2019-10-05,2,FLA,4.0,3.0,T.B,21,10,3,2,36,29,4,13,3,49,20,10,3,2,35,29,4,13,2,48,1,0,28,35,0.448276,0.551724,4,8
2019020022,2019-10-05,2,PIT,7.0,2.0,CBJ,27,12,13,6,58,22,9,8,2,41,27,12,13,6,58,22,9,8,2,41,1,0,40,30,0.509804,0.490196,7,13
2019020023,2019-10-05,2,WSH,2.0,3.0,CAR,24,15,11,2,52,17,9,6,2,34,18,14,11,2,45,16,8,6,1,31,1,0,34,28,0.553846,0.446154,10,14
2019020024,2019-10-05,2,STL,3.0,2.0,DAL,22,13,9,3,47,21,9,10,1,41,22,13,9,3,47,21,9,10,1,41,1,0,30,29,0.507937,0.492063,4,4
2019020025,2019-10-05,2,NSH,3.0,5.0,DET,38,13,18,2,71,16,13,7,5,41,38,13,18,2,71,16,13,7,5,41,0,1,42,28,0.553846,0.446154,4,4
2019020026,2019-10-05,2,COL,4.0,2.0,MIN,21,6,10,3,40,25,6,10,1,42,21,6,10,3,40,25,6,10,1,42,1,0,32,31,0.457627,0.542373,8,12
2019020027,2019-10-05,2,ARI,0.0,1.0,BOS,32,10,13,0,55,22,12,18,1,53,30,10,11,0,51,21,11,17,1,50,0,1,35,26,0.652174,0.347826,6,8
2019020028,2019-10-05,2,CGY,3.0,0.0,VAN,21,10,5,3,39,21,10,15,0,46,21,10,5,3,39,18,10,15,0,43,1,0,30,34,0.46875,0.53125,14,10
2019020029,2019-10-05,2,EDM,6.0,5.0,L.A,19,5,10,4,38,21,7,12,4,44,18,5,10,3,36,20,6,11,4,41,1,0,31,32,0.482759,0.517241,10,12
2019020030,2019-10-05,2,ANA,3.0,1.0,S.J,21,15,8,3,47,23,8,14,1,46,21,15,7,3,46,23,8,14,1,46,1,0,33,36,0.612245,0.387755,13,9
2019020031,2019-10-06,2,CAR,4.0,3.0,T.B,37,19,16,2,74,10,6,8,2,26,36,18,16,1,71,10,6,8,2,26,1,0,44,13,0.569444,0.430556,8,10
2019020032,2019-10-06,2,DET,4.0,3.0,DAL,22,3,6,3,34,16,4,5,3,28,22,3,6,3,34,16,4,5,3,28,0,1,33,22,0.489362,0.510638,4,16
2019020033,2019-10-06,2,NYI,4.0,1.0,WPG,24,10,7,3,44,33,9,19,1,62,24,10,7,3,44,33,9,19,1,62,1,0,33,36,0.5,0.5,4,2
2019020034,2019-10-07,2,TOR,2.0,3.0,STL,28,22,18,2,70,21,11,7,3,42,28,21,16,2,67,20,10,6,3,39,0,1,34,30,0.5,0.5,8,6
2019020035,2019-10-07,2,CBJ,4.0,3.0,BUF,30,5,12,2,49,14,12,16,1,43,30,5,12,1,48,14,12,14,1,41,1,0,44,18,0.566667,0.433333,8,6
2019020036,2019-10-08,2,FLA,3.0,6.0,CAR,37,4,16,1,58,19,4,8,5,36,36,4,15,1,56,16,3,8,4,31,0,1,50,35,0.545455,0.454545,10,16
2019020037,2019-10-08,2,NYI,2.0,5.0,EDM,24,8,15,1,48,14,11,12,3,40,24,8,15,1,48,14,11,12,3,40,1,0,27,27,0.58,0.42,10,4
2019020038,2019-10-08,2,PIT,1.0,4.0,WPG,32,16,10,1,59,18,5,7,4,34,32,16,10,1,59,18,5,7,4,34,1,0,38,22,0.509804,0.490196,0,4
2019020039,2019-10-08,2,WSH,3.0,4.0,DAL,23,12,10,3,48,17,3,8,4,32,23,12,10,3,48,15,3,7,3,28,1,0,32,26,0.537313,0.462687,8,10
2019020040,2019-10-08,2,DET,1.0,3.0,ANA,27,10,6,1,44,20,5,10,3,38,27,10,6,1,44,20,5,10,3,38,1,0,32,29,0.4,0.6,6,4
2019020041,2019-10-08,2,NSH,5.0,2.0,S.J,15,13,5,4,37,31,12,14,1,58,14,13,4,4,35,30,12,14,1,57,1,0,25,35,0.507692,0.492308,11,15
2019020042,2019-10-08,2,CGY,3.0,4.0,L.A,24,10,16,3,53,33,8,10,3,54,24,10,16,3,53,33,8,10,3,54,0,1,29,40,0.47541,0.52459,9,9
2019020043,2019-10-08,2,VGK,3.0,4.0,BOS,26,11,10,1,48,27,12,12,3,54,26,11,10,1,48,27,12,12,3,54,1,0,34,35,0.4375,0.5625,6,6
2019020044,2019-10-09,2,BUF,5.0,4.0,MTL,22,8,9,3,42,15,10,11,2,38,22,8,8,2,40,15,10,11,2,38,1,0,39,27,0.467742,0.532258,6,10
2019020045,2019-10-09,2,PHI,4.0,0.0,N.J,22,11,13,2,48,19,6,8,0,33,22,11,13,2,48,19,6,8,0,33,1,0,34,25,0.585714,0.414286,10,8
2019020046,2019-10-09,2,VAN,8.0,2.0,L.A,14,13,15,7,49,27,12,14,2,55,14,13,15,7,49,27,12,14,2,55,1,0,25,39,0.390625,0.609375,8,4
2019020047,2019-10-10,2,TOR,3.0,7.0,T.B,22,11,18,2,53,21,10,11,5,47,22,11,18,2,53,21,10,11,5,47,0,1,28,33,0.555556,0.444444,6,4
2019020048,2019-10-10,2,MTL,2.0,4.0,DET,24,6,20,1,51,25,15,12,3,55,24,6,20,1,51,25,15,12,3,55,0,1,35,34,0.471429,0.528571,4,6
2019020049,2019-10-10,2,N.J,3.0,4.0,EDM,27,10,13,3,53,16,6,10,2,34,23,7,11,3,44,13,5,10,1,29,1,0,31,22,0.528302,0.471698,6,4
2019020050,2019-10-10,2,PIT,2.0,1.0,ANA,19,11,10,1,41,26,5,10,1,42,19,11,10,1,41,26,5,10,1,42,1,0,28,32,0.545455,0.454545,21,17
2019020051,2019-10-10,2,OTT,4.0,6.0,STL,24,15,16,3,58,27,12,10,5,54,24,15,16,3,58,27,12,10,5,54,1,0,29,37,0.553846,0.446154,8,0
2019020052,2019-10-10,2,NSH,6.0,5.0,WSH,28,9,12,5,54,18,8,9,2,37,28,9,12,5,54,18,8,9,2,37,0,1,38,26,0.507042,0.492958,8,8
2019020053,2019-10-10,2,WPG,5.0,2.0,MIN,21,6,7,5,39,32,8,18,2,60,18,6,7,3,34,31,8,18,2,59,0,1,32,40,0.482759,0.517241,6,6
2019020054,2019-10-10,2,CHI,4.0,5.0,S.J,25,6,3,4,38,24,11,18,3,56,25,6,3,4,38,24,11,18,3,56,1,0,30,34,0.563636,0.436364,6,4
2019020055,2019-10-10,2,DAL,2.0,3.0,CGY,28,17,14,2,61,28,7,13,3,51,23,15,13,1,52,21,7,12,1,41,1,0,36,29,0.637931,0.362069,6,10
2019020056,2019-10-10,2,COL,4.0,2.0,BOS,30,10,11,3,54,37,7,10,2,56,30,10,11,3,54,37,7,10,2,56,0,1,36,41,0.42623,0.57377,2,4
2019020057,2019-10-10,2,ARI,4.0,1.0,VGK,22,6,10,4,42,21,6,11,1,39,22,6,10,4,42,21,6,11,1,39,1,0,29,38,0.527273,0.472727,8,4
2019020058,2019-10-11,2,BUF,3.0,2.0,FLA,28,12,9,4,53,37,11,10,2,60,22,10,8,2,42,34,10,10,2,56,1,0,32,43,0.555556,0.444444,4,8
2019020059,2019-10-11,2,CBJ,1.0,2.0,ANA,23,13,14,1,51,19,6,15,1,41,23,13,14,1,51,19,6,15,1,41,0,1,27,23,0.435897,0.564103,2,6
2019020060,2019-10-11,2,CAR,5.0,2.0,NYI,33,12,14,5,64,14,13,16,0,43,33,12,14,5,64,10,12,15,0,37,1,0,40,19,0.485294,0.514706,10,6
2019020061,2019-10-12,2,NYR,1.0,4.0,EDM,13,5,6,1,25,19,20,10,3,52,13,5,6,1,25,19,20,10,3,52,1,0,21,27,0.5,0.5,4,8
2019020062,2019-10-12,2,OTT,4.0,2.0,T.B,22,12,9,4,47,16,9,16,2,43,22,12,9,4,47,16,9,15,2,42,1,0,34,21,0.44,0.56,18,18
2019020063,2019-10-12,2,L.A,7.0,4.0,NSH,26,14,15,7,62,20,12,8,3,43,23,14,15,7,59,20,12,8,3,43,0,1,38,32,0.40678,0.59322,8,4
2019020064,2019-10-12,2,BOS,3.0,0.0,N.J,25,8,10,2,45,25,4,10,0,39,25,8,10,2,45,25,4,10,0,39,1,0,32,31,0.54,0.46,8,6
2019020065,2019-10-12,2,MTL,6.0,3.0,STL,27,11,13,6,57,22,5,6,2,35,26,11,13,6,56,22,5,6,2,35,1,0,38,29,0.434783,0.565217,4,8
2019020066,2019-10-12,2,DET,2.0,5.0,TOR,20,5,11,2,38,32,9,22,5,68,20,5,11,2,38,32,9,22,5,68,1,0,27,41,0.413793,0.586207,6,2
2019020067,2019-10-12,2,NYI,3.0,2.0,FLA,25,10,15,3,53,35,8,18,2,63,20,9,15,2,46,32,7,15,2,56,0,1,28,37,0.466667,0.533333,11,7
2019020068,2019-10-12,2,CAR,2.0,3.0,CBJ,26,6,10,2,44,26,10,10,3,49,26,6,10,2,44,25,9,10,3,47,0,1,32,35,0.539683,0.460317,6,6
2019020069,2019-10-12,2,CHI,2.0,3.0,WPG,24,8,13,0,45,26,5,14,2,47,24,8,13,0,45,26,5,14,1,46,1,0,29,33,0.491228,0.508772,8,4
2019020070,2019-10-12,2,DAL,1.0,4.0,WSH,16,8,11,1,36,14,13,6,2,35,16,8,11,1,36,16,15,6,2,39,0,1,25,25,0.455882,0.544118,10,12
2019020071,2019-10-12,2,MIN,4.0,7.0,PIT,28,6,16,3,53,27,6,9,5,47,27,6,15,3,51,25,6,7,5,43,0,1,33,35,0.507937,0.492063,12,8
2019020072,2019-10-12,2,COL,3.0,2.0,ARI,24,6,9,2,41,26,4,11,2,43,20,5,8,1,34,25,4,11,2,42,1,0,32,36,0.507937,0.492063,6,8
2019020073,2019-10-12,2,VAN,3.0,2.0,PHI,21,12,12,2,47,27,9,17,1,54,17,11,10,2,40,26,8,16,1,51,1,0,24,32,0.557377,0.442623,6,4
2019020074,2019-10-12,2,VGK,6.0,2.0,CGY,19,5,9,6,39,20,8,15,2,45,19,5,9,6,39,20,8,15,2,45,1,0,30,35,0.385965,0.614035,8,6
2019020075,2019-10-13,2,WPG,2.0,7.0,PIT,22,8,14,1,45,15,4,13,5,37,22,8,13,1,44,14,4,13,5,36,1,0,29,28,0.46875,0.53125,4,12
2019020076,2019-10-13,2,L.A,2.0,5.0,VGK,30,14,9,2,55,23,18,8,2,51,30,14,9,2,55,23,18,8,2,51,0,1,38,36,0.384615,0.615385,6,6
2019020077,2019-10-13,2,S.J,3.0,1.0,CGY,16,11,10,2,39,29,7,14,1,51,15,11,10,2,38,29,6,14,1,50,1,0,20,33,0.540984,0.459016,8,4
2019020078,2019-10-14,2,BOS,4.0,2.0,ANA,18,12,7,2,39,22,10,12,2,46,18,12,7,2,39,22,10,12,2,46,1,0,23,32,0.5,0.5,10,8
2019020079,2019-10-14,2,OTT,0.0,2.0,MIN,18,10,11,0,39,23,5,12,2,42,16,10,11,0,37,23,5,12,2,42,0,1,26,35,0.492537,0.507463,14,12
2019020080,2019-10-14,2,N.J,4.0,6.0,FLA,13,3,9,4,29,23,11,8,5,47,13,3,9,4,29,23,11,7,5,46,0,1,21,34,0.519231,0.480769,10,6
2019020081,2019-10-14,2,NYI,3.0,2.0,STL,23,4,22,3,52,19,7,16,1,43,23,4,21,2,50,19,7,16,1,43,0,1,32,23,0.385965,0.614035,4,2
2019020082,2019-10-14,2,BUF,4.0,0.0,DAL,18,11,8,3,40,24,8,8,0,40,18,11,8,3,40,24,8,8,0,40,1,0,22,25,0.428571,0.571429,4,4
2019020083,2019-10-14,2,WSH,3.0,6.0,COL,25,11,16,3,55,18,10,16,5,49,25,10,15,2,52,17,10,16,5,48,0,1,32,25,0.575758,0.424242,25,11
2019020084,2019-10-14,2,CHI,3.0,1.0,EDM,25,12,14,3,54,26,2,11,0,39,25,12,14,3,54,25,2,11,0,38,1,0,35,28,0.482143,0.517857,8,8
2019020085,2019-10-15,2,TOR,4.0,2.0,MIN,27,11,15,2,55,18,8,8,2,36,27,11,15,2,55,18,8,8,2,36,0,1,34,29,0.54717,0.45283,6,6
2019020086,2019-10-15,2,MTL,1.0,3.0,T.B,28,6,18,0,52,18,10,11,2,41,28,6,18,0,52,18,10,11,2,41,1,0,34,22,0.6,0.4,2,10
2019020087,2019-10-15,2,WPG,2.0,4.0,ARI,26,8,12,0,46,27,5,4,2,38,26,8,12,0,46,27,5,4,2,38,1,0,40,35,0.508772,0.491228,4,12
2019020088,2019-10-15,2,CGY,3.0,1.0,PHI,30,5,10,3,48,15,5,13,1,34,30,5,10,3,48,15,5,13,1,34,1,0,38,22,0.378788,0.621212,8,6
2019020089,2019-10-15,2,VAN,5.0,1.0,DET,22,6,11,2,41,22,10,13,1,46,22,6,11,2,41,22,10,13,1,46,0,1,32,27,0.538462,0.461538,20,24
2019020090,2019-10-15,2,VGK,2.0,5.0,NSH,33,4,16,1,54,21,7,11,4,43,33,4,16,1,54,21,7,11,4,43,0,1,35,39,0.514286,0.485714,20,18
2019020091,2019-10-15,2,L.A,0.0,2.0,CAR,24,14,8,0,46,17,8,18,1,44,24,14,7,0,45,17,8,18,1,44,0,1,31,23,0.421053,0.578947,8,10
2019020092,2019-10-16,2,PIT,3.0,2.0,COL,25,11,8,2,46,26,10,13,2,51,23,11,8,1,43,25,9,13,2,49,0,1,32,28,0.594203,0.405797,6,6
2019020093,2019-10-16,2,WSH,4.0,3.0,TOR,24,12,16,3,55,26,12,23,2,63,24,12,16,3,55,26,12,23,2,63,0,1,32,32,0.473684,0.526316,2,10
2019020094,2019-10-16,2,CBJ,3.0,2.0,DAL,28,6,11,3,48,28,9,13,2,52,28,6,11,3,48,28,9,13,2,52,1,0,35,32,0.465517,0.534483,4,6
2019020095,2019-10-16,2,EDM,6.0,3.0,PHI,12,6,8,4,30,32,9,15,1,57,12,6,8,4,30,32,9,15,1,57,1,0,22,52,0.5,0.5,12,4
2019020096,2019-10-16,2,ANA,5.0,2.0,BUF,20,10,13,4,47,24,14,7,1,46,19,8,13,4,44,23,14,7,1,45,0,1,31,33,0.561404,0.438596,24,18
2019020097,2019-10-16,2,S.J,5.0,2.0,CAR,16,2,10,3,31,28,8,13,2,51,16,2,10,3,31,28,8,13,2,51,1,0,22,38,0.544118,0.455882,8,8
2019020098,2019-10-17,2,BOS,3.0,4.0,T.B,34,9,8,0,51,31,9,10,4,54,26,7,8,0,41,25,7,9,3,44,1,0,37,36,0.460317,0.539683,8,10
2019020099,2019-10-17,2,MTL,4.0,0.0,MIN,22,11,9,3,45,11,10,17,0,38,21,11,9,3,44,10,10,17,0,37,1,0,33,17,0.5,0.5,17,17
2019020100,2019-10-17,2,N.J,5.0,2.0,NYR,19,7,8,4,38,22,12,4,2,40,17,6,8,4,35,21,12,4,2,39,0,1,38,31,0.438596,0.561404,16,18
2019020101,2019-10-17,2,STL,3.0,4.0,VAN,31,9,10,3,53,32,9,5,3,49,24,7,8,3,42,26,7,5,2,40,1,0,37,32,0.465517,0.534483,10,8
2019020102,2019-10-17,2,WPG,1.0,3.0,NYI,27,17,15,0,59,23,11,6,2,42,27,17,15,0,59,23,11,6,2,42,1,0,33,26,0.603175,0.396825,2,4
2019020103,2019-10-17,2,CGY,5.0,1.0,DET,25,10,20,3,58,22,13,8,1,44,23,10,20,3,56,21,13,8,1,43,1,0,36,28,0.519231,0.480769,6,21
2019020104,2019-10-17,2,ARI,5.0,2.0,NSH,22,9,11,2,44,15,12,10,2,39,21,9,11,2,43,14,11,10,2,37,1,0,32,25,0.5,0.5,8,14
2019020105,2019-10-17,2,VGK,3.0,2.0,OTT,38,13,13,4,68,30,7,7,4,48,35,12,12,1,60,23,4,6,2,35,1,0,54,39,0.519481,0.480519,13,11
2019020106,2019-10-17,2,L.A,0.0,3.0,BUF,41,17,22,0,80,16,7,11,2,36,41,17,22,0,80,16,7,11,2,36,0,1,47,24,0.627119,0.372881,6,6
2019020107,2019-10-18,2,FLA,4.0,5.0,COL,33,5,8,3,49,27,10,7,5,49,29,5,8,3,45,25,8,7,4,44,1,0,44,41,0.482143,0.517857,6,8
2019020108,2019-10-18,2,PIT,4.0,2.0,DAL,22,15,7,4,48,22,9,13,2,46,22,15,7,4,48,22,9,13,2,46,0,1,33,24,0.395833,0.604167,2,4
2019020109,2019-10-18,2,WSH,5.0,2.0,NYR,24,8,16,3,51,18,11,6,1,36,23,8,16,3,50,18,11,6,1,36,1,0,34,28,0.490909,0.509091,18,18
2019020110,2019-10-18,2,CHI,3.0,2.0,CBJ,20,7,13,2,42,29,6,13,2,50,19,7,13,1,40,29,6,12,2,49,1,0,33,39,0.489796,0.510204,8,8
2019020111,2019-10-18,2,EDM,2.0,1.0,DET,31,14,14,2,61,23,12,12,1,48,31,14,14,2,61,23,12,12,1,48,1,0,37,26,0.518519,0.481481,2,4
2019020112,2019-10-18,2,ANA,4.0,2.0,CAR,15,5,12,3,35,22,12,6,1,41,15,5,12,3,35,22,12,6,1,41,1,0,20,24,0.5,0.5,11,7
2019020113,2019-10-19,2,N.J,1.0,0.0,VAN,13,4,9,0,26,15,7,17,0,39,10,4,9,0,23,15,6,17,0,38,1,0,24,25,0.338462,0.661538,23,17
2019020114,2019-10-19,2,STL,2.0,5.0,MTL,24,7,9,2,42,13,4,2,3,22,24,7,9,2,42,13,4,2,3,22,0,1,34,25,0.59322,0.40678,10,6
2019020115,2019-10-19,2,TOR,4.0,3.0,BOS,25,13,9,4,51,34,11,14,2,61,23,10,9,3,45,31,11,14,2,58,1,0,29,46,0.530612,0.469388,8,2
2019020116,2019-10-19,2,T.B,2.0,6.0,COL,43,4,13,2,62,17,11,4,6,38,40,4,11,2,57,16,11,4,6,37,0,1,46,24,0.540984,0.459016,18,18
2019020117,2019-10-19,2,PHI,1.0,4.0,DAL,31,7,15,1,54,12,13,8,3,36,30,7,15,1,53,12,13,8,3,36,1,0,39,16,0.631579,0.368421,9,13
2019020118,2019-10-19,2,PIT,0.0,3.0,VGK,24,7,14,0,45,19,4,4,1,28,24,7,14,0,45,19,4,4,0,27,0,1,29,24,0.474576,0.525424,6,8
2019020119,2019-10-19,2,CBJ,2.0,3.0,NYI,31,11,31,2,75,31,11,9,3,54,31,11,31,2,75,30,11,9,2,52,0,1,36,34,0.633333,0.366667,0,2
2019020120,2019-10-19,2,ARI,5.0,2.0,OTT,16,17,21,4,58,28,15,11,0,54,16,16,21,4,57,28,15,11,0,54,1,0,27,36,0.515152,0.484848,4,10
2019020121,2019-10-19,2,NSH,2.0,3.0,FLA,23,18,16,1,58,23,10,10,1,44,19,17,16,1,53,23,9,9,1,42,0,1,27,30,0.574074,0.425926,4,8
2019020122,2019-10-19,2,L.A,4.0,1.0,CGY,21,3,8,2,34,15,12,14,1,42,21,3,8,2,34,13,10,13,0,36,1,0,36,24,0.464286,0.535714,14,30
2019020123,2019-10-19,2,S.J,3.0,4.0,BUF,24,11,10,1,46,22,6,6,4,38,24,11,10,1,46,22,6,6,4,38,0,1,32,35,0.553571,0.446429,8,8
2019020124,2019-10-20,2,NYR,2.0,3.0,VAN,31,8,13,2,54,32,16,12,1,61,31,8,13,2,54,32,16,12,1,61,0,1,40,43,0.325581,0.674419,6,6
2019020125,2019-10-20,2,MIN,4.0,3.0,MTL,24,11,12,2,49,29,16,17,2,64,24,11,12,2,49,29,16,17,2,64,1,0,33,33,0.53125,0.46875,4,10
2019020126,2019-10-20,2,CHI,3.0,5.0,WSH,32,7,25,3,67,24,8,10,3,45,32,7,25,3,67,24,8,10,3,45,0,1,44,30,0.589286,0.410714,4,12
2019020127,2019-10-20,2,WPG,1.0,0.0,EDM,13,12,15,2,42,26,11,9,0,46,10,10,13,0,33,22,8,8,0,38,0,0,23,28,0.510204,0.489796,4,8
2019020128,2019-10-20,2,ANA,1.0,2.0,CGY,25,16,12,1,54,27,14,12,2,55,25,16,12,1,54,27,14,12,2,55,1,0,30,29,0.588235,0.411765,0,6
2019020129,2019-10-21,2,TOR,3.0,4.0,CBJ,20,10,16,2,48,26,7,10,2,45,20,9,14,2,45,23,6,10,1,40,0,1,31,38,0.661538,0.338462,10,4
2019020130,2019-10-21,2,PHI,6.0,2.0,VGK,25,11,11,4,51,24,6,5,1,36,24,11,10,4,49,24,6,5,0,35,1,0,37,35,0.566667,0.433333,10,10
2019020131,2019-10-21,2,STL,3.0,1.0,COL,18,8,10,2,38,10,5,9,0,24,18,8,10,1,37,10,5,9,0,24,1,0,25,18,0.627119,0.372881,12,12
2019020132,2019-10-21,2,DAL,2.0,1.0,OTT,30,7,15,1,53,16,3,10,1,30,30,7,15,1,53,16,3,10,1,30,1,0,43,20,0.5,0.5,4,10
2019020133,2019-10-22,2,BOS,4.0,2.0,TOR,29,6,8,3,46,21,4,7,1,33,29,6,8,3,46,21,4,7,1,33,1,0,39,30,0.603175,0.396825,8,8
2019020134,2019-10-22,2,BUF,4.0,3.0,S.J,17,7,5,3,32,22,8,10,3,43,17,5,5,2,29,22,8,10,3,43,0,1,29,28,0.553571,0.446429,4,8
2019020135,2019-10-22,2,FLA,4.0,2.0,PIT,18,12,9,4,43,21,8,11,2,42,18,12,9,4,43,21,8,11,2,42,1,0,22,25,0.428571,0.571429,2,2
2019020136,2019-10-22,2,NYR,2.0,3.0,ARI,15,10,9,1,35,25,7,17,2,51,15,10,9,1,35,25,7,17,1,50,0,1,19,35,0.52,0.48,10,4
2019020137,2019-10-22,2,DET,2.0,5.0,VAN,19,10,10,0,39,25,5,9,3,42,19,10,9,0,38,23,5,9,3,40,1,0,33,41,0.473684,0.526316,12,16
2019020138,2019-10-22,2,NSH,6.0,1.0,ANA,19,3,7,4,33,21,9,14,1,45,19,3,7,4,33,20,9,14,1,44,1,0,30,27,0.377049,0.622951,6,22
2019020139,2019-10-22,2,MIN,3.0,0.0,EDM,24,10,18,2,54,22,7,7,0,36,22,10,18,2,52,22,7,7,0,36,1,0,30,25,0.510204,0.489796,6,8
2019020140,2019-10-22,2,WPG,2.0,3.0,L.A,16,14,14,2,46,27,10,12,2,51,16,14,14,2,46,27,10,12,2,51,0,1,28,41,0.430769,0.569231,8,10
2019020141,2019-10-22,2,CHI,1.0,2.0,VGK,22,5,5,1,33,26,8,13,1,48,21,4,4,1,30,25,7,12,1,45,1,0,32,34,0.537037,0.462963,10,8
2019020142,2019-10-22,2,CGY,3.0,5.0,WSH,27,11,9,2,49,20,10,8,5,43,27,11,9,2,49,20,10,8,5,43,0,1,35,30,0.508475,0.491525,6,8
2019020143,2019-10-23,2,OTT,5.0,2.0,DET,30,9,9,4,52,28,8,8,2,46,30,9,9,4,52,28,8,8,2,46,1,0,38,36,0.589041,0.410959,10,4
2019020144,2019-10-23,2,T.B,3.0,2.0,PIT,39,8,11,2,60,34,5,9,2,50,39,8,11,2,60,34,5,9,2,50,1,0,48,39,0.453125,0.546875,4,10
2019020145,2019-10-24,2,MTL,2.0,4.0,S.J,28,13,16,2,59,15,8,11,2,36,28,13,16,2,59,15,8,11,2,36,1,0,37,23,0.3875,0.6125,6,6
2019020146,2019-10-24,2,NYI,4.0,2.0,ARI,17,6,13,4,40,19,10,16,2,47,17,6,13,4,40,18,10,16,2,46,1,0,22,23,0.603774,0.396226,6,2
2019020147,2019-10-24,2,NYR,6.0,2.0,BUF,15,8,5,6,34,23,7,22,2,54,14,8,5,5,32,21,7,20,2,50,1,0,24,33,0.409091,0.590909,8,8
2019020148,2019-10-24,2,CBJ,4.0,3.0,CAR,20,6,11,4,41,19,7,18,3,47,17,6,9,3,35,17,6,17,3,43,1,0,31,24,0.6,0.4,8,6
2019020149,2019-10-24,2,STL,5.0,2.0,L.A,25,14,16,2,57,24,5,3,2,34,25,14,16,2,57,24,5,3,2,34,0,1,35,35,0.489362,0.510638,11,13
2019020150,2019-10-24,2,NSH,4.0,0.0,MIN,15,9,14,3,41,23,13,15,0,51,15,9,14,3,41,23,13,15,0,51,1,0,21,26,0.54717,0.45283,4,2
2019020151,2019-10-24,2,CHI,1.0,4.0,PHI,22,10,17,1,50,17,4,10,4,35,22,10,16,1,49,17,4,9,4,34,0,1,24,23,0.347826,0.652174,4,8
2019020152,2019-10-24,2,DAL,2.0,1.0,ANA,20,8,15,2,45,23,13,14,0,50,20,8,15,2,45,23,13,14,0,50,1,0,29,30,0.578125,0.421875,4,4
2019020153,2019-10-24,2,CGY,6.0,5.0,FLA,14,8,14,4,40,17,10,8,5,40,11,8,14,4,37,14,8,8,5,35,1,0,24,23,0.655172,0.344828,9,11
2019020154,2019-10-24,2,EDM,4.0,3.0,WSH,33,8,18,4,63,23,11,13,2,49,30,8,18,3,59,22,9,13,2,46,1,0,40,28,0.492537,0.507463,6,6
2019020155,2019-10-25,2,VGK,1.0,6.0,COL,23,8,11,1,43,31,8,17,4,60,21,8,11,1,41,31,5,14,4,54,0,1,26,40,0.52381,0.47619,8,10
2019020156,2019-10-25,2,TOR,4.0,1.0,S.J,19,12,12,4,47,13,8,9,1,31,19,12,12,4,47,13,8,9,1,31,0,1,27,17,0.513514,0.486486,2,10
2019020157,2019-10-25,2,N.J,3.0,5.0,ARI,21,6,11,2,40,12,7,8,4,31,20,6,11,2,39,12,6,8,4,30,1,0,35,17,0.530303,0.469697,6,10
2019020158,2019-10-25,2,OTT,2.0,4.0,NYI,23,12,11,1,47,16,14,8,3,41,22,12,11,1,46,16,13,8,3,40,1,0,32,24,0.614035,0.385965,25,31
2019020159,2019-10-25,2,DET,0.0,2.0,BUF,34,4,11,0,49,20,3,5,1,29,34,4,11,0,49,20,3,5,1,29,0,1,41,25,0.617021,0.382979,6,6
2019020160,2019-10-25,2,VAN,5.0,6.0,WSH,25,11,15,4,55,24,9,18,6,57,21,10,15,3,49,16,8,15,4,43,0,1,34,29,0.6,0.4,4,10
2019020161,2019-10-26,2,CAR,4.0,0.0,CHI,24,12,8,2,46,30,13,15,0,58,24,12,8,2,46,30,13,14,0,57,1,0,31,32,0.4,0.6,6,4
2019020162,2019-10-26,2,BOS,3.0,0.0,STL,14,8,8,2,32,18,4,7,0,29,14,8,8,2,32,14,4,7,0,25,1,0,24,26,0.403846,0.596154,12,12
2019020163,2019-10-26,2,MTL,5.0,2.0,TOR,28,13,14,4,59,28,7,16,2,53,28,13,14,4,59,28,7,16,2,53,1,0,38,31,0.485294,0.514706,2,4
2019020164,2019-10-26,2,T.B,2.0,3.0,NSH,22,12,12,1,47,28,10,6,1,45,22,11,12,1,46,28,10,6,0,44,0,1,30,40,0.539683,0.460317,10,8
2019020165,2019-10-26,2,PHI,7.0,4.0,CBJ,31,9,15,4,59,20,4,6,4,34,28,9,14,3,54,19,4,6,4,33,1,0,46,26,0.645161,0.354839,12,10
2019020166,2019-10-26,2,DAL,0.0,3.0,PIT,23,8,21,0,52,24,14,17,3,58,23,8,21,0,52,24,14,17,3,58,0,1,25,27,0.555556,0.444444,0,4
2019020167,2019-10-26,2,MIN,5.0,1.0,L.A,18,8,8,5,39,22,11,15,1,49,18,8,8,5,39,22,11,15,1,49,1,0,27,31,0.372549,0.627451,6,6
2019020168,2019-10-26,2,WPG,2.0,1.0,CGY,36,11,15,1,63,24,12,14,0,50,34,10,15,0,59,24,12,13,0,49,0,1,45,30,0.642857,0.357143,6,10
2019020169,2019-10-26,2,COL,2.0,5.0,ANA,23,5,13,0,41,19,3,9,4,35,23,5,13,0,41,19,2,9,4,34,0,1,37,27,0.541667,0.458333,6,12
2019020170,2019-10-27,2,EDM,2.0,6.0,FLA,12,9,11,0,32,17,3,8,4,32,19,14,14,1,48,21,7,12,6,46,0,1,26,29,0.462963,0.537037,2,6
2019020171,2019-10-27,2,DET,4.0,5.0,STL,28,12,15,3,58,9,9,6,3,27,27,12,15,3,57,9,9,6,2,26,0,1,33,20,0.422222,0.577778,8,6
2019020172,2019-10-27,2,OTT,5.0,2.0,S.J,17,11,11,5,44,20,10,21,1,52,17,11,11,5,44,19,10,21,1,51,1,0,30,36,0.571429,0.428571,12,8
2019020173,2019-10-27,2,NYI,5.0,3.0,PHI,25,9,7,5,46,21,12,18,3,54,25,8,7,5,45,21,12,18,3,54,0,1,33,31,0.454545,0.545455,13,11
2019020174,2019-10-27,2,NYR,4.0,7.0,BOS,16,10,9,3,38,30,10,14,7,61,16,10,9,3,38,27,9,14,7,57,1,0,29,43,0.485294,0.514706,6,12
2019020175,2019-10-27,2,CHI,5.0,1.0,L.A,18,10,8,5,41,31,3,14,1,49,17,8,7,5,37,31,3,14,1,49,1,0,26,39,0.491228,0.508772,8,6
2019020176,2019-10-27,2,VGK,5.0,2.0,ANA,38,23,17,3,81,13,8,9,2,32,38,23,17,3,81,13,8,9,2,32,0,1,49,15,0.483333,0.516667,2,8
2019020177,2019-10-28,2,BUF,2.0,3.0,ARI,25,17,6,1,49,38,13,7,2,60,23,12,6,1,42,36,12,7,1,56,1,0,26,44,0.54902,0.45098,4,4
2019020178,2019-10-28,2,VAN,7.0,2.0,FLA,24,7,13,7,51,25,5,14,1,45,24,7,13,7,51,25,5,14,1,45,1,0,36,31,0.537037,0.462963,4,4
2019020179,2019-10-29,2,BOS,5.0,1.0,S.J,19,8,9,3,39,9,6,5,0,20,17,8,8,3,36,9,4,5,0,18,1,0,41,17,0.5,0.5,47,57
2019020180,2019-10-29,2,TOR,3.0,4.0,WSH,16,12,5,2,35,19,9,6,2,36,16,12,5,2,35,18,9,6,2,35,1,0,31,33,0.6,0.4,16,18
2019020181,2019-10-29,2,NYR,4.0,1.0,T.B,31,7,8,3,49,22,15,14,1,52,31,7,8,3,49,22,15,14,1,52,0,1,42,30,0.462687,0.537313,9,13
2019020182,2019-10-29,2,PIT,7.0,1.0,PHI,30,5,6,7,48,22,7,10,1,40,29,5,5,7,46,21,7,10,1,39,1,0,37,30,0.459016,0.540984,10,8
2019020183,2019-10-29,2,CAR,2.0,1.0,CGY,24,16,15,1,56,23,10,5,1,39,23,16,14,1,54,23,8,5,1,37,0,1,28,29,0.533333,0.466667,6,6
2019020184,2019-10-29,2,DET,3.0,1.0,EDM,20,7,8,2,37,26,4,8,1,39,20,7,8,2,37,26,4,8,1,39,1,0,28,32,0.589286,0.410714,8,8
2019020185,2019-10-29,2,NSH,3.0,0.0,CHI,39,11,18,3,71,19,10,7,0,36,38,11,18,3,70,19,10,7,0,36,1,0,51,20,0.525424,0.474576,6,10
2019020186,2019-10-29,2,DAL,6.0,3.0,MIN,23,12,8,5,48,15,9,13,1,38,19,11,6,5,41,15,9,13,1,38,0,1,37,22,0.616667,0.383333,10,10
2019020187,2019-10-29,2,ANA,7.0,4.0,WPG,18,10,6,7,41,32,15,17,4,68,18,10,6,7,41,32,15,17,4,68,0,1,28,40,0.482759,0.517241,4,2
2019020188,2019-10-30,2,N.J,6.0,7.0,T.B,27,11,8,5,51,15,8,11,6,40,27,11,7,5,50,14,8,11,5,38,1,0,42,23,0.592593,0.407407,2,10
2019020189,2019-10-30,2,CBJ,1.0,4.0,EDM,18,7,8,0,33,20,9,15,3,47,18,7,8,0,33,20,9,15,3,47,0,1,24,31,0.607843,0.392157,10,6
2019020190,2019-10-30,2,STL,2.0,1.0,MIN,16,6,8,2,32,30,7,10,1,48,16,6,8,2,32,30,7,10,1,48,1,0,26,36,0.581818,0.418182,6,6
2019020191,2019-10-30,2,COL,3.0,4.0,FLA,24,10,7,3,44,29,8,7,3,47,24,10,7,3,44,29,8,7,2,46,1,0,30,38,0.5,0.5,25,21
2019020192,2019-10-30,2,ARI,1.0,4.0,MTL,27,10,18,1,56,27,14,10,4,55,27,10,18,1,56,27,14,10,4,55,0,1,33,36,0.477612,0.522388,4,6
2019020193,2019-10-30,2,L.A,3.0,5.0,VAN,17,6,12,2,37,33,6,10,1,50,17,6,12,2,37,33,6,10,1,50,1,0,24,49,0.348485,0.651515,17,17
2019020194,2019-10-31,2,NSH,5.0,6.0,CGY,29,7,5,3,44,20,11,16,6,53,27,7,4,3,41,17,11,15,5,48,1,0,36,27,0.516129,0.483871,6,6
2019020195,2019-10-31,2,VGK,4.0,5.0,MTL,26,16,10,4,56,22,16,11,5,54,26,16,10,4,56,22,16,11,4,53,0,1,35,29,0.5,0.5,6,2
2019020196,2019-11-01,2,N.J,3.0,4.0,PHI,21,8,10,1,40,24,9,8,4,45,18,5,9,1,33,19,7,8,3,37,1,0,26,31,0.575,0.425,21,13
2019020197,2019-11-01,2,NYI,5.0,2.0,T.B,15,6,11,5,37,25,5,16,2,48,15,6,11,5,37,25,5,16,2,48,1,0,26,35,0.413043,0.586957,11,11
2019020198,2019-11-01,2,WSH,6.0,1.0,BUF,23,13,10,6,52,28,5,13,1,47,23,13,10,6,52,28,5,13,1,47,1,0,34,30,0.56338,0.43662,4,2
2019020199,2019-11-01,2,CAR,7.0,3.0,DET,18,10,8,5,41,26,13,10,2,51,16,10,8,4,38,25,12,10,2,49,1,0,34,32,0.510204,0.489796,12,8
2019020200,2019-11-01,2,STL,4.0,3.0,CBJ,21,9,13,2,45,24,9,5,2,40,21,9,13,2,45,24,9,5,2,40,1,0,27,30,0.45614,0.54386,6,8
2019020201,2019-11-01,2,COL,1.0,2.0,DAL,29,7,20,0,56,20,6,17,1,44,28,7,20,0,55,20,6,17,1,44,0,1,39,29,0.514706,0.485294,6,12
2019020202,2019-11-01,2,ANA,2.0,1.0,VAN,18,7,8,1,34,33,16,8,1,58,16,6,8,0,30,28,13,8,1,50,1,0,29,40,0.519231,0.480769,12,10
2019020203,2019-11-01,2,S.J,2.0,3.0,WPG,37,10,11,2,60,10,2,9,3,24,37,10,11,2,60,10,2,9,3,24,0,1,53,19,0.559322,0.440678,4,4
2019020204,2019-11-02,2,PIT,1.0,2.0,EDM,39,11,15,0,65,19,7,7,2,35,38,9,14,0,61,12,7,6,1,26,0,1,52,28,0.484375,0.515625,4,10
2019020205,2019-11-02,2,NSH,1.0,2.0,NYR,25,12,13,0,50,20,10,8,2,40,25,12,13,0,50,20,10,8,2,40,0,1,33,30,0.428571,0.571429,13,15
2019020206,2019-11-02,2,BOS,5.0,2.0,OTT,21,8,8,3,40,20,4,11,2,37,21,8,8,3,40,20,4,11,2,37,1,0,32,32,0.483871,0.516129,10,8
2019020207,2019-11-02,2,BUF,0.0,1.0,NYI,24,16,12,0,52,18,9,9,1,37,24,16,12,0,52,18,9,9,1,37,0,1,27,21,0.5,0.5,2,6
2019020208,2019-11-02,2,FLA,4.0,0.0,DET,29,9,8,3,49,20,8,9,0,37,29,9,8,3,49,20,8,9,0,37,1,0,41,22,0.555556,0.444444,6,4
2019020209,2019-11-02,2,PHI,3.0,4.0,TOR,34,16,8,2,60,28,8,12,5,53,21,12,7,1,41,18,6,12,2,38,0,1,40,26,0.607843,0.392157,6,14
2019020210,2019-11-02,2,CAR,3.0,5.0,N.J,19,13,12,2,46,19,9,8,4,40,17,13,9,2,41,19,8,8,4,39,1,0,27,26,0.444444,0.555556,12,12
2019020211,2019-11-02,2,CBJ,0.0,3.0,CGY,37,9,8,0,54,21,9,17,3,50,37,9,8,0,54,21,9,17,3,50,0,1,43,29,0.464286,0.535714,6,8
2019020212,2019-11-02,2,DAL,4.0,1.0,MTL,32,9,15,2,58,30,10,19,1,60,30,8,14,1,53,28,10,19,1,58,1,0,40,36,0.46875,0.53125,10,8
2019020213,2019-11-02,2,MIN,3.0,4.0,STL,20,8,9,2,39,23,7,14,4,48,20,8,9,2,39,23,7,13,3,46,1,0,23,29,0.610169,0.389831,6,4
2019020214,2019-11-02,2,ARI,3.0,0.0,COL,23,11,8,2,44,26,13,12,0,51,23,11,8,2,44,26,13,12,0,51,1,0,28,33,0.5,0.5,15,11
2019020215,2019-11-02,2,VGK,3.0,4.0,WPG,22,14,7,2,45,30,7,17,3,57,20,14,7,1,42,27,7,17,2,53,0,1,26,39,0.613333,0.386667,13,11
2019020216,2019-11-02,2,S.J,2.0,5.0,VAN,14,6,20,1,41,20,8,11,4,43,14,6,20,1,41,20,8,11,4,43,0,1,26,28,0.553571,0.446429,8,6
2019020217,2019-11-02,2,L.A,4.0,3.0,CHI,35,11,14,4,64,23,11,9,2,45,32,11,14,3,60,20,11,9,2,42,1,0,49,27,0.569231,0.430769,2,8
2019020218,2019-11-03,2,WSH,4.0,2.0,CGY,25,8,10,3,46,22,13,18,2,55,23,7,10,3,43,22,13,18,2,55,0,1,32,27,0.535714,0.464286,6,6
2019020219,2019-11-03,2,ANA,2.0,3.0,CHI,25,14,4,1,44,25,8,15,2,50,24,14,4,1,43,24,8,15,1,48,0,1,38,37,0.540984,0.459016,10,8
2019020220,2019-11-04,2,BOS,6.0,4.0,PIT,17,9,7,6,39,36,7,11,4,58,16,9,7,5,37,35,7,10,4,56,1,0,26,44,0.464286,0.535714,4,8
2019020221,2019-11-04,2,NYR,2.0,6.0,OTT,25,4,12,1,42,19,10,4,4,37,25,3,11,1,40,17,9,4,4,34,1,0,34,30,0.550725,0.449275,36,22
2019020222,2019-11-04,2,DET,1.0,6.0,NSH,19,5,8,1,33,14,13,12,4,43,19,5,8,1,33,14,13,12,4,43,1,0,24,26,0.55,0.45,13,11
2019020223,2019-11-04,2,EDM,2.0,3.0,ARI,21,9,9,2,41,17,9,10,3,39,21,9,9,2,41,16,8,10,2,36,1,0,28,24,0.555556,0.444444,6,4
2019020224,2019-11-05,2,MTL,5.0,4.0,BOS,24,13,11,5,53,20,8,24,3,55,24,13,11,5,53,20,8,24,3,55,1,0,31,25,0.4,0.6,4,4
2019020225,2019-11-05,2,NYI,4.0,1.0,OTT,22,11,15,3,51,23,4,7,0,34,22,11,15,2,50,23,4,7,0,34,0,1,32,28,0.586957,0.413043,18,4
2019020226,2019-11-05,2,PHI,4.0,1.0,CAR,20,1,9,3,33,27,12,9,1,49,19,1,9,3,32,27,12,9,1,49,1,0,28,34,0.490909,0.509091,6,6
2019020227,2019-11-05,2,CBJ,1.0,2.0,VGK,20,11,8,1,40,18,10,10,1,39,20,11,8,1,40,18,10,10,1,39,0,1,30,25,0.574074,0.425926,6,8
2019020228,2019-11-05,2,TOR,3.0,1.0,L.A,14,16,13,3,46,18,12,10,0,40,14,16,13,3,46,18,12,10,0,40,0,1,23,25,0.574074,0.425926,6,8
2019020229,2019-11-05,2,WPG,1.0,2.0,N.J,28,13,13,1,55,26,7,13,1,47,24,13,12,1,50,26,7,13,1,47,0,1,33,32,0.661017,0.338983,6,2
2019020230,2019-11-05,2,DAL,4.0,1.0,COL,18,12,6,3,39,21,9,14,1,45,18,11,6,3,38,21,9,13,1,44,1,0,38,37,0.596491,0.403509,16,14
2019020231,2019-11-05,2,CGY,4.0,3.0,ARI,27,18,12,2,59,19,6,9,3,37,25,17,11,1,54,14,5,9,3,31,0,1,43,37,0.555556,0.444444,10,12
2019020232,2019-11-05,2,VAN,1.0,2.0,STL,26,10,11,1,48,23,4,10,2,39,25,7,10,1,43,20,4,10,1,35,0,1,34,27,0.538462,0.461538,6,10
2019020233,2019-11-05,2,ANA,2.0,4.0,MIN,25,15,16,2,58,18,17,11,4,50,25,15,16,2,58,18,17,11,4,50,1,0,31,26,0.489796,0.510204,4,4
2019020234,2019-11-05,2,S.J,4.0,2.0,CHI,21,9,15,3,48,17,7,6,2,32,21,9,15,3,48,17,7,6,2,32,1,0,32,21,0.442308,0.557692,6,6
2019020235,2019-11-06,2,NYR,5.0,1.0,DET,22,10,10,2,44,28,17,16,1,62,22,10,10,2,44,28,17,16,1,62,1,0,31,36,0.416667,0.583333,4,6
2019020236,2019-11-06,2,EDM,2.0,5.0,STL,30,9,13,1,53,16,10,16,1,43,30,9,13,1,53,16,10,16,1,43,1,0,34,25,0.409836,0.590164,6,6
2019020237,2019-11-07,2,TOR,2.0,1.0,VGK,20,9,13,1,43,24,8,13,1,46,19,8,12,0,39,23,8,12,1,44,0,1,37,38,0.537313,0.462687,10,12
2019020238,2019-11-07,2,FLA,4.0,5.0,WSH,27,6,11,3,47,20,6,9,4,39,26,6,11,3,46,20,6,9,3,38,0,1,36,31,0.5,0.5,8,10
2019020239,2019-11-07,2,NYI,3.0,4.0,PIT,19,8,11,2,40,31,18,15,4,68,18,8,10,2,38,30,16,15,3,64,1,0,23,39,0.510638,0.489362,4,2
2019020240,2019-11-07,2,PHI,3.0,2.0,MTL,30,10,9,3,52,21,9,12,2,44,29,9,9,2,49,21,9,12,2,44,1,0,43,24,0.5,0.5,0,12
2019020241,2019-11-07,2,CAR,2.0,4.0,NYR,40,22,15,2,79,13,14,3,3,33,40,22,15,2,79,13,14,3,3,33,0,1,47,19,0.607843,0.392157,4,4
2019020242,2019-11-07,2,OTT,3.0,2.0,L.A,28,13,14,3,58,22,12,10,2,46,26,13,14,2,55,20,12,9,2,43,0,1,33,28,0.52381,0.47619,4,4
2019020243,2019-11-07,2,CHI,5.0,2.0,VAN,28,5,13,2,48,30,4,7,1,42,25,4,12,2,43,30,4,7,1,42,1,0,37,38,0.344262,0.655738,8,12
2019020244,2019-11-07,2,COL,9.0,4.0,NSH,28,3,18,6,55,17,12,14,3,46,28,2,18,6,54,15,11,14,3,43,1,0,45,24,0.470588,0.529412,8,12
2019020245,2019-11-07,2,CGY,5.0,2.0,N.J,25,11,10,3,49,15,13,8,2,38,25,10,10,2,47,15,12,8,2,37,0,1,38,23,0.458333,0.541667,6,12
2019020246,2019-11-07,2,ARI,2.0,3.0,CBJ,22,10,12,2,46,28,5,10,2,45,20,10,12,2,44,25,5,10,2,42,0,1,32,33,0.5,0.5,10,8
2019020247,2019-11-07,2,S.J,6.0,5.0,MIN,20,8,6,4,38,16,14,18,5,53,19,8,5,4,36,16,13,16,5,50,1,0,31,26,0.436364,0.563636,17,30
2019020248,2019-11-08,2,DET,4.0,2.0,BOS,19,5,11,2,37,18,6,10,1,35,19,5,11,2,37,17,6,8,1,32,0,1,32,28,0.4875,0.5125,13,15
2019020249,2019-11-08,2,BUF,2.0,3.0,T.B,17,5,7,2,31,26,12,7,2,47,17,5,7,2,31,26,12,7,2,47,0,1,22,34,0.310345,0.689655,10,6
2019020250,2019-11-08,2,WPG,4.0,1.0,VAN,24,8,13,3,48,29,14,11,1,55,24,8,12,3,47,29,14,11,1,55,0,1,35,33,0.469388,0.530612,4,6
2019020251,2019-11-08,2,EDM,4.0,0.0,N.J,23,6,16,3,48,24,15,8,0,47,23,6,16,3,48,24,15,8,0,47,1,0,32,29,0.589286,0.410714,8,6
2019020252,2019-11-09,2,NYI,2.0,1.0,FLA,27,13,10,2,52,30,17,14,0,61,27,13,10,2,52,30,17,14,0,61,1,0,36,38,0.571429,0.428571,8,6
2019020253,2019-11-09,2,TOR,2.0,3.0,PHI,31,15,12,2,60,27,10,16,1,54,25,14,11,2,52,26,7,16,1,50,0,1,40,32,0.546875,0.453125,6,6
2019020254,2019-11-09,2,MTL,3.0,2.0,L.A,25,8,10,1,44,22,5,11,1,39,25,8,10,1,44,22,5,11,1,39,1,0,37,33,0.484375,0.515625,6,12
2019020255,2019-11-09,2,OTT,4.0,1.0,CAR,21,9,7,4,41,32,10,17,0,59,20,9,6,4,39,32,9,17,0,58,1,0,30,39,0.441176,0.558824,13,13
2019020256,2019-11-09,2,T.B,5.0,3.0,BUF,24,12,3,3,42,36,11,13,3,63,24,12,3,3,42,36,11,13,3,63,0,1,40,43,0.506849,0.493151,16,8
2019020257,2019-11-09,2,PIT,3.0,2.0,CHI,28,5,11,4,48,28,9,14,3,54,22,5,11,2,40,24,7,14,2,47,0,1,31,31,0.482143,0.517857,4,6
2019020258,2019-11-09,2,WSH,5.0,2.0,VGK,17,15,5,4,41,21,6,9,1,37,16,15,5,4,40,20,6,9,1,36,1,0,34,32,0.532258,0.467742,10,14
2019020259,2019-11-09,2,ARI,3.0,4.0,MIN,28,11,11,3,53,17,13,7,3,40,28,11,11,3,53,17,13,7,3,40,1,0,35,24,0.660377,0.339623,2,6
2019020260,2019-11-09,2,COL,4.0,2.0,CBJ,24,5,14,3,46,34,7,9,1,51,24,5,14,3,46,34,7,9,1,51,0,1,36,41,0.54902,0.45098,8,17
2019020261,2019-11-09,2,CGY,2.0,3.0,STL,23,8,11,2,44,21,8,8,1,38,20,8,9,1,38,21,8,8,1,38,0,1,29,28,0.53125,0.46875,10,6
2019020262,2019-11-09,2,S.J,2.0,1.0,NSH,23,12,17,1,53,14,7,14,1,36,21,11,15,1,48,12,7,14,1,34,0,1,32,25,0.454545,0.545455,8,8
2019020263,2019-11-10,2,NYR,5.0,6.0,FLA,25,9,7,4,45,23,11,13,6,53,20,8,6,3,37,20,11,13,4,48,1,0,34,35,0.240741,0.759259,11,13
2019020264,2019-11-10,2,WPG,3.0,2.0,DAL,17,9,9,2,37,25,10,8,2,45,17,9,9,1,36,25,10,8,2,45,1,0,29,28,0.634921,0.365079,2,6
2019020265,2019-11-10,2,VAN,1.0,2.0,N.J,25,14,19,0,58,22,10,12,1,45,25,14,19,0,58,22,10,12,1,45,0,1,31,27,0.529412,0.470588,4,6
2019020266,2019-11-10,2,DET,3.0,2.0,VGK,15,7,4,2,28,11,9,12,2,34,15,7,4,2,28,11,9,12,2,34,0,1,19,19,0.491228,0.508772,4,4
2019020267,2019-11-10,2,BOS,2.0,3.0,PHI,22,14,12,2,50,25,6,13,2,46,20,12,11,2,45,24,6,12,2,44,0,1,28,29,0.611111,0.388889,4,4
2019020268,2019-11-10,2,CHI,5.0,4.0,TOR,18,6,13,4,41,45,6,11,2,64,16,6,12,4,38,43,6,10,1,60,1,0,34,57,0.522388,0.477612,14,12
2019020269,2019-11-10,2,ANA,2.0,6.0,EDM,26,7,11,2,46,20,11,6,4,41,26,7,11,2,46,20,11,6,4,41,0,1,33,31,0.568627,0.431373,8,10
2019020270,2019-11-11,2,WSH,3.0,4.0,ARI,29,17,16,3,65,27,8,9,5,49,26,13,15,3,57,24,7,9,3,43,0,1,34,35,0.45614,0.54386,4,6
2019020271,2019-11-11,2,CAR,8.0,2.0,OTT,32,10,15,6,63,24,7,11,2,44,31,10,15,5,61,24,7,11,2,44,1,0,43,29,0.457143,0.542857,13,13
2019020272,2019-11-12,2,BOS,4.0,5.0,FLA,33,10,13,4,60,21,7,5,4,37,22,8,13,3,46,13,7,3,2,25,1,0,38,29,0.470588,0.529412,12,8
2019020273,2019-11-12,2,MTL,3.0,2.0,CBJ,29,12,21,3,65,22,8,9,2,41,27,10,19,2,58,20,7,9,2,38,0,1,32,35,0.545455,0.454545,6,4
2019020274,2019-11-12,2,NYR,3.0,2.0,PIT,22,4,13,3,42,26,9,14,1,50,22,4,12,2,40,25,8,13,1,47,1,0,27,32,0.488889,0.511111,6,4
2019020275,2019-11-12,2,STL,2.0,3.0,ARI,33,10,17,2,62,15,7,4,3,29,27,10,16,2,55,15,7,3,1,26,1,0,35,22,0.610169,0.389831,6,6
2019020276,2019-11-12,2,WPG,0.0,4.0,COL,31,8,16,0,55,17,5,9,3,34,31,8,16,0,55,17,5,9,3,34,0,1,40,25,0.574468,0.425532,6,4
2019020277,2019-11-12,2,VAN,5.0,3.0,NSH,20,13,11,2,46,31,12,13,2,58,20,13,11,2,46,30,12,13,2,57,1,0,26,37,0.507937,0.492063,4,6
2019020278,2019-11-12,2,ANA,3.0,4.0,DET,21,18,14,3,56,24,12,12,3,51,20,18,13,3,54,22,12,12,2,48,1,0,27,36,0.421875,0.578125,17,13
2019020279,2019-11-12,2,L.A,3.0,1.0,MIN,28,13,11,3,55,26,13,16,1,56,28,13,11,3,55,26,13,16,1,56,1,0,35,28,0.372881,0.627119,6,14
2019020280,2019-11-12,2,S.J,6.0,3.0,EDM,17,10,13,6,46,18,11,14,3,46,16,9,12,6,43,17,11,13,3,44,1,0,25,24,0.509434,0.490566,11,23
2019020281,2019-11-13,2,N.J,2.0,4.0,OTT,18,12,7,2,39,20,16,7,4,47,18,12,7,2,39,20,16,7,4,47,1,0,23,25,0.4,0.6,2,6
2019020282,2019-11-13,2,NYI,5.0,4.0,TOR,20,8,7,3,38,23,16,19,4,62,20,8,7,3,38,23,16,19,4,62,1,0,30,27,0.545455,0.454545,4,6
2019020283,2019-11-13,2,PHI,1.0,2.0,WSH,28,9,14,1,52,31,14,9,3,57,23,7,12,0,42,28,12,9,1,50,0,1,31,36,0.508197,0.491803,6,8
2019020284,2019-11-13,2,CGY,1.0,3.0,DAL,16,12,13,0,41,20,12,11,2,45,16,12,13,0,41,20,12,11,2,45,0,1,25,32,0.532258,0.467742,6,8
2019020285,2019-11-13,2,VGK,3.0,5.0,CHI,34,18,10,2,64,20,9,9,5,43,32,16,9,2,59,20,7,8,5,40,1,0,42,26,0.526316,0.473684,4,6
2019020286,2019-11-14,2,BUF,4.0,5.0,CAR,24,7,5,4,40,20,8,9,3,40,24,7,4,4,39,18,8,9,2,37,1,0,33,29,0.376812,0.623188,28,8
2019020287,2019-11-14,2,T.B,9.0,3.0,NYR,25,13,7,4,49,14,7,7,3,31,22,13,6,4,45,13,6,7,3,29,1,0,45,23,0.567164,0.432836,37,55
2019020288,2019-11-14,2,FLA,3.0,4.0,WPG,30,4,14,2,50,26,10,10,4,50,29,4,13,2,48,26,10,10,4,50,0,1,37,30,0.581818,0.418182,0,6
2019020289,2019-11-14,2,MIN,3.0,2.0,ARI,29,4,6,2,41,23,8,11,2,44,29,4,6,2,41,22,8,11,2,43,1,0,34,29,0.6,0.4,6,6
2019020290,2019-11-14,2,EDM,6.0,2.0,COL,12,9,8,2,31,26,10,13,2,51,12,9,8,2,31,25,10,13,2,50,0,1,28,33,0.491228,0.508772,15,17
2019020291,2019-11-14,2,VAN,2.0,4.0,DAL,25,8,18,2,53,20,11,7,4,42,25,8,18,2,53,21,11,7,4,43,0,1,34,29,0.403226,0.596774,9,11
2019020292,2019-11-14,2,ANA,3.0,5.0,S.J,20,17,8,2,47,26,11,13,3,53,19,17,8,2,46,26,11,13,3,53,1,0,32,35,0.509804,0.490196,11,13
2019020293,2019-11-14,2,L.A,3.0,2.0,DET,27,16,17,3,63,18,9,8,2,37,27,15,16,2,60,18,9,8,2,37,1,0,31,21,0.592593,0.407407,2,6
2019020294,2019-11-15,2,TOR,2.0,4.0,BOS,26,19,20,2,67,28,15,7,4,54,26,19,20,2,67,28,15,7,4,54,0,1,31,34,0.628571,0.371429,4,4
2019020295,2019-11-15,2,N.J,2.0,1.0,PIT,14,7,6,2,29,31,16,17,1,65,13,7,6,2,28,29,16,17,1,63,1,0,21,39,0.516129,0.483871,8,6
2019020296,2019-11-15,2,WSH,2.0,5.0,MTL,24,11,14,1,50,32,10,22,5,69,24,11,14,1,50,32,10,22,5,69,0,1,28,40,0.409836,0.590164,2,2
2019020297,2019-11-15,2,CBJ,3.0,2.0,STL,33,5,10,2,50,23,10,15,1,49,31,5,10,2,48,23,10,15,1,49,1,0,39,27,0.544118,0.455882,6,6
2019020298,2019-11-15,2,OTT,2.0,1.0,PHI,15,12,13,1,41,17,3,9,1,30,15,12,13,1,41,17,3,9,1,30,0,1,19,27,0.431373,0.568627,10,6
2019020299,2019-11-16,2,MIN,3.0,4.0,CAR,28,11,10,2,51,17,7,8,4,36,27,11,10,2,50,16,7,8,3,34,0,1,35,28,0.454545,0.545455,6,8
2019020300,2019-11-16,2,T.B,3.0,4.0,WPG,27,16,14,3,60,16,10,6,3,35,27,16,14,3,60,16,9,6,3,34,0,1,34,27,0.422222,0.577778,8,4
2019020301,2019-11-16,2,EDM,4.0,5.0,DAL,27,9,10,3,49,27,11,8,5,51,26,9,10,3,48,27,10,8,4,49,0,1,34,36,0.428571,0.571429,4,6
2019020302,2019-11-16,2,ARI,3.0,0.0,CGY,16,5,10,3,34,28,7,19,0,54,16,5,10,3,34,28,7,19,0,54,1,0,24,37,0.471698,0.528302,14,16
2019020303,2019-11-16,2,BOS,2.0,3.0,WSH,21,15,3,3,42,35,11,9,4,59,14,12,3,2,31,30,8,9,2,49,1,0,23,44,0.326923,0.673077,6,8
2019020304,2019-11-16,2,BUF,4.0,2.0,OTT,20,13,10,4,47,18,4,11,1,34,20,13,10,4,47,18,4,11,1,34,1,0,32,23,0.47619,0.52381,6,4
2019020305,2019-11-16,2,MTL,3.0,4.0,N.J,27,4,18,2,51,36,9,7,1,53,25,4,16,2,47,34,8,6,1,49,1,0,34,43,0.540541,0.459459,14,12
2019020306,2019-11-16,2,FLA,4.0,3.0,NYR,23,10,14,2,49,26,7,10,3,46,23,8,14,2,47,26,7,10,3,46,1,0,30,33,0.516129,0.483871,6,8
2019020307,2019-11-16,2,PHI,3.0,4.0,NYI,23,9,10,2,44,28,10,16,4,58,21,8,9,2,40,25,10,16,2,53,1,0,31,36,0.469388,0.530612,6,6
2019020308,2019-11-16,2,PIT,6.0,1.0,TOR,26,6,3,4,39,29,12,16,1,58,26,6,3,4,39,29,12,16,1,58,1,0,38,33,0.315789,0.684211,4,2
2019020309,2019-11-16,2,STL,1.0,4.0,ANA,33,11,8,1,53,12,5,3,3,23,33,11,8,1,53,12,5,3,3,23,0,1,38,25,0.454545,0.545455,6,10
2019020310,2019-11-16,2,NSH,2.0,7.0,CHI,36,9,16,2,63,16,8,7,7,38,36,9,16,2,63,16,8,7,7,38,0,1,41,24,0.528302,0.471698,2,2
2019020311,2019-11-16,2,VAN,4.0,5.0,COL,24,16,18,2,60,13,4,7,4,28,23,16,18,2,59,12,4,7,3,26,0,1,32,23,0.644068,0.355932,12,14
2019020312,2019-11-16,2,L.A,4.0,3.0,VGK,18,10,8,2,38,24,15,10,3,52,18,10,8,2,38,24,15,10,3,52,1,0,25,31,0.492063,0.507937,6,4
2019020313,2019-11-16,2,S.J,4.0,3.0,DET,14,6,12,3,35,21,10,10,3,44,13,6,11,2,32,17,6,9,3,35,1,0,19,28,0.5,0.5,6,6
2019020314,2019-11-17,2,CHI,4.0,1.0,BUF,14,12,7,3,36,24,3,12,1,40,14,12,7,3,36,24,3,12,1,40,1,0,27,34,0.516129,0.483871,13,15
2019020315,2019-11-17,2,VGK,6.0,0.0,CGY,25,20,11,5,61,34,7,20,0,61,25,20,11,4,60,33,8,19,0,60,1,0,37,34,0.585714,0.414286,12,14
2019020316,2019-11-18,2,WSH,5.0,2.0,ANA,25,13,13,4,55,24,10,13,1,48,25,13,13,4,55,24,10,13,1,48,1,0,31,34,0.5,0.5,25,33
2019020317,2019-11-18,2,ARI,3.0,0.0,L.A,20,9,7,1,37,21,17,23,0,61,20,9,7,1,37,21,17,23,0,61,1,0,27,31,0.510204,0.489796,8,8
2019020318,2019-11-19,2,BUF,1.0,4.0,MIN,24,10,10,1,45,14,6,3,3,26,24,10,10,1,45,14,6,2,3,25,0,1,31,26,0.436364,0.563636,14,6
2019020319,2019-11-19,2,FLA,5.0,2.0,PHI,19,12,16,5,52,31,9,16,2,58,19,12,16,5,52,31,9,17,2,59,0,1,26,37,0.520833,0.479167,6,8
2019020320,2019-11-19,2,N.J,1.0,5.0,BOS,24,10,14,1,49,23,11,7,4,45,24,10,14,1,49,23,11,7,4,45,0,1,26,28,0.395833,0.604167,4,4
2019020321,2019-11-19,2,PIT,4.0,5.0,NYI,20,4,13,2,39,30,8,10,5,53,20,4,13,2,39,26,8,10,4,48,1,0,31,42,0.450704,0.549296,6,8
2019020322,2019-11-19,2,CBJ,5.0,2.0,MTL,19,5,5,4,33,26,12,18,2,58,19,5,5,4,33,26,12,18,2,58,1,0,26,32,0.37931,0.62069,4,4
2019020323,2019-11-19,2,DET,3.0,4.0,OTT,27,3,3,2,35,21,8,7,4,40,27,3,3,2,35,18,8,7,3,36,0,1,38,33,0.5,0.5,10,8
2019020324,2019-11-19,2,STL,3.0,1.0,T.B,24,9,11,3,47,15,10,12,1,38,22,8,11,3,44,15,10,12,1,38,0,1,34,18,0.546875,0.453125,6,10
2019020325,2019-11-19,2,NSH,1.0,2.0,WPG,36,21,14,1,72,21,7,17,2,47,34,21,13,1,69,21,6,15,2,44,0,1,39,25,0.48,0.52,8,8
2019020326,2019-11-19,2,CHI,2.0,4.0,CAR,21,6,20,2,49,25,10,19,4,58,21,6,20,2,49,25,10,19,4,58,0,1,32,33,0.467742,0.532258,12,6
2019020327,2019-11-19,2,DAL,6.0,1.0,VAN,23,6,8,5,42,23,8,10,1,42,23,6,8,5,42,23,8,10,1,42,1,0,31,33,0.612903,0.387097,10,6
2019020328,2019-11-19,2,CGY,2.0,3.0,COL,24,13,19,2,58,16,16,10,3,45,24,13,19,2,58,16,16,10,3,45,0,1,33,26,0.553571,0.446429,4,4
2019020329,2019-11-19,2,VGK,4.0,2.0,TOR,31,10,17,2,60,31,8,19,1,59,31,10,17,2,60,31,8,19,1,59,1,0,37,33,0.461538,0.538462,4,4
2019020330,2019-11-19,2,S.J,2.0,5.0,EDM,28,10,16,2,56,22,14,8,4,48,28,10,16,2,56,22,14,8,4,48,0,1,35,29,0.610169,0.389831,4,4
2019020331,2019-11-20,2,MTL,1.0,2.0,OTT,32,19,17,0,68,20,9,11,2,42,31,19,17,0,67,20,9,11,1,41,1,0,36,24,0.54386,0.45614,6,2
2019020332,2019-11-20,2,NYR,4.0,1.0,WSH,22,8,5,2,37,22,16,11,0,49,21,8,5,2,36,22,16,11,0,49,1,0,31,31,0.428571,0.571429,11,11
2019020333,2019-11-21,2,BOS,3.0,2.0,BUF,17,5,11,1,34,30,12,17,1,60,17,5,11,1,34,30,12,17,1,60,0,1,27,38,0.535714,0.464286,15,11
2019020334,2019-11-21,2,FLA,5.0,4.0,ANA,22,12,15,5,54,28,10,18,3,59,22,12,15,4,53,28,10,18,3,59,0,1,28,32,0.53125,0.46875,2,2
2019020335,2019-11-21,2,NYI,4.0,3.0,PIT,13,5,8,2,28,22,12,10,3,47,13,4,7,1,25,21,9,8,2,40,0,1,24,26,0.548387,0.451613,8,16
2019020336,2019-11-21,2,CAR,3.0,5.0,PHI,28,5,11,2,46,14,9,12,3,38,27,5,11,2,45,14,9,12,2,37,1,0,36,23,0.457627,0.542373,16,10
2019020337,2019-11-21,2,CBJ,5.0,4.0,DET,24,16,13,3,56,21,3,8,3,35,24,16,13,3,56,21,3,8,3,35,1,0,37,26,0.530612,0.469388,6,10
2019020338,2019-11-21,2,STL,5.0,0.0,CGY,25,10,6,4,45,35,14,10,0,59,25,9,6,4,44,34,12,10,0,56,1,0,31,40,0.551724,0.448276,13,9
2019020339,2019-11-21,2,NSH,3.0,6.0,VAN,28,12,17,2,59,14,4,4,0,22,28,12,17,2,59,14,4,4,0,22,1,0,48,23,0.493151,0.506849,12,12
2019020340,2019-11-21,2,MIN,3.0,2.0,COL,22,11,10,2,45,24,9,13,1,47,21,11,10,2,44,24,9,13,1,47,1,0,31,27,0.52459,0.47541,6,10
2019020341,2019-11-21,2,CHI,2.0,4.0,T.B,28,7,19,2,56,25,12,14,3,54,28,7,19,2,56,25,12,14,3,54,0,1,34,35,0.571429,0.428571,6,6
2019020342,2019-11-21,2,DAL,5.0,3.0,WPG,29,7,11,5,52,21,10,16,3,50,29,7,11,5,52,21,10,16,3,50,1,0,36,26,0.66,0.34,4,4
2019020343,2019-11-21,2,ARI,1.0,3.0,TOR,24,8,14,1,47,30,20,20,2,72,24,8,14,1,47,30,20,20,2,72,0,1,31,33,0.477612,0.522388,0,6
2019020344,2019-11-21,2,VGK,1.0,2.0,S.J,31,10,15,1,57,22,6,11,2,41,27,10,14,1,52,17,5,11,1,34,0,1,38,29,0.526316,0.473684,4,6
2019020345,2019-11-21,2,L.A,5.0,1.0,EDM,21,5,10,4,40,21,10,8,1,40,21,5,10,4,40,21,10,8,1,40,1,0,30,26,0.509434,0.490566,4,22
2019020346,2019-11-22,2,PIT,4.0,1.0,N.J,34,9,7,4,54,26,7,11,0,44,33,8,7,4,52,25,7,11,0,43,1,0,41,37,0.460317,0.539683,13,11
2019020347,2019-11-22,2,OTT,4.0,1.0,NYR,24,11,6,2,43,24,5,9,1,39,26,11,6,2,45,25,6,10,1,42,1,0,39,31,0.545455,0.454545,8,10
2019020348,2019-11-23,2,WSH,1.0,2.0,VAN,33,15,7,1,56,28,17,9,1,55,24,14,6,1,45,22,15,9,0,46,1,0,33,33,0.54717,0.45283,10,6
2019020349,2019-11-23,2,PHI,2.0,3.0,CGY,33,9,16,2,60,24,10,11,3,48,27,8,14,2,51,20,10,10,2,42,1,0,38,27,0.594595,0.405405,6,6
2019020350,2019-11-23,2,L.A,2.0,3.0,ARI,38,17,15,1,71,15,6,10,2,33,38,17,15,1,71,15,6,10,2,33,0,1,45,19,0.589286,0.410714,2,6
2019020351,2019-11-23,2,BOS,5.0,4.0,MIN,28,8,16,4,56,20,5,6,2,33,27,7,15,3,52,17,3,6,2,28,0,1,39,36,0.5,0.5,16,8
2019020352,2019-11-23,2,MTL,5.0,6.0,NYR,28,13,21,5,67,22,6,10,5,43,27,13,20,5,65,22,6,10,5,43,1,0,43,34,0.5,0.5,6,10
2019020353,2019-11-23,2,T.B,6.0,2.0,ANA,14,7,12,3,36,26,11,9,1,47,13,7,12,3,35,25,11,9,1,46,1,0,27,38,0.555556,0.444444,12,24
2019020354,2019-11-23,2,N.J,5.0,1.0,DET,19,10,7,5,41,16,6,7,1,30,16,10,7,5,38,16,5,7,1,29,0,1,34,20,0.471698,0.528302,15,15
2019020355,2019-11-23,2,CAR,4.0,2.0,FLA,20,20,19,4,63,18,13,6,2,39,20,20,19,4,63,18,13,6,2,39,0,1,34,23,0.42,0.58,4,4
2019020356,2019-11-23,2,WPG,4.0,3.0,CBJ,22,11,5,4,42,25,14,11,0,50,22,11,5,4,42,25,14,11,0,50,0,1,31,35,0.566038,0.433962,10,6
2019020357,2019-11-23,2,COL,3.0,5.0,TOR,30,10,22,2,64,22,9,15,4,50,30,10,22,2,64,22,9,15,4,50,1,0,37,28,0.603175,0.396825,4,6
2019020358,2019-11-23,2,STL,2.0,4.0,NSH,21,5,16,1,43,30,8,5,4,47,21,5,16,1,43,30,8,5,4,47,0,1,26,43,0.451613,0.548387,6,6
2019020359,2019-11-23,2,DAL,2.0,1.0,CHI,29,9,17,3,58,30,14,16,1,61,27,9,16,1,53,24,12,16,1,53,1,0,41,39,0.5,0.5,8,8
2019020360,2019-11-23,2,VGK,2.0,4.0,EDM,25,6,18,2,51,22,7,15,3,47,25,6,18,2,51,22,7,15,3,47,0,1,27,31,0.508475,0.491525,6,0
2019020361,2019-11-23,2,S.J,2.0,1.0,NYI,19,7,12,2,40,17,9,13,1,40,18,7,11,1,37,17,9,13,1,40,1,0,26,28,0.533333,0.466667,17,7
2019020362,2019-11-24,2,FLA,2.0,5.0,BUF,36,6,14,1,57,18,9,8,5,40,36,6,14,1,57,18,9,8,5,40,0,1,45,26,0.56,0.44,4,8
2019020363,2019-11-24,2,DET,0.0,2.0,CAR,17,10,10,0,37,31,9,11,1,52,17,10,10,0,37,31,9,11,1,52,0,1,19,36,0.545455,0.454545,4,2
2019020364,2019-11-24,2,ARI,3.0,4.0,EDM,23,16,14,2,55,35,12,17,3,67,21,13,13,2,49,31,11,17,2,61,0,1,30,37,0.508772,0.491228,2,4
2019020365,2019-11-25,2,T.B,5.0,2.0,BUF,19,13,11,2,45,17,12,9,2,40,17,12,10,2,41,17,12,9,2,40,1,0,29,30,0.638298,0.361702,8,8
2019020366,2019-11-25,2,NYR,3.0,2.0,MIN,23,10,16,2,51,24,8,12,2,46,23,10,16,1,50,24,8,11,2,45,1,0,31,28,0.5,0.5,4,8
2019020367,2019-11-25,2,PHI,2.0,1.0,VAN,32,4,20,2,58,14,8,16,1,39,32,4,20,2,58,14,8,16,1,39,0,1,34,17,0.615385,0.384615,4,2
2019020368,2019-11-25,2,PIT,3.0,2.0,CGY,29,6,14,2,51,29,13,17,1,60,26,6,13,1,46,25,12,14,1,52,0,1,38,34,0.471429,0.528571,4,6
2019020369,2019-11-25,2,CBJ,1.0,0.0,OTT,16,12,13,1,42,24,15,13,0,52,14,11,13,1,39,24,14,13,0,51,1,0,19,25,0.5,0.5,4,6
2019020370,2019-11-25,2,NSH,3.0,2.0,STL,28,12,15,4,59,21,8,9,3,41,22,10,14,2,48,18,7,9,2,36,1,0,39,25,0.609375,0.390625,11,11
2019020371,2019-11-25,2,DAL,4.0,2.0,VGK,18,10,16,2,46,21,13,23,2,59,17,10,16,2,45,21,11,19,2,53,1,0,28,28,0.461538,0.538462,10,8
2019020372,2019-11-25,2,ANA,3.0,0.0,NYI,19,8,9,3,39,23,15,17,0,55,19,8,9,3,39,23,15,17,0,55,1,0,23,26,0.509804,0.490196,9,9
2019020373,2019-11-25,2,L.A,3.0,4.0,S.J,19,15,17,3,54,19,8,9,4,40,19,14,16,3,52,19,8,9,3,39,0,1,36,25,0.568966,0.431034,4,10
2019020374,2019-11-26,2,MTL,1.0,8.0,BOS,35,15,14,1,65,13,10,12,6,41,32,13,14,1,60,13,10,12,6,41,0,1,37,24,0.5,0.5,6,6
2019020375,2019-11-26,2,N.J,2.0,3.0,MIN,28,6,10,1,45,24,12,11,2,49,28,6,10,1,45,24,12,11,2,49,0,1,34,29,0.4375,0.5625,8,4
2019020376,2019-11-26,2,CHI,3.0,0.0,DAL,33,4,17,2,56,28,8,16,0,52,33,4,17,2,56,28,8,16,0,52,1,0,38,32,0.436364,0.563636,4,2
2019020377,2019-11-27,2,BUF,2.0,3.0,CGY,27,14,12,1,54,24,9,8,3,44,26,14,12,1,53,24,9,8,2,43,0,1,36,29,0.45614,0.54386,4,4
2019020378,2019-11-27,2,OTT,1.0,2.0,BOS,29,13,20,1,63,14,9,15,2,40,29,13,20,1,63,14,9,15,2,40,1,0,34,21,0.511111,0.488889,4,4
2019020379,2019-11-27,2,DET,0.0,6.0,TOR,25,12,5,0,42,46,13,11,5,75,25,12,5,0,42,46,13,11,5,75,0,1,25,54,0.446429,0.553571,2,0
2019020380,2019-11-27,2,T.B,3.0,4.0,STL,30,5,9,2,46,25,4,4,2,35,30,5,9,2,46,25,4,4,2,35,1,0,35,33,0.461538,0.538462,4,8
2019020381,2019-11-27,2,NYR,3.0,2.0,CAR,17,10,8,2,37,30,13,16,1,60,17,10,7,2,36,30,13,16,1,60,1,0,25,43,0.4,0.6,10,10
2019020382,2019-11-27,2,PIT,8.0,6.0,VAN,25,12,18,6,61,14,6,9,5,34,22,12,18,5,57,13,6,9,5,33,1,0,40,22,0.548387,0.451613,6,10
2019020383,2019-11-27,2,WSH,4.0,3.0,FLA,13,5,16,4,38,29,9,14,3,55,13,5,16,4,38,27,8,14,3,52,1,0,20,40,0.407407,0.592593,8,6
2019020384,2019-11-27,2,CBJ,2.0,3.0,PHI,25,8,9,2,44,13,7,13,2,35,25,8,9,2,44,13,7,13,2,35,1,0,30,22,0.480769,0.519231,20,2
2019020385,2019-11-27,2,NSH,3.0,4.0,VGK,30,9,12,3,54,24,9,12,4,49,30,9,12,3,54,23,9,11,3,46,0,1,34,30,0.516667,0.483333,4,4
2019020386,2019-11-27,2,ARI,4.0,3.0,ANA,24,9,9,4,46,29,10,16,4,59,22,9,9,2,42,25,9,16,3,53,1,0,28,34,0.392157,0.607843,8,6
2019020387,2019-11-27,2,COL,4.0,1.0,EDM,36,8,15,4,63,19,9,12,1,41,34,8,14,4,60,18,7,11,1,37,0,1,50,20,0.645833,0.354167,8,29
2019020388,2019-11-27,2,L.A,4.0,1.0,NYI,22,13,13,3,51,18,11,16,1,46,23,12,12,2,49,17,11,15,1,44,0,1,30,25,0.491228,0.508772,8,10
2019020389,2019-11-27,2,S.J,1.0,5.0,WPG,22,7,12,1,42,17,4,4,4,29,22,7,12,1,42,17,3,4,4,28,1,0,33,26,0.5,0.5,18,34
2019020390,2019-11-28,2,MTL,4.0,6.0,N.J,41,14,22,4,81,26,9,10,6,51,41,14,22,4,81,26,9,10,6,51,0,1,48,35,0.575758,0.424242,6,4
2019020391,2019-11-29,2,BOS,3.0,2.0,NYR,19,9,10,3,41,20,10,3,2,35,19,9,10,2,40,20,9,3,2,34,0,1,27,28,0.509434,0.490566,17,7
2019020392,2019-11-29,2,BUF,6.0,4.0,TOR,26,6,5,6,43,18,11,7,4,40,23,6,5,6,40,18,10,7,3,38,0,1,36,29,0.607143,0.392857,10,6
2019020393,2019-11-29,2,PHI,6.0,1.0,DET,25,5,12,5,47,25,9,10,1,45,25,5,12,5,47,24,9,10,1,44,1,0,35,33,0.52459,0.47541,6,6
2019020394,2019-11-29,2,CHI,2.0,5.0,COL,32,7,19,2,60,18,7,11,4,40,32,7,18,2,59,18,7,11,4,40,0,1,36,23,0.576271,0.423729,13,9
2019020395,2019-11-29,2,MIN,7.0,2.0,OTT,26,9,12,6,53,30,13,9,2,54,25,9,12,5,51,30,13,9,2,54,0,1,35,35,0.466667,0.533333,4,8
2019020396,2019-11-29,2,ANA,0.0,3.0,WPG,22,12,7,0,41,14,10,7,2,33,22,12,7,0,41,14,10,7,2,33,0,1,24,20,0.5,0.5,35,11
2019020397,2019-11-29,2,S.J,4.0,1.0,L.A,15,9,14,4,42,32,5,13,1,51,15,9,14,4,42,32,5,13,1,51,1,0,22,34,0.458333,0.541667,2,6
2019020398,2019-11-29,2,WSH,4.0,3.0,T.B,28,12,27,2,69,24,13,10,2,49,26,9,26,1,62,22,13,9,2,46,0,1,35,30,0.477612,0.522388,10,6
2019020399,2019-11-29,2,VGK,2.0,1.0,ARI,31,5,15,2,53,35,10,12,2,59,24,5,14,0,43,30,10,10,1,51,1,0,38,36,0.54386,0.45614,4,10
2019020400,2019-11-29,2,CBJ,5.0,2.0,PIT,20,9,4,3,36,21,4,10,2,37,20,9,4,3,36,21,4,10,2,37,1,0,30,31,0.5,0.5,8,8
2019020401,2019-11-29,2,CAR,0.0,3.0,NSH,26,15,16,0,57,16,8,5,3,32,26,15,16,0,57,16,8,5,3,32,0,1,31,28,0.396226,0.603774,8,6
2019020402,2019-11-29,2,DAL,1.0,3.0,STL,31,8,17,1,57,30,6,22,3,61,31,8,17,1,57,32,8,24,3,67,0,1,32,40,0.526316,0.473684,4,0
2019020403,2019-11-30,2,N.J,0.0,4.0,NYR,26,10,9,0,45,14,10,2,1,27,26,10,9,0,45,15,9,2,0,26,0,1,33,23,0.433962,0.566038,13,34
2019020404,2019-11-30,2,MTL,3.0,4.0,PHI,32,8,11,2,53,23,10,19,4,56,32,8,11,2,53,23,10,19,3,55,1,0,42,29,0.45,0.55,4,6
2019020405,2019-11-30,2,TOR,2.0,1.0,BUF,39,11,11,1,62,29,18,11,1,59,37,11,11,0,59,27,17,11,1,56,1,0,43,30,0.537037,0.462963,4,2
2019020406,2019-11-30,2,DET,2.0,5.0,WSH,24,9,13,1,47,23,3,10,4,40,24,9,13,1,47,23,3,10,4,40,1,0,27,34,0.557377,0.442623,6,8
2019020407,2019-11-30,2,T.B,2.0,3.0,CAR,27,13,16,1,57,17,6,8,2,33,26,12,17,1,56,16,6,7,2,31,0,1,38,24,0.516667,0.483333,18,12
2019020408,2019-11-30,2,FLA,3.0,0.0,NSH,22,12,12,3,49,20,10,14,0,44,17,10,10,3,40,20,10,14,0,44,1,0,28,27,0.5,0.5,8,8
2019020409,2019-11-30,2,NYI,2.0,0.0,CBJ,25,9,8,2,44,37,13,14,0,64,25,9,8,2,44,37,13,14,0,64,1,0,27,39,0.431818,0.568182,2,0
2019020410,2019-11-30,2,CGY,3.0,1.0,OTT,23,14,14,2,53,25,15,12,1,53,23,14,14,2,53,25,15,12,1,53,1,0,27,27,0.4,0.6,2,6
2019020411,2019-11-30,2,STL,5.0,2.0,PIT,14,5,9,4,32,23,10,8,2,43,12,5,9,4,30,23,10,8,2,43,1,0,27,31,0.44898,0.55102,4,6
2019020412,2019-11-30,2,ARI,2.0,4.0,S.J,19,13,8,2,42,23,7,7,4,41,18,12,8,2,40,23,7,7,4,41,1,0,23,30,0.477273,0.522727,2,6
2019020413,2019-11-30,2,COL,7.0,3.0,CHI,17,5,5,6,33,18,7,12,1,38,17,5,5,6,33,18,7,12,1,38,0,1,29,29,0.555556,0.444444,17,13
2019020414,2019-11-30,2,EDM,2.0,5.0,VAN,20,8,15,2,45,25,7,8,3,43,19,7,15,2,43,25,7,8,3,43,0,1,30,38,0.52459,0.47541,6,6
2019020415,2019-11-30,2,L.A,2.0,1.0,WPG,32,14,16,2,64,29,12,10,1,52,32,14,16,2,64,29,12,10,1,52,1,0,34,34,0.446429,0.553571,6,0
2019020416,2019-12-01,2,MIN,3.0,2.0,DAL,23,8,12,3,46,21,9,17,3,50,19,8,12,0,39,20,7,16,1,44,1,0,29,28,0.52,0.48,6,6
2019020417,2019-12-01,2,BOS,3.0,1.0,MTL,28,5,11,2,46,21,9,16,1,47,27,5,11,2,45,21,9,16,1,47,0,1,34,29,0.410714,0.589286,4,8
2019020418,2019-12-01,2,VAN,2.0,3.0,EDM,26,7,21,2,56,23,10,7,1,41,26,7,21,2,56,23,10,7,1,41,0,1,32,28,0.446809,0.553191,4,4
2019020419,2019-12-02,2,BUF,7.0,1.0,N.J,22,5,3,6,36,34,12,9,0,55,22,5,3,5,35,33,12,9,0,54,1,0,32,45,0.527273,0.472727,10,6
2019020420,2019-12-02,2,NYR,1.0,4.0,VGK,20,13,17,1,51,25,13,10,2,50,20,11,16,1,48,25,13,10,2,50,0,1,30,32,0.44186,0.55814,6,12
2019020421,2019-12-02,2,DET,1.0,4.0,NYI,21,9,9,0,39,14,7,10,3,34,21,9,9,0,39,14,7,10,3,34,0,1,31,25,0.44898,0.55102,10,12
2019020422,2019-12-02,2,CHI,0.0,4.0,STL,36,9,9,0,54,25,4,13,3,45,36,9,9,0,54,25,4,13,3,45,0,1,38,30,0.461538,0.538462,4,4
2019020423,2019-12-02,2,ANA,4.0,2.0,L.A,15,11,16,3,45,27,23,13,2,65,15,11,16,3,45,27,23,12,2,64,1,0,20,36,0.388889,0.611111,4,2
2019020424,2019-12-03,2,BOS,2.0,0.0,CAR,28,0,10,2,40,21,14,10,0,45,28,0,10,2,40,21,14,10,0,45,1,0,34,24,0.471698,0.528302,4,4
2019020425,2019-12-03,2,MTL,4.0,2.0,NYI,33,9,18,4,64,13,8,20,2,43,33,9,17,4,63,13,8,20,2,43,1,0,40,23,0.380952,0.619048,8,2
2019020426,2019-12-03,2,FLA,2.0,4.0,MIN,41,12,7,1,61,21,6,9,4,40,41,12,7,1,61,21,6,9,4,40,1,0,46,26,0.581818,0.418182,2,6
2019020427,2019-12-03,2,N.J,3.0,4.0,VGK,26,13,13,3,55,18,7,13,3,41,26,13,13,3,55,18,7,13,3,41,1,0,35,30,0.462963,0.537037,8,6
2019020428,2019-12-03,2,PHI,6.0,1.0,TOR,22,12,16,6,56,20,11,8,1,40,21,12,16,6,55,20,11,8,1,40,1,0,29,28,0.6,0.4,2,6
2019020429,2019-12-03,2,CBJ,2.0,4.0,ARI,31,10,14,1,56,22,7,9,3,41,31,10,14,1,56,22,7,9,3,41,0,1,35,28,0.433962,0.566038,2,6
2019020430,2019-12-03,2,NSH,2.0,3.0,T.B,24,3,7,1,35,19,11,8,3,41,23,3,7,1,34,17,11,8,2,38,0,1,32,31,0.507937,0.492063,26,15
2019020431,2019-12-03,2,WPG,5.0,1.0,DAL,22,9,10,5,46,25,12,12,1,50,20,8,10,5,43,23,11,12,0,46,1,0,30,28,0.66129,0.33871,13,13
2019020432,2019-12-03,2,VAN,5.0,2.0,OTT,23,7,13,4,47,34,7,14,2,57,23,7,13,4,47,34,7,14,2,57,1,0,29,42,0.454545,0.545455,6,4
2019020433,2019-12-03,2,S.J,2.0,5.0,WSH,23,11,11,2,47,17,14,9,5,45,23,11,11,2,47,17,14,9,5,45,1,0,25,28,0.534884,0.465116,17,0
2019020434,2019-12-04,2,TOR,1.0,3.0,COL,34,9,11,1,55,24,9,19,1,53,34,9,11,1,55,24,9,19,1,53,0,1,39,30,0.648148,0.351852,6,2
2019020435,2019-12-04,2,PIT,3.0,0.0,STL,25,6,5,3,39,19,3,8,0,30,25,6,5,3,39,19,3,8,0,30,1,0,33,28,0.519231,0.480769,8,10
2019020436,2019-12-04,2,EDM,2.0,5.0,OTT,17,15,10,1,43,16,10,8,4,38,17,15,10,1,43,17,9,9,4,39,1,0,26,25,0.490566,0.509434,6,14
2019020437,2019-12-04,2,L.A,1.0,3.0,WSH,17,9,8,1,35,14,16,9,3,42,17,9,8,1,35,14,16,9,3,42,0,1,23,22,0.46875,0.53125,4,6
2019020438,2019-12-05,2,BOS,3.0,4.0,CHI,27,9,16,2,54,19,13,9,2,43,27,9,16,2,54,19,13,9,1,42,0,1,40,31,0.481481,0.518519,11,13
2019020439,2019-12-05,2,MTL,2.0,3.0,COL,33,7,18,1,59,25,4,14,2,45,33,7,18,1,59,25,4,14,2,45,0,1,40,35,0.525424,0.474576,6,6
2019020440,2019-12-05,2,T.B,4.0,5.0,MIN,23,11,18,3,55,11,6,12,5,34,23,11,18,3,55,11,6,12,5,34,1,0,34,21,0.560976,0.439024,6,10
2019020441,2019-12-05,2,NYI,3.0,2.0,VGK,27,15,13,2,57,29,8,18,2,57,26,14,12,2,54,28,8,18,2,56,1,0,31,33,0.574074,0.425926,2,4
2019020442,2019-12-05,2,PHI,1.0,3.0,ARI,23,11,18,1,53,14,10,7,1,32,23,11,18,1,53,14,10,7,1,32,0,1,29,18,0.6,0.4,8,6
2019020443,2019-12-05,2,CAR,3.0,2.0,S.J,23,12,9,3,47,26,13,11,2,52,16,9,7,2,34,22,9,11,2,44,1,0,29,30,0.333333,0.666667,6,8
2019020444,2019-12-05,2,CBJ,2.0,3.0,NYR,29,18,8,2,57,13,10,8,2,33,29,18,8,2,57,13,10,8,2,33,1,0,47,19,0.538462,0.461538,4,10
2019020445,2019-12-05,2,DAL,3.0,2.0,WPG,30,9,11,1,51,25,10,16,2,53,26,8,11,1,46,21,10,15,2,48,1,0,39,38,0.509091,0.490909,8,12
2019020446,2019-12-05,2,CGY,4.0,3.0,BUF,22,17,10,2,51,22,10,10,2,44,20,17,10,2,49,22,10,10,2,44,0,1,29,29,0.454545,0.545455,16,4
2019020447,2019-12-06,2,N.J,1.0,2.0,CHI,30,9,16,2,57,27,16,18,3,64,25,9,15,0,49,23,13,16,0,52,1,0,30,29,0.527273,0.472727,9,13
2019020448,2019-12-06,2,NYR,1.0,2.0,MTL,21,10,16,1,48,28,8,11,2,49,21,10,16,1,48,28,8,11,2,49,0,1,30,33,0.395349,0.604651,2,4
2019020449,2019-12-06,2,PIT,2.0,0.0,ARI,21,6,10,1,38,23,6,9,0,38,21,6,10,1,38,23,6,9,0,38,1,0,26,33,0.372549,0.627451,10,4
2019020450,2019-12-06,2,EDM,2.0,1.0,L.A,15,11,7,0,33,27,12,14,1,54,15,11,7,0,33,27,12,14,1,54,1,0,20,36,0.407407,0.592593,4,6
2019020451,2019-12-06,2,ANA,2.0,3.0,WSH,24,24,10,2,60,30,9,5,2,46,24,23,9,2,58,24,7,5,2,38,0,1,29,36,0.641509,0.358491,38,28
2019020452,2019-12-07,2,PHI,4.0,3.0,OTT,16,11,6,4,37,15,13,10,2,40,16,11,6,4,37,15,13,10,2,40,1,0,21,30,0.538462,0.461538,16,16
2019020453,2019-12-07,2,VAN,6.0,5.0,BUF,23,9,5,4,41,21,7,14,4,46,23,9,4,4,40,21,6,14,4,45,1,0,30,28,0.639344,0.360656,8,4
2019020454,2019-12-07,2,BOS,1.0,4.0,COL,16,13,16,1,46,15,9,10,4,38,16,12,16,1,45,15,9,10,4,38,1,0,20,20,0.405405,0.594595,2,6
2019020455,2019-12-07,2,DET,3.0,5.0,PIT,21,9,12,1,43,22,7,4,4,37,21,9,12,1,43,22,7,4,4,37,0,1,28,28,0.5,0.5,4,6
2019020456,2019-12-07,2,T.B,7.0,1.0,S.J,25,11,4,5,45,26,11,10,1,48,25,11,4,5,45,26,11,10,1,48,1,0,38,38,0.47619,0.52381,8,8
2019020457,2019-12-07,2,FLA,4.0,1.0,CBJ,20,5,14,3,42,31,10,15,1,57,20,5,14,3,42,30,10,15,1,56,1,0,27,34,0.596154,0.403846,11,13
2019020458,2019-12-07,2,CAR,6.0,2.0,MIN,29,9,8,3,49,20,6,7,2,35,29,9,8,3,49,20,6,7,2,35,0,1,40,24,0.47541,0.52459,8,6
2019020459,2019-12-07,2,STL,2.0,5.0,TOR,23,9,10,2,44,18,6,18,2,44,23,9,10,2,44,18,6,18,2,44,0,1,28,27,0.574074,0.425926,9,13
2019020460,2019-12-07,2,NSH,6.0,4.0,N.J,25,11,12,6,54,25,8,12,3,48,23,8,12,6,49,25,8,12,3,48,1,0,37,33,0.540984,0.459016,8,12
2019020461,2019-12-07,2,DAL,3.0,1.0,NYI,33,14,14,1,62,30,10,12,1,53,33,14,14,1,62,30,10,12,1,53,1,0,37,35,0.537037,0.462963,2,4
2019020462,2019-12-07,2,CGY,4.0,3.0,L.A,22,6,12,3,43,30,11,11,1,53,22,6,12,3,43,30,11,11,1,53,0,1,30,33,0.339623,0.660377,21,23
2019020463,2019-12-08,2,WPG,3.0,2.0,ANA,27,11,19,2,59,27,7,13,2,49,27,11,18,2,58,26,7,13,2,48,1,0,33,33,0.5,0.5,9,13
2019020464,2019-12-08,2,FLA,5.0,1.0,S.J,22,10,11,3,46,24,16,15,0,55,22,10,11,3,46,23,16,15,0,54,1,0,33,31,0.477273,0.522727,11,23
2019020465,2019-12-08,2,CHI,3.0,4.0,ARI,23,8,13,2,46,34,7,9,1,51,21,8,12,2,43,33,7,8,1,49,1,0,29,47,0.518519,0.481481,27,9
2019020466,2019-12-08,2,VGK,0.0,5.0,NYR,32,6,16,0,54,16,7,6,3,32,31,6,16,0,53,14,7,6,3,30,0,1,38,25,0.607143,0.392857,15,13
2019020467,2019-12-08,2,EDM,2.0,3.0,BUF,18,7,8,1,34,17,13,13,3,46,17,7,8,1,33,17,13,13,2,45,0,1,28,22,0.627451,0.372549,6,6
2019020468,2019-12-09,2,T.B,1.0,5.0,NYI,27,17,14,1,59,16,8,10,3,37,23,17,14,1,55,15,8,10,3,36,0,1,32,24,0.583333,0.416667,8,10
2019020469,2019-12-09,2,WSH,2.0,5.0,CBJ,29,9,16,2,56,26,7,11,5,49,29,7,15,2,53,25,7,11,5,48,0,1,39,38,0.578125,0.421875,10,6
2019020470,2019-12-09,2,OTT,5.0,2.0,BOS,18,10,5,4,37,27,10,25,1,63,18,10,5,4,37,26,9,24,1,60,1,0,28,40,0.551724,0.448276,10,6
2019020471,2019-12-09,2,COL,4.0,5.0,CGY,27,11,21,4,63,21,7,13,4,45,27,10,20,4,61,20,7,12,3,42,1,0,32,33,0.387097,0.612903,6,4
2019020472,2019-12-10,2,BUF,5.0,2.0,STL,23,6,8,5,42,26,6,6,2,40,23,6,8,5,42,26,6,6,2,40,1,0,33,30,0.442308,0.557692,4,4
2019020473,2019-12-10,2,FLA,1.0,2.0,T.B,18,10,20,1,49,38,10,16,2,66,18,10,20,1,49,38,10,16,2,66,0,1,28,48,0.5,0.5,4,6
2019020474,2019-12-10,2,PIT,1.0,4.0,MTL,33,9,12,1,55,22,3,9,3,37,33,9,12,1,55,22,3,9,3,37,1,0,34,26,0.563636,0.436364,2,2
2019020475,2019-12-10,2,NSH,3.0,1.0,S.J,22,11,13,2,48,16,7,8,1,32,16,8,9,2,35,14,7,7,1,29,1,0,32,25,0.62963,0.37037,33,39
2019020476,2019-12-10,2,MIN,2.0,3.0,ANA,17,11,6,2,36,24,13,10,3,50,14,9,4,2,29,24,13,10,1,48,0,1,24,33,0.380282,0.619718,11,15
2019020477,2019-12-10,2,WPG,5.0,1.0,DET,18,12,7,3,40,13,6,14,1,34,16,12,6,3,37,13,6,14,1,34,1,0,30,17,0.584906,0.415094,16,18
2019020478,2019-12-10,2,DAL,2.0,0.0,N.J,28,5,21,2,56,13,10,5,0,28,28,5,21,2,56,13,10,5,0,28,1,0,35,26,0.666667,0.333333,6,10
2019020479,2019-12-10,2,EDM,3.0,6.0,CAR,25,11,4,2,42,22,13,11,3,49,25,11,4,2,42,22,13,11,3,49,0,1,36,32,0.430769,0.569231,18,10
2019020480,2019-12-10,2,ARI,2.0,5.0,CGY,45,13,14,1,73,21,9,9,4,43,45,13,14,1,73,21,9,9,4,43,0,1,48,29,0.537313,0.462687,8,4
2019020481,2019-12-10,2,VAN,1.0,4.0,TOR,35,10,12,1,58,21,10,16,4,51,35,10,12,1,58,21,10,16,4,51,0,1,39,26,0.45098,0.54902,4,4
2019020482,2019-12-10,2,VGK,5.0,1.0,CHI,28,7,10,3,48,28,12,11,0,51,28,6,10,3,47,28,12,8,0,48,1,0,37,29,0.507463,0.492537,8,4
2019020483,2019-12-10,2,L.A,3.0,1.0,NYR,21,22,11,3,57,21,11,7,0,39,21,22,11,3,57,21,11,7,0,39,1,0,26,30,0.442308,0.557692,14,12
2019020484,2019-12-11,2,WSH,3.0,2.0,BOS,21,11,15,2,49,21,6,13,2,42,19,11,14,2,46,21,6,13,2,42,0,1,25,32,0.410714,0.589286,17,13
2019020485,2019-12-11,2,MTL,3.0,2.0,OTT,21,7,8,2,38,27,15,9,1,52,19,7,8,1,35,27,15,9,1,52,1,0,29,37,0.553846,0.446154,14,10
2019020486,2019-12-11,2,COL,3.0,1.0,PHI,22,10,8,3,43,30,7,13,1,51,22,10,8,3,43,29,7,13,1,50,1,0,27,33,0.428571,0.571429,4,4
2019020487,2019-12-12,2,BUF,4.0,3.0,NSH,27,10,8,4,49,34,8,11,3,56,27,10,8,4,49,34,8,11,3,56,0,1,32,39,0.474576,0.525424,4,2
2019020488,2019-12-12,2,T.B,3.0,2.0,BOS,23,16,12,1,52,22,10,8,2,42,23,16,12,1,52,19,9,7,2,37,0,1,31,29,0.476923,0.523077,11,13
2019020489,2019-12-12,2,FLA,1.0,3.0,NYI,25,9,14,1,49,23,11,8,1,43,25,9,13,1,48,23,11,8,1,43,0,1,33,30,0.508475,0.491525,13,21
2019020490,2019-12-12,2,PIT,1.0,0.0,CBJ,30,9,19,0,58,15,8,15,0,38,29,9,19,0,57,15,8,15,0,38,0,0,32,17,0.488889,0.511111,2,6
2019020491,2019-12-12,2,DET,5.0,2.0,WPG,28,9,7,3,47,26,8,9,2,45,28,9,7,3,47,26,8,9,2,45,1,0,34,28,0.533333,0.466667,2,8
2019020492,2019-12-12,2,STL,4.0,2.0,VGK,23,10,5,4,42,23,8,14,2,47,23,10,5,4,42,23,8,14,2,47,1,0,29,29,0.452381,0.547619,6,0
2019020493,2019-12-12,2,MIN,6.0,5.0,EDM,19,16,11,6,52,28,11,13,4,56,19,15,11,6,51,27,11,12,4,54,0,1,26,33,0.5,0.5,9,7
2019020494,2019-12-12,2,CGY,4.0,2.0,TOR,19,19,12,4,54,28,7,13,2,50,19,19,12,4,54,28,7,13,2,50,0,1,24,34,0.555556,0.444444,6,2
2019020495,2019-12-12,2,ARI,5.0,2.0,CHI,23,11,11,5,50,25,14,9,1,49,22,11,11,5,49,25,14,9,1,49,1,0,40,30,0.565217,0.434783,6,8
2019020496,2019-12-12,2,VAN,1.0,0.0,CAR,19,4,5,1,29,34,4,8,0,46,17,4,4,0,25,32,4,8,0,44,0,0,26,43,0.45,0.55,8,10
2019020497,2019-12-12,2,ANA,1.0,2.0,L.A,34,17,13,0,64,20,12,8,1,41,32,16,13,0,61,19,12,8,1,40,0,1,37,27,0.4,0.6,11,11
2019020498,2019-12-12,2,S.J,3.0,6.0,NYR,14,7,10,2,33,19,7,16,5,47,14,7,10,2,33,19,7,16,5,47,1,0,18,30,0.615385,0.384615,6,4
2019020499,2019-12-13,2,DAL,2.0,3.0,VGK,22,7,20,2,51,23,14,12,3,52,21,7,20,2,50,22,14,12,2,50,1,0,30,32,0.516129,0.483871,4,4
2019020500,2019-12-13,2,COL,3.0,1.0,N.J,29,10,16,2,57,26,8,11,1,46,29,10,16,2,57,26,8,11,1,46,1,0,37,38,0.618182,0.381818,8,10
2019020501,2019-12-14,2,OTT,4.0,3.0,CBJ,21,10,14,3,48,34,13,9,3,59,18,10,12,3,43,29,12,9,3,53,1,0,27,41,0.576271,0.423729,13,11
2019020502,2019-12-14,2,NYI,3.0,2.0,BUF,20,4,6,3,33,23,9,16,0,48,19,4,6,2,31,21,9,16,0,46,1,0,26,35,0.733333,0.266667,8,8
2019020503,2019-12-14,2,CGY,0.0,4.0,CAR,23,8,13,0,44,21,10,13,1,45,21,7,12,0,40,20,10,12,1,43,0,1,32,31,0.474576,0.525424,8,12
2019020504,2019-12-14,2,ANA,4.0,3.0,NYR,34,13,9,3,59,31,10,8,4,53,31,12,8,1,52,26,10,8,3,47,0,1,42,32,0.661017,0.338983,6,10
2019020505,2019-12-14,2,NSH,1.0,4.0,DAL,29,17,20,1,67,12,5,6,3,26,29,17,20,1,67,12,5,6,3,26,1,0,38,22,0.53125,0.46875,4,6
2019020506,2019-12-14,2,MTL,1.0,2.0,DET,38,16,13,1,68,14,4,9,1,28,38,16,13,1,68,14,4,9,1,28,0,1,43,20,0.518519,0.481481,12,6
2019020507,2019-12-14,2,T.B,2.0,5.0,WSH,21,6,16,1,44,23,4,6,5,38,21,6,15,1,43,23,4,6,5,38,0,1,28,34,0.471698,0.528302,4,10
2019020508,2019-12-14,2,FLA,2.0,4.0,BOS,26,15,17,2,60,27,10,12,3,52,26,15,17,2,60,26,10,12,3,51,0,1,33,42,0.426471,0.573529,6,6
2019020509,2019-12-14,2,PIT,5.0,4.0,L.A,21,6,8,4,39,31,14,14,4,63,13,3,8,2,26,26,11,11,4,52,0,1,27,42,0.508772,0.491228,13,15
2019020510,2019-12-14,2,MIN,4.0,1.0,PHI,20,9,4,3,36,15,4,12,1,32,19,9,4,3,35,15,4,11,1,31,0,1,28,18,0.392157,0.607843,11,15
2019020511,2019-12-14,2,EDM,1.0,4.0,TOR,34,10,13,0,57,28,14,8,3,53,34,10,13,0,57,28,14,8,3,53,0,1,37,32,0.526316,0.473684,2,4
2019020512,2019-12-14,2,STL,4.0,3.0,CHI,31,10,10,4,55,11,9,5,3,28,29,9,10,4,52,11,9,5,3,28,0,1,38,22,0.433962,0.566038,8,6
2019020513,2019-12-14,2,ARI,1.0,2.0,N.J,28,10,22,0,60,25,6,7,2,40,28,10,22,0,60,25,6,7,2,40,0,1,32,33,0.588235,0.411765,6,6
2019020514,2019-12-14,2,S.J,4.0,2.0,VAN,19,16,11,4,50,24,14,17,2,57,18,16,11,4,49,23,14,17,2,56,1,0,27,35,0.375,0.625,8,6
2019020515,2019-12-15,2,WPG,7.0,3.0,PHI,14,11,14,4,43,25,11,4,2,42,13,11,14,4,42,24,11,4,2,41,1,0,24,32,0.578947,0.421053,4,21
2019020516,2019-12-15,2,DET,2.0,4.0,L.A,19,4,8,2,33,24,8,11,4,47,19,4,8,2,33,24,8,11,4,47,0,1,24,32,0.471698,0.528302,6,6
2019020517,2019-12-15,2,CHI,5.0,3.0,MIN,20,3,18,4,45,23,14,17,2,56,20,3,17,4,44,23,14,17,1,55,1,0,27,26,0.62069,0.37931,4,6
2019020518,2019-12-15,2,VGK,6.0,3.0,VAN,34,10,15,4,63,23,11,8,2,44,34,10,14,4,62,23,11,8,2,44,1,0,46,29,0.426471,0.573529,8,12
2019020519,2019-12-16,2,FLA,6.0,1.0,OTT,17,7,8,5,37,25,7,12,1,45,17,7,8,5,37,25,7,12,1,45,1,0,31,30,0.5,0.5,8,16
2019020520,2019-12-16,2,NYR,2.0,5.0,NSH,27,8,12,2,49,17,11,10,5,43,28,8,11,2,49,16,11,9,5,41,0,1,41,24,0.35,0.65,16,10
2019020521,2019-12-16,2,CBJ,3.0,0.0,WSH,17,8,3,3,31,24,15,12,0,51,17,8,3,3,31,24,15,12,0,51,1,0,21,30,0.515152,0.484848,25,11
2019020522,2019-12-16,2,STL,5.0,2.0,COL,26,13,11,3,53,22,16,9,1,48,25,13,10,3,51,21,13,8,1,43,1,0,35,28,0.557692,0.442308,6,8
2019020523,2019-12-16,2,DAL,1.0,2.0,EDM,29,10,18,1,58,17,6,5,1,29,29,10,18,1,58,17,6,5,1,29,0,1,35,28,0.564103,0.435897,12,6
2019020524,2019-12-17,2,BOS,3.0,4.0,L.A,32,15,7,2,56,22,9,8,2,41,29,13,7,2,51,21,9,8,1,39,0,1,40,27,0.623188,0.376812,2,6
2019020525,2019-12-17,2,TOR,5.0,3.0,BUF,24,12,9,4,49,26,12,13,2,53,24,12,9,4,49,26,12,13,2,53,1,0,33,30,0.64,0.36,4,2
2019020526,2019-12-17,2,T.B,4.0,3.0,OTT,35,18,19,4,76,21,3,3,3,30,31,18,19,3,71,19,3,2,2,26,1,0,40,28,0.551724,0.448276,8,2
2019020527,2019-12-17,2,NYI,3.0,8.0,NSH,23,11,23,1,58,13,9,11,6,39,23,11,23,1,58,11,9,11,6,37,0,1,30,24,0.523077,0.476923,34,18
2019020528,2019-12-17,2,PHI,4.0,1.0,ANA,22,4,7,4,37,36,9,10,0,55,22,4,7,4,37,36,9,10,0,55,1,0,31,41,0.509091,0.490909,17,11
2019020529,2019-12-17,2,DET,3.0,5.0,CBJ,15,6,3,2,26,31,10,8,4,53,15,6,3,2,26,31,10,8,4,53,1,0,21,39,0.442623,0.557377,4,6
2019020530,2019-12-17,2,WPG,3.0,6.0,CAR,27,6,9,2,44,17,13,18,4,52,27,6,9,2,44,17,13,18,3,51,0,1,33,28,0.432836,0.567164,4,4
2019020531,2019-12-17,2,CGY,1.0,4.0,PIT,33,16,12,1,62,27,6,11,4,48,33,16,12,1,62,27,6,11,4,48,1,0,34,33,0.519231,0.480769,6,2
2019020532,2019-12-17,2,VAN,1.0,3.0,MTL,36,9,13,0,58,24,14,7,1,46,36,9,13,0,58,24,14,7,1,46,1,0,39,30,0.481481,0.518519,4,8
2019020533,2019-12-17,2,VGK,3.0,2.0,MIN,23,12,13,3,51,19,11,15,1,46,23,12,13,3,51,19,11,15,1,46,0,1,29,26,0.563636,0.436364,10,2
2019020534,2019-12-17,2,S.J,2.0,3.0,ARI,23,8,11,2,44,10,9,11,3,33,23,8,11,2,44,10,9,11,3,33,0,1,28,19,0.45098,0.54902,6,8
2019020535,2019-12-18,2,N.J,3.0,1.0,ANA,15,9,9,2,35,23,10,13,1,47,14,9,9,2,34,22,10,12,1,45,0,1,20,27,0.367347,0.632653,9,13
2019020536,2019-12-18,2,CHI,1.0,4.0,COL,25,7,17,1,50,29,3,16,4,52,25,7,17,1,50,29,3,16,4,52,0,1,32,36,0.5,0.5,4,6
2019020537,2019-12-18,2,STL,2.0,1.0,EDM,30,6,9,2,47,26,7,2,1,36,30,6,9,2,47,25,7,2,1,35,1,0,44,36,0.490909,0.509091,8,10
2019020538,2019-12-19,2,BOS,2.0,3.0,NYI,22,11,12,2,47,17,14,6,4,41,18,10,11,1,40,14,12,5,2,33,1,0,29,21,0.592593,0.407407,4,10
2019020539,2019-12-19,2,T.B,3.0,4.0,DAL,42,13,15,1,71,15,7,6,3,31,40,11,15,1,67,13,6,5,2,26,0,1,48,20,0.492754,0.507246,4,8
2019020540,2019-12-19,2,PHI,6.0,1.0,BUF,20,9,9,3,41,16,4,5,0,25,20,9,9,3,41,16,4,5,0,25,1,0,29,17,0.613636,0.386364,6,12
2019020541,2019-12-19,2,CBJ,3.0,2.0,L.A,20,10,15,2,47,19,9,9,2,39,20,10,15,1,46,19,9,9,2,39,0,1,28,25,0.571429,0.428571,4,8
2019020542,2019-12-19,2,OTT,5.0,4.0,NSH,19,17,20,2,58,33,10,21,3,67,19,16,17,1,53,33,10,19,3,65,0,1,24,37,0.453333,0.546667,4,8
2019020543,2019-12-19,2,WPG,1.0,4.0,CHI,31,8,18,1,58,26,7,7,3,43,31,8,18,1,58,26,7,7,3,43,0,1,37,32,0.482143,0.517857,4,4
2019020544,2019-12-19,2,COL,1.0,3.0,CAR,16,6,15,0,37,28,8,11,3,50,16,6,15,0,37,28,8,11,3,50,1,0,28,40,0.538462,0.461538,6,12
2019020545,2019-12-19,2,CGY,3.0,4.0,MTL,24,15,13,2,54,35,17,15,4,71,21,15,12,1,49,29,15,13,3,60,1,0,27,43,0.52381,0.47619,6,4
2019020546,2019-12-19,2,ARI,5.0,8.0,MIN,29,13,17,3,62,21,8,8,8,45,27,13,17,3,60,20,6,7,8,41,1,0,40,33,0.602941,0.397059,8,12
2019020547,2019-12-19,2,VAN,5.0,4.0,VGK,24,8,2,4,38,35,9,17,4,65,22,8,2,3,35,34,7,16,3,60,1,0,34,43,0.603175,0.396825,6,14
2019020548,2019-12-20,2,FLA,7.0,4.0,DAL,24,9,7,5,45,22,5,12,3,42,23,8,7,5,43,21,4,12,3,40,1,0,33,31,0.5,0.5,6,8
2019020549,2019-12-20,2,N.J,3.0,6.0,WSH,18,2,6,2,28,20,16,14,6,56,18,2,6,2,28,20,15,13,4,52,1,0,27,29,0.5,0.5,9,13
2019020550,2019-12-20,2,NYR,3.0,6.0,TOR,17,11,7,3,38,26,13,11,5,55,17,11,7,3,38,26,13,10,5,54,0,1,22,40,0.508772,0.491228,6,6
2019020551,2019-12-20,2,EDM,2.0,5.0,PIT,23,15,8,1,47,18,7,11,4,40,23,13,8,1,45,18,7,11,4,40,0,1,28,26,0.44898,0.55102,4,6
2019020552,2019-12-21,2,BUF,3.0,2.0,L.A,22,5,5,3,35,22,11,17,2,52,22,5,5,3,35,21,9,16,2,48,0,1,28,27,0.367347,0.632653,4,6
2019020553,2019-12-21,2,NYI,5.0,6.0,ANA,25,4,14,4,47,19,9,11,5,44,22,3,14,3,42,15,8,11,3,37,1,0,33,28,0.578947,0.421053,8,6
2019020554,2019-12-21,2,MIN,0.0,6.0,WPG,25,10,11,0,46,20,2,11,4,37,21,10,9,0,40,19,2,11,3,35,0,1,31,31,0.581818,0.418182,15,13
2019020555,2019-12-21,2,BOS,3.0,4.0,NSH,23,14,11,2,50,17,9,12,4,42,21,12,10,2,45,15,9,11,2,37,1,0,32,29,0.482759,0.517241,6,8
2019020556,2019-12-21,2,TOR,4.0,1.0,DET,16,16,12,3,47,25,14,7,0,46,14,16,12,3,45,25,12,7,0,44,1,0,23,30,0.553191,0.446809,23,17
2019020557,2019-12-21,2,OTT,4.0,5.0,PHI,23,7,14,3,47,29,13,15,4,61,17,5,13,3,38,20,12,15,3,50,0,1,34,38,0.428571,0.571429,10,8
2019020558,2019-12-21,2,WSH,3.0,1.0,T.B,25,7,14,2,48,17,8,11,1,37,25,7,14,2,48,17,8,11,1,37,1,0,35,27,0.453125,0.546875,14,6
2019020559,2019-12-21,2,CAR,2.0,4.0,FLA,37,13,19,1,70,14,5,5,2,26,37,13,19,1,70,14,5,5,2,26,0,1,44,22,0.508197,0.491803,10,10
2019020560,2019-12-21,2,CBJ,5.0,1.0,N.J,28,6,7,3,44,15,6,8,1,30,28,6,6,3,43,13,6,7,0,26,1,0,40,22,0.576271,0.423729,10,14
2019020561,2019-12-21,2,EDM,4.0,3.0,MTL,14,6,11,3,34,21,13,20,1,55,14,6,11,3,34,21,13,20,1,55,1,0,26,26,0.517857,0.482143,7,15
2019020562,2019-12-21,2,COL,3.0,5.0,CHI,24,6,15,3,48,20,6,16,5,47,24,6,15,3,48,20,6,16,5,47,1,0,31,32,0.44,0.56,11,11
2019020563,2019-12-21,2,VAN,4.0,1.0,PIT,8,7,6,2,23,21,11,21,0,53,8,7,6,2,23,21,11,21,0,53,1,0,14,29,0.65,0.35,10,10
2019020564,2019-12-21,2,S.J,2.0,5.0,STL,29,8,12,1,50,22,7,4,3,36,29,8,12,1,50,22,7,4,3,36,1,0,36,28,0.465517,0.534483,4,6
2019020565,2019-12-22,2,NYR,5.0,1.0,ANA,25,9,4,4,42,16,8,8,1,33,25,9,4,3,41,16,8,8,1,33,1,0,41,20,0.540984,0.459016,29,31
2019020566,2019-12-22,2,DET,2.0,5.0,ARI,22,7,5,2,36,36,12,4,5,57,22,7,5,2,36,36,12,4,5,57,0,1,30,45,0.474576,0.525424,0,6
2019020567,2019-12-22,2,DAL,1.0,5.0,CGY,22,7,15,1,45,22,12,10,1,45,22,7,14,1,44,21,12,10,1,44,0,1,27,30,0.465517,0.534483,12,18
2019020568,2019-12-22,2,S.J,1.0,3.0,VGK,24,9,17,1,51,30,18,15,3,66,22,9,14,1,46,29,16,15,3,63,0,1,38,37,0.508475,0.491525,10,10
2019020569,2019-12-23,2,TOR,8.0,6.0,CAR,29,11,9,6,55,25,11,6,4,46,29,11,9,6,55,25,11,6,4,46,1,0,39,40,0.466667,0.533333,6,8
2019020570,2019-12-23,2,MIN,3.0,0.0,CGY,31,16,11,3,61,20,17,14,0,51,31,16,11,3,61,20,17,14,0,51,1,0,34,22,0.483871,0.516129,2,0
2019020571,2019-12-23,2,BOS,7.0,3.0,WSH,7,6,5,4,22,27,5,12,3,47,6,6,5,4,21,26,5,11,3,45,1,0,17,42,0.5,0.5,14,26
2019020572,2019-12-23,2,T.B,6.0,1.0,FLA,24,10,13,3,50,21,4,6,0,31,24,10,13,3,50,24,4,6,0,34,1,0,34,30,0.440678,0.559322,8,8
2019020573,2019-12-23,2,NYI,2.0,3.0,CBJ,28,10,16,2,56,31,11,6,2,50,27,10,15,2,54,31,10,6,2,49,1,0,37,35,0.442308,0.557692,6,6
2019020574,2019-12-23,2,PHI,5.0,1.0,NYR,18,12,8,4,42,25,8,8,0,41,18,12,8,4,42,25,8,8,0,41,0,1,30,35,0.507463,0.492537,8,12
2019020575,2019-12-23,2,OTT,3.0,1.0,BUF,22,6,16,3,47,40,12,18,1,71,22,6,16,3,47,40,12,18,1,71,1,0,29,44,0.516129,0.483871,4,4
2019020576,2019-12-23,2,NSH,3.0,2.0,ARI,38,14,12,3,67,26,10,13,2,51,38,14,12,3,67,26,10,13,2,51,1,0,41,28,0.574074,0.425926,4,2
2019020577,2019-12-23,2,WPG,2.0,6.0,MTL,22,7,9,1,39,36,17,13,5,71,22,7,9,1,39,36,17,13,4,70,1,0,29,48,0.478261,0.521739,4,6
2019020578,2019-12-23,2,CHI,1.0,7.0,N.J,24,4,20,1,49,30,3,20,6,59,23,4,20,1,48,28,3,19,6,56,1,0,33,44,0.517857,0.482143,13,31
2019020579,2019-12-23,2,VAN,4.0,2.0,EDM,23,13,19,3,58,25,7,12,1,45,21,13,18,3,55,24,7,12,1,44,1,0,28,29,0.5625,0.4375,11,11
2019020580,2019-12-23,2,VGK,3.0,7.0,COL,24,11,9,3,47,27,12,12,4,55,24,11,9,3,47,28,12,12,4,56,0,1,32,38,0.478873,0.521127,17,9
2019020581,2019-12-23,2,L.A,1.0,4.0,STL,24,13,14,0,51,22,9,6,2,39,24,13,14,0,51,22,9,6,2,39,0,1,30,28,0.466667,0.533333,4,10
2019020582,2019-12-27,2,BUF,0.0,3.0,BOS,24,16,13,0,53,20,13,4,2,39,24,14,13,0,51,20,13,4,2,39,0,1,26,25,0.433962,0.566038,10,6
2019020583,2019-12-27,2,N.J,4.0,5.0,TOR,22,8,7,3,40,28,12,13,3,56,22,8,7,3,40,27,12,12,2,53,1,0,28,37,0.509091,0.490909,10,8
2019020584,2019-12-27,2,NYR,5.0,3.0,CAR,16,6,5,3,30,23,14,13,3,53,16,6,5,3,30,23,14,13,3,53,0,1,24,42,0.457627,0.542373,10,8
2019020585,2019-12-27,2,WSH,2.0,1.0,CBJ,25,20,20,1,66,21,9,8,1,39,21,16,18,1,56,21,9,8,1,39,0,1,36,28,0.464286,0.535714,11,17
2019020586,2019-12-27,2,NSH,2.0,5.0,PIT,25,11,15,2,53,20,13,10,5,48,25,10,15,2,52,19,13,10,5,47,0,1,32,25,0.596491,0.403509,18,10
2019020587,2019-12-27,2,WPG,4.0,5.0,STL,16,11,9,3,39,25,9,7,4,45,16,9,9,3,37,20,7,7,3,37,0,1,29,35,0.464286,0.535714,6,8
2019020588,2019-12-27,2,COL,4.0,6.0,MIN,32,7,9,4,52,27,4,10,5,46,30,7,9,4,50,27,4,10,4,45,0,1,44,33,0.532258,0.467742,16,6
2019020589,2019-12-27,2,CHI,5.0,2.0,NYI,22,7,16,5,50,30,4,12,1,47,22,7,16,5,50,30,4,12,1,47,0,1,30,40,0.5,0.5,14,18
2019020590,2019-12-27,2,EDM,1.0,5.0,CGY,25,12,10,1,48,20,3,13,4,40,25,12,10,1,48,20,3,13,4,40,0,1,29,31,0.5,0.5,2,4
2019020591,2019-12-27,2,ANA,4.0,3.0,VGK,12,10,7,2,31,23,15,10,3,51,10,9,6,2,27,23,14,10,3,50,0,1,18,29,0.604651,0.395349,8,10
2019020592,2019-12-27,2,S.J,2.0,3.0,L.A,19,7,16,2,44,33,12,14,3,62,18,6,16,2,42,32,12,13,2,59,1,0,24,38,0.511111,0.488889,2,2
2019020593,2019-12-28,2,TOR,4.0,5.0,NYR,39,18,16,3,76,31,8,6,5,50,37,18,16,3,74,30,8,6,4,48,0,1,48,38,0.681159,0.318841,6,8
2019020594,2019-12-28,2,T.B,5.0,4.0,MTL,22,10,12,5,49,32,11,12,3,58,22,10,12,5,49,31,11,12,3,57,0,1,30,43,0.393443,0.606557,4,2
2019020595,2019-12-28,2,FLA,5.0,4.0,DET,24,11,10,3,48,33,12,16,3,64,24,11,10,2,47,31,12,15,3,61,1,0,30,39,0.380952,0.619048,6,8
2019020596,2019-12-28,2,PIT,6.0,4.0,NSH,29,2,6,3,40,37,10,15,3,65,29,2,6,3,40,37,10,15,3,65,1,0,36,48,0.514286,0.485714,4,8
2019020597,2019-12-28,2,CAR,6.0,4.0,WSH,22,9,10,4,45,16,8,12,2,38,22,9,10,4,45,16,8,12,2,38,1,0,29,29,0.466667,0.533333,10,6
2019020598,2019-12-28,2,DAL,3.0,2.0,COL,25,9,12,3,49,37,8,19,2,66,22,9,11,1,43,33,8,18,2,61,1,0,40,43,0.584615,0.415385,6,10
2019020599,2019-12-28,2,VAN,3.0,2.0,L.A,21,3,9,3,36,43,11,27,2,83,21,3,9,3,36,43,11,27,2,83,1,0,26,51,0.622642,0.377358,6,2
2019020600,2019-12-28,2,VGK,4.0,1.0,ARI,29,11,12,2,54,23,7,16,1,47,28,10,10,2,50,22,7,16,1,46,1,0,36,28,0.509434,0.490566,15,11
2019020601,2019-12-28,2,S.J,6.0,1.0,PHI,23,5,9,6,43,21,7,14,0,42,23,5,9,6,43,21,7,14,0,42,1,0,29,27,0.352941,0.647059,6,2
2019020602,2019-12-29,2,STL,4.0,1.0,WPG,22,14,11,3,50,19,10,7,1,37,22,14,11,3,50,17,10,6,1,34,1,0,28,26,0.636364,0.363636,6,4
2019020603,2019-12-29,2,OTT,3.0,4.0,N.J,16,12,9,3,40,21,17,14,2,54,16,12,9,3,40,21,17,13,1,52,0,1,23,34,0.527273,0.472727,15,23
2019020604,2019-12-29,2,CBJ,2.0,3.0,CHI,28,8,8,3,47,20,8,19,3,50,26,5,7,2,40,18,6,19,1,44,1,0,33,30,0.45614,0.54386,12,8
2019020605,2019-12-29,2,MIN,1.0,3.0,NYI,24,12,16,1,53,22,4,13,3,42,21,12,16,1,50,22,4,13,3,42,1,0,26,28,0.48,0.52,6,8
2019020606,2019-12-29,2,BOS,3.0,2.0,BUF,14,8,7,1,30,19,8,9,2,38,14,8,7,1,30,19,8,9,2,38,1,0,22,26,0.509804,0.490196,6,22
2019020607,2019-12-29,2,T.B,2.0,1.0,DET,25,6,20,1,52,17,2,4,1,24,25,6,20,1,52,17,2,4,1,24,1,0,39,20,0.553571,0.446429,4,8
2019020608,2019-12-29,2,FLA,6.0,5.0,MTL,22,6,14,6,48,31,16,16,3,66,22,5,14,6,47,28,16,16,1,61,1,0,34,43,0.485714,0.514286,8,10
2019020609,2019-12-29,2,ARI,2.0,4.0,DAL,26,8,9,2,45,18,15,14,4,51,26,8,9,2,45,18,15,14,4,51,1,0,35,25,0.526316,0.473684,8,10
2019020610,2019-12-29,2,ANA,1.0,2.0,PHI,23,11,11,1,46,31,13,12,2,58,20,11,11,1,43,28,11,11,1,51,1,0,28,35,0.389831,0.610169,4,8
2019020611,2019-12-29,2,CGY,2.0,5.0,VAN,17,11,12,2,42,17,14,9,3,43,16,10,12,1,39,16,14,8,3,41,0,1,25,28,0.31746,0.68254,12,10
2019020612,2019-12-30,2,PIT,5.0,2.0,OTT,27,6,17,5,55,22,8,13,2,45,27,6,15,5,53,22,7,13,2,44,1,0,33,26,0.453125,0.546875,18,26
2019020613,2019-12-31,2,N.J,3.0,2.0,BOS,35,17,14,2,68,25,14,14,1,54,28,14,13,2,57,23,12,13,1,49,0,1,44,30,0.5,0.5,6,8
2019020614,2019-12-31,2,WSH,3.0,4.0,NYI,30,17,25,3,75,17,7,12,4,40,29,17,25,3,74,16,7,12,4,39,0,1,39,22,0.584906,0.415094,6,6
2019020615,2019-12-31,2,VGK,5.0,2.0,ANA,38,12,11,5,66,21,11,9,2,43,38,12,11,4,65,21,11,9,2,43,0,1,43,28,0.509434,0.490566,9,7
2019020616,2019-12-31,2,MIN,1.0,4.0,TOR,21,8,15,0,44,23,13,9,3,48,21,8,15,0,44,23,13,9,3,48,0,1,27,29,0.523077,0.476923,6,6
2019020617,2019-12-31,2,BUF,4.0,6.0,T.B,18,9,6,3,36,16,7,5,4,32,17,9,6,3,35,16,6,4,4,30,1,0,28,27,0.54902,0.45098,27,15
2019020618,2019-12-31,2,CAR,3.0,1.0,MTL,28,15,10,2,55,28,13,12,1,54,28,15,10,2,55,28,13,12,1,54,1,0,36,30,0.552239,0.447761,6,4
2019020619,2019-12-31,2,CBJ,4.0,1.0,FLA,19,4,7,3,33,28,12,22,1,63,18,4,7,3,32,28,12,21,1,62,1,0,28,37,0.423077,0.576923,6,8
2019020620,2019-12-31,2,DET,2.0,0.0,S.J,16,8,10,2,36,28,5,18,0,51,16,7,10,2,35,28,5,18,0,51,1,0,23,34,0.48,0.52,13,11
2019020621,2019-12-31,2,COL,4.0,7.0,WPG,35,14,16,2,67,19,6,9,6,40,35,14,15,2,66,16,6,8,5,35,0,1,43,26,0.54386,0.45614,4,10
2019020622,2019-12-31,2,CGY,3.0,5.0,CHI,39,12,11,2,64,26,9,11,4,50,38,11,11,2,62,25,9,11,3,48,0,1,44,33,0.492958,0.507042,8,2
2019020623,2019-12-31,2,EDM,7.0,5.0,NYR,18,10,10,4,42,24,15,23,5,67,18,10,10,4,42,22,14,23,5,64,1,0,31,33,0.439394,0.560606,6,16
2019020624,2019-12-31,2,ARI,3.0,1.0,STL,18,11,7,1,37,28,10,10,1,49,18,11,7,1,37,28,10,10,1,49,1,0,26,39,0.4375,0.5625,8,8
2019020625,2019-12-31,2,L.A,5.0,3.0,PHI,17,6,12,1,36,28,8,7,2,45,17,6,12,1,36,28,8,6,2,44,1,0,29,35,0.461538,0.538462,6,6
2019020626,2020-01-01,2,DAL,4.0,2.0,NSH,26,13,10,2,51,26,12,16,0,54,24,12,9,2,47,26,12,15,0,53,0,1,35,33,0.546875,0.453125,21,8
2019020627,2020-01-02,2,BOS,1.0,2.0,CBJ,24,11,14,0,49,27,8,2,2,39,24,10,14,0,48,27,8,2,1,38,1,0,26,33,0.659091,0.340909,4,4
2019020628,2020-01-02,2,BUF,3.0,2.0,EDM,20,7,7,3,37,23,6,5,2,36,18,7,7,2,34,23,6,5,2,36,0,1,26,27,0.346939,0.653061,2,4
2019020629,2020-01-02,2,MTL,1.0,2.0,T.B,37,10,17,1,65,20,9,8,2,39,33,8,16,1,58,20,9,7,2,38,0,1,39,23,0.584906,0.415094,9,15
2019020630,2020-01-02,2,NYI,1.0,2.0,N.J,27,10,21,1,59,27,24,15,2,68,27,10,21,0,58,26,23,14,2,65,1,0,30,31,0.534483,0.465517,6,6
2019020631,2020-01-02,2,PIT,2.0,3.0,S.J,31,13,12,2,58,28,4,12,2,46,31,13,12,2,58,27,4,11,2,44,0,1,38,32,0.507692,0.492308,4,4
2019020632,2020-01-02,2,OTT,3.0,6.0,FLA,25,13,20,3,61,24,5,14,4,47,25,13,20,3,61,24,5,14,4,47,0,1,31,31,0.47541,0.52459,6,6
2019020633,2020-01-02,2,WPG,3.0,6.0,TOR,39,11,12,2,64,18,14,12,5,49,39,11,12,2,64,18,14,12,5,49,0,1,48,28,0.5,0.5,8,4
2019020634,2020-01-02,2,COL,7.0,3.0,STL,27,13,7,4,51,22,5,10,2,39,27,13,7,4,51,22,5,10,2,39,1,0,42,27,0.609375,0.390625,6,10
2019020635,2020-01-02,2,CGY,4.0,3.0,NYR,17,8,8,3,36,21,10,7,1,39,16,7,8,3,34,20,10,7,1,38,1,0,29,27,0.458333,0.541667,8,10
2019020636,2020-01-02,2,ARI,4.0,2.0,ANA,27,23,16,4,70,24,10,10,2,46,27,23,16,4,70,24,10,10,2,46,1,0,34,28,0.56,0.44,2,6
2019020637,2020-01-02,2,VAN,7.0,5.0,CHI,25,12,11,6,54,24,6,13,4,47,22,12,10,6,50,23,6,13,4,46,1,0,37,33,0.532258,0.467742,10,6
2019020638,2020-01-02,2,VGK,5.0,4.0,PHI,26,18,13,4,61,27,7,8,3,45,26,18,13,4,61,26,7,8,3,44,0,1,33,38,0.467742,0.532258,6,2
2019020639,2020-01-03,2,CAR,3.0,4.0,WSH,30,13,10,1,54,23,6,3,2,34,30,13,10,1,54,23,6,3,2,34,0,1,41,29,0.62069,0.37931,10,24
2019020640,2020-01-03,2,DAL,4.0,1.0,DET,17,4,12,1,34,18,7,13,1,39,17,4,12,1,34,18,7,13,1,39,0,1,27,23,0.518519,0.481481,10,8
2019020641,2020-01-04,2,BOS,1.0,4.0,EDM,31,11,12,0,54,20,11,12,4,47,31,11,12,0,54,20,11,12,4,47,1,0,36,26,0.444444,0.555556,4,6
2019020642,2020-01-04,2,CBJ,2.0,3.0,S.J,20,8,7,2,37,25,9,8,3,45,20,8,7,2,37,25,9,8,3,45,0,1,23,28,0.413793,0.586207,2,4
2019020643,2020-01-04,2,MIN,3.0,2.0,WPG,34,7,12,2,55,17,10,9,0,36,33,7,12,2,54,17,10,9,0,36,1,0,44,21,0.45283,0.54717,10,12
2019020644,2020-01-04,2,VGK,5.0,4.0,STL,26,11,13,5,55,22,6,10,2,40,26,11,13,4,54,21,5,8,2,36,0,1,33,31,0.367647,0.632353,12,10
2019020645,2020-01-04,2,BUF,3.0,2.0,FLA,13,5,9,2,29,27,9,12,2,50,13,5,9,2,29,27,9,12,2,50,1,0,18,34,0.519231,0.480769,8,8
2019020646,2020-01-04,2,TOR,3.0,0.0,NYI,19,12,12,3,46,31,6,9,0,46,19,12,12,3,46,31,6,9,0,46,1,0,23,33,0.55814,0.44186,2,0
2019020647,2020-01-04,2,MTL,2.0,3.0,PIT,19,8,14,2,43,28,13,14,3,58,18,7,14,2,41,26,12,14,2,54,1,0,28,37,0.491228,0.508772,15,15
2019020648,2020-01-04,2,OTT,3.0,5.0,T.B,20,11,9,1,41,22,10,14,5,51,19,11,9,1,40,21,10,12,5,48,1,0,28,28,0.423077,0.576923,13,17
2019020649,2020-01-04,2,N.J,2.0,5.0,COL,22,7,8,0,37,25,12,12,4,53,21,7,8,0,36,25,12,12,4,53,0,1,30,34,0.555556,0.444444,26,6
2019020650,2020-01-04,2,ARI,6.0,2.0,PHI,12,8,5,4,29,23,11,11,2,47,12,8,5,4,29,23,9,10,2,44,1,0,22,29,0.455882,0.544118,10,12
2019020651,2020-01-04,2,VAN,2.0,1.0,NYR,15,7,14,2,38,31,14,18,1,64,15,7,14,2,38,31,14,18,1,64,1,0,27,37,0.65625,0.34375,4,6
2019020652,2020-01-04,2,L.A,1.0,4.0,NSH,20,16,9,0,45,28,11,12,4,55,19,16,9,0,44,27,10,12,4,53,0,1,24,38,0.464789,0.535211,15,13
2019020653,2020-01-05,2,WSH,5.0,4.0,S.J,21,9,14,5,49,24,13,11,2,50,21,9,14,4,48,22,12,11,2,47,0,1,29,29,0.534483,0.465517,8,4
2019020654,2020-01-05,2,PIT,1.0,4.0,FLA,27,4,12,1,44,30,7,20,4,61,26,4,12,1,43,30,7,19,4,60,0,1,32,35,0.425926,0.574074,14,18
2019020655,2020-01-05,2,CAR,1.0,3.0,T.B,21,11,8,1,41,18,4,4,3,29,21,11,8,1,41,18,4,4,3,29,0,1,29,26,0.578947,0.421053,4,8
2019020656,2020-01-05,2,MIN,4.0,5.0,CGY,31,10,17,4,62,37,17,17,4,75,26,9,17,3,55,32,17,16,2,67,1,0,34,37,0.5,0.5,8,4
2019020657,2020-01-05,2,CHI,4.0,2.0,DET,16,13,18,4,51,18,11,10,1,40,16,13,18,4,51,18,11,10,1,40,0,1,27,21,0.477273,0.522727,6,6
2019020658,2020-01-05,2,ANA,5.0,4.0,NSH,38,13,9,4,64,24,13,12,4,53,32,11,9,2,54,17,11,11,3,42,1,0,47,26,0.438356,0.561644,11,17
2019020659,2020-01-06,2,TOR,4.0,6.0,EDM,26,9,9,3,47,26,9,12,5,52,25,9,9,3,46,25,9,11,4,49,0,1,36,35,0.587302,0.412698,12,10
2019020660,2020-01-06,2,MTL,2.0,3.0,WPG,25,13,12,2,52,22,4,10,2,38,25,13,12,2,52,22,4,10,2,38,0,1,31,27,0.52459,0.47541,2,4
2019020661,2020-01-06,2,NYI,1.0,0.0,COL,30,8,9,1,48,32,16,31,0,79,30,8,9,1,48,32,16,31,0,79,1,0,33,32,0.396226,0.603774,4,2
2019020662,2020-01-06,2,L.A,2.0,4.0,CBJ,34,18,18,2,72,18,2,9,4,33,34,18,18,2,72,18,2,9,4,33,1,0,37,24,0.636364,0.363636,2,0
2019020663,2020-01-07,2,T.B,9.0,2.0,VAN,23,11,9,7,50,16,3,6,2,27,23,11,9,7,50,15,3,6,2,26,0,1,37,23,0.465517,0.534483,8,10
2019020664,2020-01-07,2,FLA,2.0,5.0,ARI,30,17,15,2,64,28,7,7,3,45,29,16,15,2,62,27,7,7,3,44,0,1,39,37,0.56338,0.43662,6,6
2019020665,2020-01-07,2,N.J,3.0,4.0,NYI,30,17,10,2,59,37,13,17,4,71,28,15,10,2,55,36,11,16,3,66,0,1,35,41,0.538462,0.461538,0,2
2019020666,2020-01-07,2,NYR,5.0,3.0,COL,23,4,10,4,41,23,10,11,3,47,23,4,10,4,41,23,10,11,3,47,0,1,29,32,0.55,0.45,11,21
2019020667,2020-01-07,2,WSH,6.0,1.0,OTT,33,8,10,6,57,26,13,11,1,51,33,8,10,6,57,26,13,11,1,51,0,1,41,27,0.442623,0.557377,2,0
2019020668,2020-01-07,2,CAR,5.0,4.0,PHI,27,12,11,5,55,14,16,6,4,40,27,10,11,4,52,14,13,6,4,37,0,1,33,21,0.484848,0.515152,4,2
2019020669,2020-01-07,2,DET,4.0,3.0,MTL,22,7,6,4,39,17,7,9,1,34,22,7,6,4,39,17,7,9,1,34,0,1,30,26,0.553571,0.446429,10,8
2019020670,2020-01-07,2,STL,3.0,2.0,S.J,24,6,14,3,47,24,9,10,0,43,24,6,14,3,47,24,9,10,0,43,1,0,27,29,0.568966,0.431034,2,6
2019020671,2020-01-07,2,NSH,2.0,6.0,BOS,21,12,10,0,43,24,11,5,5,45,21,12,10,0,43,22,11,5,4,42,0,1,35,36,0.442857,0.557143,13,21
2019020672,2020-01-07,2,CHI,1.0,2.0,CGY,28,7,11,1,47,21,12,15,2,50,28,7,11,1,47,21,12,15,2,50,1,0,32,28,0.538462,0.461538,8,4
2019020673,2020-01-07,2,VGK,3.0,4.0,PIT,26,18,14,2,60,12,8,6,3,29,26,18,14,2,60,12,8,6,3,29,0,1,34,16,0.47619,0.52381,4,6
2019020674,2020-01-07,2,ANA,3.0,4.0,CBJ,35,7,11,3,56,19,5,6,3,33,35,7,11,3,56,18,5,6,3,32,1,0,40,27,0.645833,0.354167,6,4
2019020675,2020-01-08,2,TOR,3.0,4.0,WPG,25,14,8,5,52,24,13,12,5,54,21,13,6,3,43,18,11,9,2,40,0,1,28,28,0.486486,0.513514,4,6
2019020676,2020-01-08,2,PHI,3.0,2.0,WSH,23,10,8,2,43,20,7,9,2,38,23,10,8,2,43,20,7,9,2,38,1,0,27,28,0.705882,0.294118,10,14
2019020677,2020-01-08,2,L.A,1.0,2.0,DAL,28,9,8,1,46,27,5,12,1,45,28,9,8,1,46,27,5,12,1,45,1,0,31,32,0.563636,0.436364,4,4
2019020678,2020-01-09,2,BOS,5.0,4.0,WPG,25,6,6,4,41,17,5,5,2,29,25,6,6,4,41,17,5,5,2,29,0,1,36,21,0.566667,0.433333,4,8
2019020679,2020-01-09,2,MTL,2.0,4.0,EDM,31,9,14,2,56,20,10,9,3,42,31,9,14,2,56,20,10,9,3,42,1,0,37,26,0.483871,0.516129,4,4
2019020680,2020-01-09,2,T.B,4.0,0.0,ARI,27,11,12,4,54,24,7,6,0,37,27,11,12,4,54,24,7,6,0,37,1,0,34,25,0.644068,0.355932,6,4
2019020681,2020-01-09,2,FLA,5.0,2.0,VAN,36,4,12,4,56,24,9,7,2,42,35,4,11,4,54,24,9,7,2,42,1,0,49,32,0.558824,0.441176,6,18
2019020682,2020-01-09,2,NYR,6.0,3.0,N.J,26,12,14,4,56,36,9,16,2,63,24,12,14,4,54,35,9,16,2,62,1,0,37,49,0.542373,0.457627,6,12
2019020683,2020-01-09,2,STL,5.0,1.0,BUF,24,5,9,4,42,17,11,4,1,33,24,5,9,3,41,17,11,4,1,33,1,0,31,19,0.555556,0.444444,4,4
2019020684,2020-01-09,2,CHI,2.0,5.0,NSH,27,8,26,1,62,21,5,9,5,40,27,8,26,1,62,21,5,9,5,40,0,1,31,30,0.54717,0.45283,4,6
2019020685,2020-01-09,2,CGY,2.0,1.0,MIN,26,7,10,1,44,41,19,11,1,72,26,7,10,1,44,41,19,11,0,71,1,0,37,43,0.52459,0.47541,4,4
2019020686,2020-01-09,2,VGK,2.0,5.0,L.A,43,13,17,2,75,17,10,13,4,44,43,13,17,2,75,17,10,13,4,44,0,1,46,23,0.577465,0.422535,2,2
2019020687,2020-01-09,2,ANA,0.0,3.0,DAL,26,19,11,0,56,21,8,9,1,39,25,18,10,0,53,20,8,8,1,37,0,1,27,27,0.47541,0.52459,13,11
2019020688,2020-01-09,2,S.J,3.0,1.0,CBJ,26,11,12,2,51,27,6,19,1,53,26,11,12,2,51,27,6,18,1,52,1,0,33,31,0.557377,0.442623,9,11
2019020689,2020-01-10,2,DET,3.0,2.0,OTT,23,14,8,2,47,25,14,5,1,45,18,13,8,1,40,23,12,4,1,40,1,0,28,31,0.5,0.5,8,10
2019020690,2020-01-10,2,CAR,3.0,0.0,ARI,23,13,9,3,48,26,3,7,0,36,23,13,9,3,48,26,3,7,0,36,1,0,29,32,0.5,0.5,6,6
2019020691,2020-01-10,2,COL,3.0,4.0,PIT,23,13,15,2,53,23,5,12,4,44,23,12,15,2,52,22,5,11,3,41,1,0,31,30,0.589286,0.410714,4,6
2019020692,2020-01-11,2,BUF,3.0,6.0,VAN,22,8,9,2,41,25,10,5,6,46,22,8,9,2,41,25,10,5,6,46,1,0,28,35,0.473684,0.526316,4,6
2019020693,2020-01-11,2,OTT,1.0,2.0,MTL,30,8,10,1,49,22,18,12,1,53,26,8,9,1,44,15,18,12,0,45,0,1,42,25,0.538462,0.461538,10,10
2019020694,2020-01-11,2,NYI,2.0,3.0,BOS,34,14,16,2,66,26,12,16,2,56,34,13,16,2,65,25,12,16,2,55,1,0,37,33,0.54,0.46,4,2
2019020695,2020-01-11,2,PHI,0.0,1.0,T.B,16,9,13,0,38,25,9,18,1,53,16,9,13,0,38,25,9,18,1,53,0,1,23,28,0.411765,0.588235,8,6
2019020696,2020-01-11,2,WSH,1.0,5.0,N.J,28,9,13,0,50,14,8,13,4,39,28,9,13,0,50,14,8,13,4,39,0,1,34,22,0.448276,0.551724,2,10
2019020697,2020-01-11,2,CAR,2.0,0.0,L.A,25,14,10,2,51,35,16,14,0,65,25,14,10,2,51,35,16,14,0,65,1,0,30,41,0.54386,0.45614,4,4
2019020698,2020-01-11,2,STL,5.0,2.0,NYR,20,14,10,4,48,17,7,6,2,32,20,14,10,4,48,17,7,6,2,32,0,1,29,23,0.44,0.56,18,31
2019020699,2020-01-11,2,CHI,4.0,2.0,ANA,29,13,17,4,63,34,13,12,2,61,29,13,17,4,63,34,13,12,2,61,0,1,33,37,0.509434,0.490566,2,2
2019020700,2020-01-11,2,CGY,4.0,3.0,EDM,26,18,14,3,61,27,6,12,3,48,26,18,14,3,61,27,6,12,3,48,1,0,33,32,0.54717,0.45283,2,14
2019020701,2020-01-11,2,VGK,0.0,3.0,CBJ,24,14,10,0,48,15,7,11,2,35,24,14,10,0,48,15,7,11,2,35,0,1,27,22,0.56,0.44,4,6
2019020702,2020-01-11,2,S.J,2.0,1.0,DAL,23,14,14,2,53,23,8,12,0,43,23,14,14,2,53,23,8,12,0,43,0,1,26,28,0.480769,0.519231,4,4
2019020703,2020-01-12,2,WPG,0.0,1.0,NSH,24,15,17,0,56,28,9,13,1,51,24,15,17,0,56,27,9,13,1,50,0,1,28,32,0.54386,0.45614,2,4
2019020704,2020-01-12,2,MIN,1.0,4.0,VAN,16,12,14,1,43,17,7,11,3,38,14,11,14,1,40,16,7,9,3,35,0,1,24,30,0.403846,0.596154,16,10
2019020705,2020-01-12,2,DET,1.0,5.0,BUF,18,8,7,1,34,15,2,5,2,24,18,8,7,1,34,14,2,5,2,23,0,1,22,27,0.571429,0.428571,8,6
2019020706,2020-01-12,2,ARI,3.0,4.0,PIT,25,11,9,4,49,27,23,15,3,68,16,6,9,3,34,19,22,15,1,57,0,1,27,34,0.566038,0.433962,10,10
2019020707,2020-01-12,2,FLA,8.0,4.0,TOR,19,8,4,6,37,37,10,13,4,64,18,8,4,6,36,37,10,13,4,64,1,0,29,47,0.464789,0.535211,6,4
2019020708,2020-01-12,2,N.J,3.0,1.0,T.B,7,5,9,3,24,23,16,11,1,51,7,5,9,3,24,22,16,11,1,50,0,1,20,27,0.607843,0.392157,9,13
2019020709,2020-01-13,2,MTL,2.0,0.0,CGY,26,10,20,2,58,27,10,16,0,53,26,10,20,2,58,27,10,16,0,53,1,0,37,31,0.590909,0.409091,4,6
2019020710,2020-01-13,2,NYR,6.0,2.0,NYI,27,12,14,5,58,29,8,18,1,56,27,12,14,5,58,29,8,18,1,56,0,1,36,34,0.522727,0.477273,50,38
2019020711,2020-01-13,2,PHI,6.0,5.0,BOS,31,14,17,5,67,29,11,8,4,52,20,12,12,3,47,22,7,5,4,38,0,1,39,31,0.409091,0.590909,8,10
2019020712,2020-01-13,2,WSH,2.0,0.0,CAR,27,9,9,1,46,15,7,12,0,34,27,9,9,1,46,15,7,12,0,34,1,0,30,23,0.548387,0.451613,6,12
2019020713,2020-01-13,2,STL,4.0,1.0,ANA,30,6,10,3,49,16,1,6,1,24,28,6,10,3,47,14,1,6,1,22,1,0,34,21,0.568627,0.431373,6,4
2019020714,2020-01-14,2,BUF,4.0,2.0,VGK,21,6,5,2,34,21,11,16,1,49,21,5,5,2,33,20,11,16,1,48,0,1,26,26,0.538462,0.461538,8,8
2019020715,2020-01-14,2,TOR,7.0,4.0,N.J,19,9,7,5,40,20,14,13,3,50,19,9,7,5,40,19,14,13,3,49,1,0,34,29,0.590909,0.409091,10,10
2019020716,2020-01-14,2,T.B,4.0,3.0,L.A,30,9,10,5,54,34,7,9,3,53,26,8,9,3,46,29,7,9,2,47,0,1,38,41,0.515152,0.484848,6,4
2019020717,2020-01-14,2,NYI,8.0,2.0,DET,16,3,5,8,32,31,12,11,2,56,14,3,4,8,29,31,12,11,2,56,1,0,26,36,0.510638,0.489362,6,4
2019020718,2020-01-14,2,PIT,7.0,3.0,MIN,19,8,2,5,34,21,5,6,2,34,19,8,2,5,34,21,5,6,2,34,1,0,29,29,0.534483,0.465517,4,8
2019020719,2020-01-14,2,CBJ,3.0,0.0,BOS,21,5,7,2,35,28,10,15,0,53,21,5,7,2,35,26,10,15,0,51,1,0,27,34,0.44898,0.55102,10,6
2019020720,2020-01-14,2,OTT,2.0,3.0,CHI,16,4,12,2,34,24,12,18,3,57,16,4,12,2,34,24,12,18,2,56,1,0,22,30,0.436364,0.563636,2,4
2019020721,2020-01-14,2,WPG,4.0,0.0,VAN,17,9,6,3,35,31,17,11,0,59,17,9,6,3,35,31,17,11,0,59,1,0,25,41,0.539683,0.460317,8,6
2019020722,2020-01-14,2,COL,2.0,3.0,DAL,39,7,19,2,67,25,11,12,2,50,35,7,18,2,62,24,9,11,1,45,1,0,43,30,0.457627,0.542373,11,9
2019020723,2020-01-14,2,EDM,4.0,2.0,NSH,24,12,15,2,53,25,11,12,2,50,21,10,15,2,48,24,11,12,2,49,1,0,32,32,0.403226,0.596774,6,8
2019020724,2020-01-14,2,ARI,6.0,3.0,S.J,31,9,11,5,56,21,14,19,2,56,31,9,11,5,56,21,14,19,2,56,1,0,40,28,0.446429,0.553571,6,4
2019020725,2020-01-15,2,MTL,1.0,4.0,CHI,27,13,18,1,59,15,13,8,2,38,27,13,18,1,59,15,13,8,2,38,0,1,33,28,0.540984,0.459016,6,6
2019020726,2020-01-15,2,STL,3.0,4.0,PHI,25,8,8,2,43,17,14,9,3,43,24,8,6,2,40,15,11,9,2,37,1,0,33,25,0.508197,0.491803,6,14
2019020727,2020-01-16,2,BOS,4.0,1.0,PIT,19,8,10,4,41,21,9,9,1,40,17,7,9,4,37,19,8,9,1,37,0,1,30,30,0.534483,0.465517,15,17
2019020728,2020-01-16,2,TOR,1.0,2.0,CGY,33,10,18,0,61,27,10,10,2,49,26,9,18,0,53,22,10,8,1,41,0,1,36,32,0.541667,0.458333,4,8
2019020729,2020-01-16,2,FLA,4.0,3.0,L.A,19,8,10,2,39,21,10,12,1,44,19,8,10,2,39,21,10,12,1,44,1,0,26,30,0.5,0.5,8,6
2019020730,2020-01-16,2,NYI,2.0,3.0,NYR,29,9,7,2,47,19,7,13,1,40,29,8,7,1,45,18,7,13,1,39,1,0,40,28,0.606557,0.393443,12,12
2019020731,2020-01-16,2,PHI,1.0,4.0,MTL,29,9,4,1,43,33,5,7,3,48,29,9,4,1,43,33,5,7,3,48,1,0,41,40,0.47619,0.52381,11,23
2019020732,2020-01-16,2,WSH,5.0,2.0,N.J,27,7,16,4,54,24,11,8,1,44,26,7,16,4,53,23,11,7,1,42,1,0,38,34,0.588235,0.411765,8,10
2019020733,2020-01-16,2,CBJ,3.0,2.0,CAR,15,4,7,3,29,30,11,24,2,67,15,4,7,3,29,30,11,23,2,66,1,0,18,34,0.480769,0.519231,2,4
2019020734,2020-01-16,2,OTT,2.0,4.0,VGK,27,9,7,1,44,36,8,14,3,61,27,9,7,1,44,36,8,14,3,61,0,1,35,43,0.5,0.5,2,8
2019020735,2020-01-16,2,NSH,2.0,4.0,ANA,33,11,11,1,56,21,10,9,2,42,33,11,11,1,56,22,10,9,2,43,0,1,35,27,0.387097,0.612903,4,2
2019020736,2020-01-16,2,MIN,3.0,2.0,T.B,13,11,6,2,32,14,14,12,1,41,13,11,6,2,32,14,14,12,1,41,1,0,23,20,0.363636,0.636364,4,8
2019020737,2020-01-16,2,DAL,1.0,4.0,BUF,26,13,13,1,53,15,11,12,3,41,25,13,13,1,52,15,11,12,3,41,0,1,29,22,0.52381,0.47619,4,8
2019020738,2020-01-16,2,COL,4.0,0.0,S.J,29,5,12,3,49,23,8,10,0,41,27,5,11,3,46,22,6,10,0,38,1,0,38,27,0.62069,0.37931,18,20
2019020739,2020-01-16,2,VAN,3.0,1.0,ARI,22,8,13,2,45,31,11,9,1,52,22,8,13,2,45,31,11,9,1,52,0,1,25,35,0.510638,0.489362,4,4
2019020740,2020-01-17,2,DET,1.0,2.0,PIT,25,3,5,0,33,31,11,17,0,59,25,3,5,0,33,29,11,17,0,57,1,0,29,37,0.46,0.54,8,8
2019020741,2020-01-17,2,CAR,1.0,2.0,ANA,20,8,16,1,45,31,12,13,2,58,19,8,16,1,44,31,12,13,1,57,1,0,26,37,0.606557,0.393443,4,4
2019020742,2020-01-17,2,WPG,1.0,7.0,T.B,26,14,14,1,55,15,12,14,7,48,26,14,14,1,55,17,12,14,7,50,0,1,31,26,0.472727,0.527273,2,4
2019020743,2020-01-18,2,NYI,4.0,6.0,WSH,22,3,7,3,35,18,10,18,6,52,21,3,7,3,34,17,10,18,6,51,0,1,29,30,0.4375,0.5625,10,10
2019020744,2020-01-18,2,COL,5.0,3.0,STL,13,6,9,5,33,17,11,10,2,40,13,6,9,5,33,17,11,10,2,40,1,0,18,24,0.458333,0.541667,8,8
2019020745,2020-01-18,2,EDM,7.0,3.0,ARI,17,9,10,5,41,23,6,11,1,41,16,9,10,5,40,23,6,11,1,41,1,0,27,30,0.564516,0.435484,8,8
2019020746,2020-01-18,2,OTT,5.0,2.0,CGY,12,5,6,4,27,33,15,20,2,70,12,5,6,4,27,33,15,20,2,70,1,0,21,42,0.6,0.4,6,2
2019020747,2020-01-18,2,TOR,2.0,6.0,CHI,30,15,13,1,59,27,10,10,6,53,30,15,13,1,59,27,10,10,6,53,0,1,33,34,0.608696,0.391304,2,4
2019020748,2020-01-18,2,MTL,5.0,4.0,VGK,28,10,8,6,52,29,11,17,5,62,20,8,8,4,40,25,10,17,4,56,1,0,32,34,0.508772,0.491228,4,2
2019020749,2020-01-18,2,DET,1.0,4.0,FLA,13,7,9,1,30,23,8,10,3,44,11,7,9,1,28,18,8,10,3,39,0,1,28,38,0.587302,0.412698,27,19
2019020750,2020-01-18,2,PHI,4.0,1.0,L.A,19,6,8,2,35,31,14,13,1,59,19,6,8,2,35,31,14,13,1,59,1,0,26,35,0.467742,0.532258,4,4
2019020751,2020-01-18,2,CBJ,5.0,0.0,N.J,23,9,8,5,45,36,8,15,0,59,21,9,8,5,43,36,8,14,0,58,1,0,31,41,0.462963,0.537037,18,16
2019020752,2020-01-18,2,NSH,2.0,1.0,BUF,29,13,12,1,55,24,6,11,1,42,29,13,12,1,55,24,6,11,1,42,0,1,37,31,0.592593,0.407407,6,6
2019020753,2020-01-18,2,MIN,7.0,0.0,DAL,22,7,9,4,42,22,13,13,0,48,21,7,8,4,40,19,11,13,0,43,1,0,32,27,0.310345,0.689655,18,22
2019020754,2020-01-18,2,VAN,4.0,1.0,S.J,24,9,12,3,48,16,13,12,1,42,24,9,12,3,48,16,13,12,1,42,1,0,39,18,0.62,0.38,38,36
2019020755,2020-01-19,2,PIT,4.0,3.0,BOS,14,11,7,3,35,30,12,20,3,65,14,11,7,3,35,30,12,20,3,65,0,1,22,38,0.421875,0.578125,6,6
2019020756,2020-01-19,2,CAR,2.0,1.0,NYI,28,13,16,4,61,21,22,13,3,59,23,10,16,1,50,17,16,13,1,47,1,0,32,27,0.48,0.52,6,4
2019020757,2020-01-19,2,NYR,1.0,2.0,CBJ,30,16,14,1,61,27,9,14,2,52,30,16,14,1,61,27,9,14,2,52,1,0,32,31,0.409091,0.590909,2,0
2019020758,2020-01-19,2,CHI,5.0,2.0,WPG,20,4,14,5,43,23,9,20,2,54,19,4,13,5,41,23,8,19,2,52,1,0,33,38,0.470588,0.529412,12,6
2019020759,2020-01-20,2,COL,6.0,3.0,DET,29,9,12,5,55,16,5,11,3,35,29,9,12,5,55,16,5,11,3,35,0,1,46,25,0.578125,0.421875,4,10
2019020760,2020-01-20,2,MIN,4.0,5.0,FLA,23,10,12,1,46,17,9,5,4,35,23,10,12,1,46,17,9,5,4,35,0,1,33,25,0.525424,0.474576,4,8
2019020761,2020-01-21,2,BOS,3.0,2.0,VGK,30,7,4,3,44,24,6,5,1,36,30,7,4,3,44,24,6,5,1,36,0,1,37,29,0.54902,0.45098,4,10
2019020762,2020-01-21,2,NYR,2.0,4.0,NYI,31,10,11,0,52,12,9,10,2,33,31,10,11,0,52,12,9,10,2,33,0,1,42,18,0.351852,0.648148,4,10
2019020763,2020-01-21,2,PHI,3.0,0.0,PIT,23,12,10,3,48,16,14,10,0,40,23,12,10,3,48,16,14,10,0,40,1,0,30,19,0.48,0.52,6,6
2019020764,2020-01-21,2,CAR,4.0,1.0,WPG,18,9,6,3,36,14,9,13,1,37,16,9,6,3,34,14,8,13,1,36,1,0,29,17,0.54902,0.45098,17,21
2019020765,2020-01-21,2,CHI,3.0,4.0,FLA,24,7,10,2,43,22,5,17,3,47,24,7,10,2,43,22,5,17,3,47,0,1,35,26,0.492308,0.507692,6,8
2019020766,2020-01-22,2,CBJ,4.0,3.0,WPG,24,15,14,3,56,25,10,17,2,54,24,15,14,3,56,25,10,17,2,54,0,1,29,30,0.584615,0.415385,4,2
2019020767,2020-01-22,2,MIN,4.0,2.0,DET,29,17,11,4,61,22,7,13,1,43,29,17,11,4,61,22,7,13,1,43,0,1,33,27,0.5,0.5,4,0
2019020768,2020-01-27,2,MTL,2.0,4.0,WSH,28,10,10,2,50,29,5,15,3,52,28,10,10,2,50,29,6,15,3,53,1,0,33,40,0.557377,0.442623,6,6
2019020769,2020-01-27,2,OTT,3.0,4.0,N.J,35,15,29,0,79,39,15,11,4,69,30,15,26,0,71,35,14,11,2,62,0,1,38,53,0.480519,0.519481,15,9
2019020770,2020-01-27,2,NSH,2.0,5.0,TOR,33,16,13,2,64,25,9,10,5,49,33,15,13,2,63,25,9,10,5,49,0,1,36,31,0.5,0.5,4,2
2019020771,2020-01-27,2,DAL,3.0,2.0,T.B,29,11,15,3,58,17,9,17,2,45,23,10,15,2,50,17,9,16,2,44,0,1,35,25,0.54902,0.45098,8,8
2019020772,2020-01-27,2,VAN,3.0,1.0,STL,18,9,12,3,42,29,12,18,1,60,18,9,12,3,42,29,12,17,1,59,0,1,26,37,0.614035,0.385965,6,6
2019020773,2020-01-27,2,S.J,4.0,2.0,ANA,26,14,9,4,53,24,11,14,0,49,26,14,9,4,53,24,11,14,0,49,1,0,31,28,0.444444,0.555556,9,7
2019020774,2020-01-28,2,BUF,2.0,5.0,OTT,21,5,8,1,35,25,9,5,1,40,21,5,8,1,35,25,9,5,1,40,0,1,30,39,0.542373,0.457627,8,8
2019020775,2020-01-28,2,CGY,4.0,5.0,STL,26,16,9,1,52,26,7,11,5,49,23,12,8,1,44,24,7,11,3,45,0,1,31,34,0.540984,0.459016,4,8
2019020776,2020-01-29,2,WSH,4.0,5.0,NSH,15,10,13,3,41,16,8,7,3,34,15,10,12,3,40,16,7,7,3,33,1,0,33,24,0.52381,0.47619,10,12
2019020777,2020-01-29,2,DAL,3.0,5.0,TOR,28,12,22,3,65,27,5,13,5,50,28,12,21,3,64,25,5,13,5,48,0,1,34,34,0.5,0.5,4,6
2019020778,2020-01-29,2,EDM,3.0,4.0,CGY,29,17,11,2,59,21,10,13,4,48,25,11,11,2,49,17,10,10,3,40,0,1,34,28,0.469697,0.530303,16,22
2019020779,2020-01-29,2,ANA,4.0,2.0,ARI,23,17,9,3,52,15,12,10,2,39,23,16,8,3,50,13,12,10,2,37,1,0,32,27,0.466667,0.533333,10,8
2019020780,2020-01-29,2,L.A,2.0,4.0,T.B,32,13,17,1,63,14,14,8,4,40,32,13,17,1,63,14,14,8,4,40,1,0,34,24,0.47619,0.52381,4,2
2019020781,2020-01-29,2,S.J,2.0,5.0,VAN,36,7,15,2,60,18,8,7,4,37,36,7,15,2,60,18,8,7,4,37,1,0,40,25,0.344828,0.655172,6,4
2019020782,2020-01-30,2,BUF,1.0,3.0,MTL,18,13,7,0,38,27,9,10,3,49,18,13,7,0,38,27,9,10,3,49,1,0,21,30,0.542373,0.457627,2,6
2019020783,2020-01-30,2,N.J,5.0,6.0,NSH,27,11,15,3,56,24,7,12,6,49,22,10,14,2,48,16,5,12,4,37,0,1,32,30,0.459016,0.540984,6,6
2019020784,2020-01-30,2,ARI,2.0,3.0,L.A,22,13,14,2,51,29,11,14,2,56,20,13,13,2,48,28,10,14,1,53,0,1,28,37,0.592593,0.407407,4,6
2019020785,2020-01-31,2,NYR,4.0,2.0,DET,31,15,19,3,68,23,8,17,2,50,31,15,19,3,68,23,8,17,2,50,1,0,39,25,0.358491,0.641509,0,6
2019020786,2020-01-31,2,PIT,4.0,3.0,PHI,14,6,8,2,30,25,9,12,2,48,14,5,8,1,28,25,9,12,2,48,0,1,20,30,0.46,0.54,6,4
2019020787,2020-01-31,2,OTT,3.0,5.0,WSH,25,7,17,1,50,24,11,5,3,43,25,7,17,1,50,24,11,5,3,43,0,1,28,37,0.534483,0.465517,10,6
2019020788,2020-01-31,2,CAR,3.0,4.0,VGK,20,8,15,2,45,28,7,7,3,45,20,8,15,2,45,28,7,7,3,45,0,1,25,37,0.466667,0.533333,6,4
2019020789,2020-01-31,2,WPG,1.0,2.0,BOS,25,12,10,1,48,19,6,3,0,28,25,12,10,1,48,19,6,3,0,28,1,0,38,25,0.528302,0.471698,35,39
2019020790,2020-01-31,2,EDM,4.0,2.0,STL,29,11,23,3,66,25,13,14,2,54,29,11,23,3,66,25,13,14,2,54,1,0,35,32,0.537313,0.462687,6,2
2019020791,2020-01-31,2,ANA,3.0,4.0,T.B,17,23,17,3,60,16,10,15,4,45,17,23,17,3,60,15,10,12,4,41,0,1,26,22,0.545455,0.454545,6,6
2019020792,2020-02-01,2,BUF,2.0,1.0,CBJ,22,10,6,2,40,17,11,10,1,39,22,10,6,1,39,17,11,10,1,39,1,0,24,23,0.5,0.5,4,0
2019020793,2020-02-01,2,NYI,3.0,4.0,VAN,32,9,22,3,66,20,10,11,4,45,31,9,22,3,65,19,10,11,3,43,0,1,37,24,0.46,0.54,2,6
2019020794,2020-02-01,2,MTL,4.0,0.0,FLA,24,11,21,3,59,15,5,7,0,27,24,11,21,3,59,15,5,7,0,27,1,0,35,29,0.649123,0.350877,12,4
2019020795,2020-02-01,2,TOR,2.0,1.0,OTT,30,14,18,0,62,19,10,8,1,38,30,14,17,0,61,19,8,8,1,36,0,1,36,25,0.574468,0.425532,6,6
2019020796,2020-02-01,2,DET,0.0,1.0,NYR,30,9,4,0,43,24,8,6,0,38,27,9,4,0,40,23,8,6,0,37,0,1,33,31,0.311111,0.688889,6,6
2019020797,2020-02-01,2,N.J,2.0,3.0,DAL,25,8,8,1,42,26,14,11,3,54,24,8,8,1,41,23,12,11,2,48,1,0,31,31,0.403509,0.596491,4,6
2019020798,2020-02-01,2,PHI,6.0,3.0,COL,14,10,13,4,41,23,16,6,2,47,14,9,13,4,40,23,15,6,2,46,1,0,28,31,0.550725,0.449275,8,12
2019020799,2020-02-01,2,WPG,5.0,2.0,STL,23,13,12,5,53,35,14,10,2,61,23,13,12,5,53,32,12,10,2,56,1,0,33,40,0.440678,0.559322,6,6
2019020800,2020-02-01,2,NSH,0.0,3.0,VGK,14,5,8,0,27,22,16,14,3,55,14,5,8,0,27,22,16,14,3,55,0,1,19,39,0.481481,0.518519,8,10
2019020801,2020-02-01,2,MIN,1.0,6.0,BOS,19,10,10,1,40,21,10,12,3,46,19,10,10,1,40,21,10,12,3,46,0,1,26,34,0.459016,0.540984,10,10
2019020802,2020-02-01,2,ARI,2.0,3.0,CHI,38,7,13,2,60,35,6,12,4,57,32,7,13,2,54,31,5,11,2,49,0,1,42,44,0.5625,0.4375,6,6
2019020803,2020-02-01,2,CGY,3.0,8.0,EDM,20,9,5,3,37,34,9,8,7,58,20,9,5,3,37,33,9,6,5,53,0,1,26,49,0.614035,0.385965,57,45
2019020804,2020-02-01,2,L.A,1.0,3.0,ANA,44,21,11,0,76,23,10,5,3,41,44,21,11,0,76,23,10,5,3,41,0,1,47,28,0.41791,0.58209,7,9
2019020805,2020-02-01,2,S.J,0.0,3.0,T.B,26,10,11,0,47,28,14,22,3,67,26,10,11,0,47,28,14,22,3,67,0,1,30,35,0.538462,0.461538,10,8
2019020806,2020-02-02,2,WSH,3.0,4.0,PIT,27,18,18,3,66,19,2,4,4,29,26,18,17,3,64,17,1,4,4,26,1,0,32,33,0.46875,0.53125,16,10
2019020807,2020-02-02,2,MTL,3.0,4.0,CBJ,27,17,23,3,70,17,6,12,4,39,27,15,22,3,67,16,6,12,4,38,0,1,30,27,0.425532,0.574468,6,6
2019020808,2020-02-02,2,CAR,4.0,3.0,VAN,28,11,13,5,57,27,12,9,4,52,25,10,11,3,49,24,10,9,3,46,0,1,32,35,0.529412,0.470588,8,2
2019020809,2020-02-03,2,TOR,3.0,5.0,FLA,26,9,9,2,46,11,10,10,4,35,26,9,9,2,46,11,10,10,4,35,0,1,34,21,0.557692,0.442308,4,6
2019020810,2020-02-03,2,NYR,3.0,5.0,DAL,29,6,15,0,50,13,12,9,3,37,26,6,13,0,45,13,10,9,3,35,1,0,36,21,0.537037,0.462963,12,10
2019020811,2020-02-03,2,DET,0.0,3.0,PHI,12,7,6,0,25,27,17,12,1,57,12,7,6,0,25,27,17,12,1,57,0,1,16,31,0.462963,0.537037,4,4
2019020812,2020-02-04,2,BOS,4.0,0.0,VAN,26,8,9,3,46,24,6,7,0,37,26,8,9,2,45,22,6,7,0,35,1,0,42,25,0.457627,0.542373,6,22
2019020813,2020-02-04,2,BUF,1.0,6.0,COL,19,11,11,1,42,21,13,13,6,53,19,11,11,1,42,21,13,13,6,53,0,1,24,27,0.425926,0.574074,0,4
2019020814,2020-02-04,2,T.B,4.0,2.0,VGK,11,6,11,4,32,26,11,10,2,49,11,5,11,4,31,24,11,10,2,47,1,0,18,29,0.59375,0.40625,8,4
2019020815,2020-02-04,2,N.J,4.0,5.0,MTL,17,8,5,2,32,28,8,21,4,61,13,5,5,1,24,20,7,21,3,51,1,0,24,36,0.465753,0.534247,14,20
2019020816,2020-02-04,2,NYI,4.0,3.0,DAL,25,6,9,3,43,24,7,12,2,45,24,6,8,2,40,23,6,12,2,43,1,0,41,31,0.520833,0.479167,6,10
2019020817,2020-02-04,2,WSH,4.0,2.0,L.A,20,7,6,4,37,28,13,11,2,54,20,7,6,4,37,28,13,11,2,54,0,1,24,31,0.438596,0.561404,4,2
2019020818,2020-02-04,2,CBJ,1.0,0.0,FLA,38,9,13,1,61,30,9,13,0,52,37,9,13,0,59,29,8,13,0,50,0,0,45,32,0.45,0.55,4,2
2019020819,2020-02-04,2,OTT,2.0,3.0,ANA,25,8,6,0,39,22,8,19,4,53,20,7,5,0,32,19,6,19,2,46,0,1,32,28,0.625,0.375,6,10
2019020820,2020-02-04,2,STL,6.0,3.0,CAR,17,6,3,4,30,20,7,8,2,37,17,5,3,4,29,20,7,8,2,37,1,0,26,28,0.6,0.4,10,10
2019020821,2020-02-04,2,MIN,3.0,2.0,CHI,29,17,8,2,56,23,10,12,2,47,25,16,7,1,49,22,9,12,2,45,1,0,34,29,0.559322,0.440678,6,4
2019020822,2020-02-04,2,WPG,1.0,2.0,NSH,27,11,13,1,52,28,10,9,2,49,26,10,13,1,50,27,10,9,1,47,1,0,34,36,0.52459,0.47541,4,6
2019020823,2020-02-04,2,CGY,1.0,3.0,S.J,27,7,15,0,49,22,9,11,3,45,27,7,15,0,49,22,9,11,3,45,1,0,31,26,0.574074,0.425926,7,9
2019020824,2020-02-04,2,ARI,3.0,0.0,EDM,19,14,14,2,49,25,12,17,0,54,19,14,14,2,49,23,12,16,0,51,1,0,27,30,0.4375,0.5625,8,8
2019020825,2020-02-05,2,NYR,5.0,3.0,TOR,27,11,7,5,50,27,13,20,2,62,27,11,7,5,50,27,13,19,2,61,0,1,35,30,0.5,0.5,11,11
2019020826,2020-02-05,2,CHI,1.0,2.0,BOS,18,12,10,0,40,31,9,18,2,60,16,11,10,0,37,30,9,17,1,57,1,0,22,40,0.516667,0.483333,18,10
2019020827,2020-02-06,2,BUF,3.0,4.0,DET,26,12,10,3,51,11,5,3,4,23,19,10,9,3,41,10,4,2,1,17,0,1,32,21,0.566038,0.433962,10,10
2019020828,2020-02-06,2,MTL,3.0,2.0,ANA,18,8,15,2,43,27,9,8,2,46,18,8,15,1,42,27,9,8,2,46,1,0,27,37,0.462963,0.537037,4,10
2019020829,2020-02-06,2,T.B,4.0,2.0,PIT,20,11,11,4,46,23,7,10,2,42,20,11,11,4,46,18,5,9,1,33,1,0,29,31,0.486486,0.513514,12,10
2019020830,2020-02-06,2,FLA,2.0,7.0,VGK,17,2,7,1,27,29,8,10,5,52,14,2,7,1,24,26,8,10,5,49,0,1,25,39,0.534483,0.465517,12,8
2019020831,2020-02-06,2,NYI,5.0,3.0,L.A,27,8,13,5,53,21,13,20,3,57,27,8,12,5,52,21,13,20,3,57,0,1,33,25,0.537037,0.462963,11,9
2019020832,2020-02-06,2,PHI,0.0,5.0,N.J,35,10,15,0,60,8,2,8,3,21,35,10,15,0,60,8,2,8,3,21,0,1,46,19,0.679245,0.320755,6,8
2019020833,2020-02-06,2,OTT,1.0,4.0,COL,23,15,13,1,52,27,7,9,3,46,23,15,13,1,52,27,7,9,3,46,0,1,26,34,0.446154,0.553846,2,4
2019020834,2020-02-06,2,STL,2.0,4.0,WPG,27,13,7,1,48,18,9,15,4,46,27,12,7,1,47,18,9,15,4,46,0,1,37,25,0.583333,0.416667,2,6
2019020835,2020-02-06,2,MIN,4.0,2.0,VAN,26,12,12,2,52,21,12,18,0,51,26,12,12,2,52,21,12,18,0,51,1,0,37,26,0.438596,0.561404,18,28
2019020836,2020-02-06,2,CGY,2.0,3.0,NSH,33,7,24,2,66,29,11,16,2,58,31,7,24,2,64,29,11,16,2,58,1,0,39,35,0.464286,0.535714,2,4
2019020837,2020-02-06,2,EDM,3.0,6.0,S.J,26,10,12,3,51,21,9,11,5,46,26,10,12,3,51,22,10,11,5,48,1,0,31,31,0.586957,0.413043,8,4
2019020838,2020-02-06,2,ARI,3.0,5.0,CAR,22,8,11,2,43,24,9,11,5,49,22,8,11,2,43,24,9,11,5,49,1,0,33,31,0.551724,0.448276,4,10
2019020839,2020-02-07,2,TOR,5.0,4.0,ANA,26,11,10,3,50,22,10,17,2,51,23,11,8,3,45,22,10,17,2,51,1,0,35,30,0.53125,0.46875,8,12
2019020840,2020-02-07,2,NYR,2.0,3.0,BUF,34,10,16,1,61,22,13,16,3,54,34,10,16,1,61,21,13,16,3,53,0,1,39,28,0.530612,0.469388,2,4
2019020841,2020-02-07,2,CBJ,2.0,0.0,DET,36,9,10,2,57,14,10,7,0,31,35,9,10,2,56,14,10,7,0,31,1,0,44,16,0.5,0.5,4,8
2019020842,2020-02-07,2,DAL,2.0,3.0,MIN,21,9,15,1,46,21,9,14,3,47,20,9,12,1,42,21,8,14,3,46,1,0,33,31,0.470588,0.529412,8,14
2019020843,2020-02-08,2,WPG,5.0,2.0,OTT,26,12,8,2,48,23,20,13,2,58,26,12,8,2,48,23,20,13,2,58,1,0,34,27,0.42,0.58,16,18
2019020844,2020-02-08,2,BOS,4.0,2.0,ARI,24,11,11,2,48,20,14,11,1,46,24,11,11,2,48,20,14,11,1,46,0,1,33,31,0.518519,0.481481,14,8
2019020845,2020-02-08,2,MTL,2.0,1.0,TOR,27,7,17,2,53,19,10,15,1,45,25,7,17,1,50,18,10,15,1,44,0,1,30,23,0.533333,0.466667,4,4
2019020846,2020-02-08,2,T.B,3.0,1.0,NYI,25,9,9,3,46,16,12,16,0,44,24,9,9,3,45,16,12,16,0,44,1,0,30,18,0.52,0.48,4,4
2019020847,2020-02-08,2,FLA,2.0,3.0,PIT,30,15,8,2,55,14,8,8,2,32,30,15,8,2,55,14,8,8,2,32,0,1,35,22,0.61194,0.38806,2,6
2019020848,2020-02-08,2,N.J,3.0,0.0,L.A,24,15,5,2,46,29,14,14,0,57,24,14,5,2,45,29,14,14,0,57,1,0,34,37,0.42,0.58,6,8
2019020849,2020-02-08,2,WSH,2.0,7.0,PHI,24,8,7,1,40,16,8,8,5,37,24,8,7,1,40,16,8,8,5,37,0,1,27,26,0.269841,0.730159,17,15
2019020850,2020-02-08,2,CBJ,1.0,2.0,COL,27,9,11,0,47,19,10,13,2,44,27,7,11,0,45,17,9,13,2,41,1,0,32,22,0.470588,0.529412,6,12
2019020851,2020-02-08,2,EDM,3.0,2.0,NSH,28,10,10,1,49,21,13,18,2,54,28,10,10,1,49,21,12,14,2,49,0,1,36,29,0.631579,0.368421,8,10
2019020852,2020-02-08,2,STL,2.0,3.0,DAL,17,7,7,1,32,19,9,9,2,39,16,7,7,1,31,19,9,7,1,36,1,0,25,34,0.57377,0.42623,8,6
2019020853,2020-02-08,2,VAN,2.0,6.0,CGY,19,18,15,2,54,24,12,11,5,52,19,15,13,2,49,22,12,10,5,49,1,0,27,32,0.5,0.5,11,15
2019020854,2020-02-08,2,VGK,5.0,6.0,CAR,31,17,13,4,65,27,9,12,5,53,27,15,12,4,58,25,6,12,3,46,1,0,38,34,0.528571,0.471429,8,4
2019020855,2020-02-09,2,DET,3.0,1.0,BOS,16,10,10,2,38,29,14,11,1,55,16,10,10,2,38,29,14,11,1,55,1,0,20,40,0.45098,0.54902,8,6
2019020856,2020-02-09,2,BUF,2.0,3.0,ANA,29,11,13,1,54,22,8,4,3,37,29,11,13,1,54,21,8,4,3,36,0,1,33,28,0.5,0.5,2,4
2019020857,2020-02-09,2,NYR,4.0,1.0,L.A,35,9,10,4,58,38,17,19,1,75,35,9,10,4,58,38,17,19,1,75,1,0,41,43,0.444444,0.555556,4,2
2019020858,2020-02-09,2,WPG,5.0,2.0,CHI,23,9,13,3,48,21,19,10,2,52,21,9,13,3,46,20,19,10,2,51,0,1,36,26,0.415094,0.584906,11,17
2019020859,2020-02-09,2,MIN,2.0,3.0,COL,29,8,21,0,58,25,5,16,1,47,29,8,21,0,58,25,5,16,1,47,0,1,36,33,0.590164,0.409836,11,13
2019020860,2020-02-10,2,MTL,2.0,3.0,ARI,20,13,6,2,41,20,7,10,2,39,20,12,6,2,40,20,6,10,2,38,1,0,28,34,0.59322,0.40678,12,12
2019020861,2020-02-10,2,PHI,4.0,1.0,FLA,18,6,9,3,36,19,7,10,1,37,18,6,9,3,36,19,7,10,1,37,0,1,34,31,0.551724,0.448276,10,10
2019020862,2020-02-10,2,WSH,3.0,5.0,NYI,21,14,21,2,58,24,7,9,5,45,21,13,21,2,57,24,7,9,4,44,0,1,29,32,0.533333,0.466667,9,11
2019020863,2020-02-10,2,CBJ,1.0,2.0,T.B,27,9,9,1,46,24,9,10,2,45,26,7,9,1,43,24,8,10,0,42,0,1,32,30,0.54,0.46,10,10
2019020864,2020-02-10,2,VAN,6.0,2.0,NSH,21,5,8,4,38,30,12,8,1,51,21,5,8,4,38,30,12,8,1,51,1,0,32,38,0.560606,0.439394,37,33
2019020865,2020-02-10,2,S.J,2.0,6.0,CGY,30,11,12,1,54,26,8,6,3,43,29,11,12,1,53,26,8,6,3,43,0,1,36,37,0.607143,0.392857,24,4
2019020866,2020-02-11,2,BUF,3.0,2.0,DET,11,15,12,3,41,21,11,9,2,43,11,14,12,3,40,21,11,9,2,43,0,1,25,29,0.44898,0.55102,6,6
2019020867,2020-02-11,2,TOR,3.0,2.0,ARI,30,10,16,3,59,26,6,15,2,49,27,10,16,2,55,25,6,15,2,48,0,1,41,37,0.561404,0.438596,6,6
2019020868,2020-02-11,2,N.J,3.0,5.0,FLA,23,11,11,2,47,24,17,18,5,64,23,11,11,2,47,24,17,18,5,64,1,0,28,33,0.389831,0.610169,4,4
2019020869,2020-02-11,2,NYI,5.0,3.0,PHI,20,8,13,5,46,29,11,16,3,59,20,8,13,5,46,29,11,16,3,59,1,0,25,38,0.478261,0.521739,4,2
2019020870,2020-02-11,2,PIT,1.0,2.0,T.B,29,6,9,0,44,26,9,12,1,48,25,6,7,0,38,25,8,11,0,44,1,0,36,38,0.527273,0.472727,10,10
2019020871,2020-02-11,2,MIN,4.0,0.0,VGK,15,9,5,1,30,20,10,13,0,43,15,9,5,1,30,20,10,13,0,43,1,0,25,26,0.442623,0.557377,10,12
2019020872,2020-02-11,2,WPG,1.0,4.0,NYR,32,12,12,1,57,25,6,12,3,46,32,12,12,1,57,24,6,12,3,45,0,1,44,32,0.591837,0.408163,4,10
2019020873,2020-02-11,2,DAL,4.0,1.0,CAR,30,11,10,2,53,20,9,16,1,46,30,11,10,2,53,20,9,16,1,46,1,0,36,25,0.588235,0.411765,2,8
2019020874,2020-02-11,2,COL,3.0,0.0,OTT,28,14,7,2,51,28,10,12,0,50,27,14,7,2,50,28,10,12,0,50,1,0,36,34,0.519231,0.480769,4,10
2019020875,2020-02-11,2,EDM,5.0,3.0,CHI,21,4,8,3,36,28,9,10,2,49,21,4,8,3,36,28,9,10,2,49,1,0,31,41,0.52459,0.47541,6,6
2019020876,2020-03-11,2,ANA,2.0,4.0,STL,21,12,10,2,45,29,12,12,3,56,21,12,10,1,44,29,12,12,2,55,1,1,27,37,0.517857,0.482143,4,2
2019020877,2020-02-12,2,BOS,4.0,1.0,MTL,28,6,5,3,42,23,10,13,1,47,28,6,5,3,42,22,9,13,1,45,1,0,38,29,0.421053,0.578947,12,12
2019020878,2020-02-12,2,L.A,5.0,3.0,CGY,26,16,6,5,53,28,9,10,3,50,26,16,6,5,53,28,9,10,3,50,0,1,33,38,0.589041,0.410959,13,19
2019020879,2020-02-12,2,VAN,3.0,0.0,CHI,12,6,6,2,26,39,10,13,0,62,12,6,6,2,26,39,10,13,0,62,1,0,20,49,0.559322,0.440678,20,16
2019020880,2020-02-13,2,BUF,4.0,3.0,CBJ,21,4,11,3,39,27,5,13,3,48,19,4,10,2,35,25,4,12,3,44,0,1,27,31,0.5,0.5,4,4
2019020881,2020-02-13,2,TOR,2.0,3.0,DAL,26,22,18,1,67,14,10,4,2,30,24,19,16,1,60,12,10,3,2,27,0,1,31,19,0.555556,0.444444,13,9
2019020882,2020-02-13,2,T.B,3.0,1.0,EDM,34,7,10,2,53,28,7,7,1,43,34,7,10,2,53,27,7,7,1,42,1,0,37,30,0.559322,0.440678,4,0
2019020883,2020-02-13,2,FLA,2.0,6.0,PHI,24,4,12,2,42,19,5,7,5,36,24,4,12,2,42,19,5,7,5,36,0,1,28,28,0.393443,0.606557,8,4
2019020884,2020-02-13,2,N.J,4.0,1.0,DET,13,12,9,3,37,23,9,6,0,38,13,12,9,3,37,23,9,6,0,38,0,1,26,26,0.333333,0.666667,8,12
2019020885,2020-02-13,2,OTT,3.0,2.0,ARI,24,14,10,3,51,30,9,29,1,69,24,13,10,3,50,30,9,29,1,69,1,0,31,34,0.518519,0.481481,4,6
2019020886,2020-02-13,2,NSH,5.0,0.0,NYI,20,21,21,5,67,30,8,17,0,55,20,21,21,5,67,30,8,17,0,55,1,0,26,31,0.591837,0.408163,9,5
2019020887,2020-02-13,2,MIN,3.0,4.0,NYR,20,14,12,3,49,28,10,17,5,60,16,10,11,3,40,24,9,15,3,51,1,0,26,31,0.677966,0.322034,6,8
2019020888,2020-02-13,2,COL,2.0,3.0,WSH,27,2,15,1,45,26,7,16,1,50,27,2,15,1,45,26,7,16,1,50,1,0,34,38,0.614286,0.385714,10,8
2019020889,2020-02-13,2,VGK,6.0,5.0,STL,37,12,16,2,67,16,4,6,5,31,34,12,16,2,64,14,3,6,5,28,0,1,52,24,0.558824,0.441176,6,12
2019020890,2020-02-13,2,ANA,0.0,6.0,CGY,35,15,16,0,66,22,8,9,5,44,34,15,16,0,65,22,8,9,5,44,0,1,44,32,0.481481,0.518519,9,13
2019020891,2020-02-14,2,PIT,4.0,1.0,MTL,17,10,8,3,38,31,5,12,0,48,17,10,8,3,38,31,5,12,0,48,1,0,28,35,0.466667,0.533333,6,6
2019020892,2020-02-14,2,CBJ,1.0,3.0,NYR,30,14,10,1,55,22,8,12,3,45,30,14,10,1,55,22,8,12,3,45,0,1,37,28,0.490196,0.509804,6,4
2019020893,2020-02-14,2,WPG,2.0,3.0,S.J,17,8,15,1,41,25,8,4,3,40,16,8,14,1,39,24,8,4,3,39,0,1,32,35,0.528302,0.471698,8,10
2019020894,2020-02-14,2,CAR,5.0,2.0,N.J,23,13,16,5,57,23,7,4,2,36,23,13,16,5,57,23,7,4,2,36,1,0,30,37,0.5625,0.4375,8,4
2019020895,2020-02-15,2,BOS,4.0,1.0,DET,34,6,4,3,47,23,8,8,0,39,34,6,4,3,47,23,8,8,0,39,0,1,41,26,0.641509,0.358491,11,9
2019020896,2020-02-15,2,STL,3.0,4.0,NSH,17,8,9,2,36,16,7,7,3,33,17,7,9,2,35,16,7,6,3,32,0,1,26,27,0.530303,0.469697,20,20
2019020897,2020-02-15,2,T.B,5.0,3.0,PHI,12,10,10,5,37,23,6,3,1,33,11,10,10,5,36,22,6,3,1,32,1,0,24,33,0.602941,0.397059,24,14
2019020898,2020-02-15,2,FLA,1.0,4.0,EDM,27,9,14,1,51,22,12,6,4,44,27,9,14,1,51,22,12,6,4,44,0,1,34,29,0.581818,0.418182,12,16
2019020899,2020-02-15,2,MIN,0.0,2.0,S.J,36,12,17,0,65,15,8,11,2,36,36,12,16,0,64,15,8,11,2,36,0,1,39,21,0.517241,0.482759,6,6
2019020900,2020-02-15,2,MTL,3.0,4.0,DAL,29,6,16,3,54,19,9,19,3,50,26,6,16,3,51,18,8,18,2,46,1,0,32,26,0.396552,0.603448,4,0
2019020901,2020-02-15,2,OTT,2.0,4.0,TOR,23,17,16,2,58,21,4,12,4,41,23,16,16,2,57,20,3,11,4,38,0,1,27,31,0.5,0.5,4,8
2019020902,2020-02-15,2,COL,1.0,3.0,L.A,32,13,9,1,55,17,15,17,3,52,30,12,8,1,51,17,13,16,3,49,0,1,33,23,0.553571,0.446429,4,4
2019020903,2020-02-15,2,CGY,4.0,8.0,CHI,30,10,8,3,51,13,5,7,8,33,29,10,8,3,50,11,5,7,7,30,0,1,42,28,0.528302,0.471698,8,10
2019020904,2020-02-15,2,ARI,3.0,1.0,WSH,23,13,12,2,50,27,11,17,1,56,22,13,12,2,49,27,11,17,1,56,1,0,30,37,0.514706,0.485294,6,6
2019020905,2020-02-15,2,VGK,1.0,0.0,NYI,35,12,13,1,61,17,8,8,0,33,35,12,13,1,61,15,7,8,0,30,1,0,43,19,0.4375,0.5625,14,16
2019020906,2020-02-16,2,PIT,5.0,1.0,DET,29,10,8,4,51,27,5,5,1,38,29,10,8,4,51,27,5,5,1,38,0,1,35,28,0.488889,0.511111,0,4
2019020907,2020-02-16,2,NYR,1.0,3.0,BOS,21,13,11,0,45,21,9,14,2,46,21,13,11,0,45,21,9,14,2,46,0,1,26,34,0.448276,0.551724,4,10
2019020908,2020-02-16,2,CAR,3.0,4.0,EDM,20,12,9,3,44,17,8,13,3,41,15,11,9,3,38,17,8,11,2,38,1,0,31,24,0.592593,0.407407,8,8
2019020909,2020-02-16,2,VAN,1.0,5.0,ANA,34,14,16,0,64,18,6,11,3,38,34,14,16,0,64,18,6,11,3,38,0,1,38,28,0.689655,0.310345,8,20
2019020910,2020-02-16,2,OTT,4.0,3.0,DAL,40,14,13,3,70,36,9,9,3,57,38,13,13,2,66,34,9,9,3,55,0,1,46,39,0.455882,0.544118,2,6
2019020911,2020-02-16,2,N.J,4.0,3.0,CBJ,26,14,6,5,51,48,13,16,4,81,19,11,6,3,39,43,10,16,3,72,0,1,26,55,0.45614,0.54386,4,0
2019020912,2020-02-16,2,NSH,2.0,1.0,STL,19,11,8,2,40,34,13,15,1,63,19,11,8,2,40,33,13,15,1,62,1,0,24,39,0.673913,0.326087,6,6
2019020913,2020-02-16,2,BUF,5.0,2.0,TOR,27,16,12,4,59,19,8,10,2,39,27,16,12,4,59,19,8,10,2,39,1,0,36,22,0.596154,0.403846,2,6
2019020914,2020-02-16,2,WPG,3.0,2.0,CHI,35,14,16,3,68,31,15,12,2,60,35,14,16,3,68,31,15,12,2,60,0,1,38,33,0.509804,0.490196,0,0
2019020915,2020-02-17,2,CGY,6.0,4.0,ANA,31,17,8,6,62,21,11,2,4,38,31,17,7,6,61,21,11,2,4,38,0,1,43,30,0.5,0.5,4,8
2019020916,2020-02-17,2,ARI,2.0,1.0,NYI,28,13,14,2,57,23,17,20,1,61,28,13,14,2,57,23,17,20,1,61,1,0,32,29,0.625,0.375,6,4
2019020917,2020-02-17,2,S.J,3.0,5.0,FLA,25,7,16,2,50,18,11,12,5,46,25,7,15,2,49,17,11,12,5,45,0,1,32,28,0.65,0.35,8,8
2019020918,2020-02-17,2,VGK,3.0,2.0,WSH,22,7,8,3,40,24,15,15,1,55,23,7,8,3,41,24,15,15,1,55,1,0,29,27,0.625,0.375,6,4
2019020919,2020-02-17,2,COL,3.0,4.0,T.B,18,14,15,2,49,23,15,11,4,53,15,13,15,2,45,22,14,11,3,50,1,0,27,27,0.614035,0.385965,6,12
2019020920,2020-02-18,2,PHI,5.0,1.0,CBJ,10,7,18,4,39,24,8,15,0,47,10,7,18,4,39,24,8,15,0,47,1,0,15,29,0.535714,0.464286,6,2
2019020921,2020-02-18,2,PIT,5.0,2.0,TOR,19,7,5,2,33,27,9,8,2,46,19,7,5,2,33,27,9,8,2,46,1,0,24,36,0.438596,0.561404,8,6
2019020922,2020-02-18,2,OTT,7.0,4.0,BUF,31,11,11,3,56,21,18,9,3,51,31,11,11,3,56,21,18,9,3,51,0,1,40,27,0.590909,0.409091,8,4
2019020923,2020-02-18,2,DET,4.0,3.0,MTL,17,6,12,4,39,18,13,12,1,44,17,6,12,4,39,18,13,12,1,44,0,1,25,22,0.5625,0.4375,6,6
2019020924,2020-02-18,2,STL,3.0,0.0,N.J,33,5,11,3,52,13,6,10,0,29,32,5,10,3,50,12,5,10,0,27,1,0,39,17,0.431373,0.568627,8,8
2019020925,2020-02-18,2,NSH,1.0,4.0,CAR,19,7,9,1,36,26,20,17,3,66,19,7,9,1,36,26,20,17,3,66,0,1,29,30,0.576923,0.423077,6,8
2019020926,2020-02-18,2,WPG,6.0,3.0,L.A,21,9,4,6,40,27,15,7,3,52,21,9,4,6,40,27,15,7,3,52,0,1,35,34,0.527778,0.472222,4,4
2019020927,2020-02-19,2,CHI,3.0,6.0,NYR,31,6,17,3,57,29,7,11,5,52,31,6,17,3,57,29,7,11,5,52,0,1,40,41,0.571429,0.428571,8,6
2019020928,2020-02-19,2,DAL,3.0,2.0,ARI,25,8,20,1,54,32,8,13,1,54,24,8,19,1,52,30,8,12,1,51,1,0,33,41,0.465517,0.534483,19,6
2019020929,2020-02-19,2,EDM,1.0,2.0,BOS,15,6,8,0,29,18,9,11,2,40,15,6,8,0,29,17,8,11,1,37,0,1,29,34,0.618182,0.381818,14,12
2019020930,2020-02-19,2,COL,3.0,1.0,NYI,24,15,16,3,58,22,5,17,1,45,23,15,16,3,57,21,4,17,1,43,1,0,29,28,0.6,0.4,6,8
2019020931,2020-02-19,2,ANA,1.0,4.0,FLA,33,13,7,1,54,24,9,16,4,53,32,13,7,1,53,23,9,16,4,52,1,0,36,32,0.5,0.5,4,4
2019020932,2020-02-19,2,VAN,3.0,4.0,MIN,32,11,21,5,69,27,9,21,6,63,28,10,20,3,61,24,8,21,3,56,0,1,34,28,0.537037,0.462963,4,4
2019020933,2020-02-20,2,TOR,4.0,0.0,PIT,24,15,16,3,58,18,12,20,0,50,24,15,16,3,58,18,12,20,0,50,1,0,30,24,0.622642,0.377358,7,11
2019020934,2020-02-20,2,N.J,2.0,1.0,S.J,15,8,18,1,42,28,17,11,1,57,15,8,17,1,41,28,17,11,1,57,0,1,25,37,0.528302,0.471698,11,17
2019020935,2020-02-20,2,WSH,3.0,4.0,MTL,29,6,14,3,52,27,18,12,4,61,29,6,14,3,52,27,17,12,3,59,1,0,32,32,0.396552,0.603448,2,2
2019020936,2020-02-20,2,CBJ,3.0,4.0,PHI,24,7,15,3,49,29,14,15,3,61,21,7,15,3,46,26,14,14,2,56,1,0,31,33,0.461538,0.538462,4,8
2019020937,2020-02-20,2,OTT,1.0,5.0,WPG,21,11,21,1,54,21,8,7,2,38,20,11,20,1,52,21,8,7,2,38,1,0,30,34,0.478261,0.521739,49,35
2019020938,2020-02-20,2,STL,1.0,0.0,ARI,39,18,9,1,67,11,9,12,0,32,39,18,9,1,67,11,9,12,0,32,1,0,46,14,0.431373,0.568627,6,6
2019020939,2020-02-20,2,VGK,5.0,3.0,T.B,17,8,10,4,39,19,12,20,1,52,17,8,10,4,39,19,12,20,1,52,0,1,33,27,0.546875,0.453125,8,8
2019020940,2020-02-20,2,L.A,5.0,4.0,FLA,25,12,12,4,53,18,10,3,2,33,24,12,12,4,52,18,10,3,2,33,1,0,40,29,0.650794,0.349206,10,12
2019020941,2020-02-21,2,NYI,4.0,1.0,DET,28,5,9,3,45,16,14,11,0,41,27,5,9,3,44,16,14,11,0,41,1,0,40,22,0.393443,0.606557,4,10
2019020942,2020-02-21,2,CAR,2.0,5.0,NYR,18,8,19,1,46,23,10,8,4,45,14,8,18,1,41,23,10,8,3,44,0,1,29,36,0.530612,0.469388,12,12
2019020943,2020-02-21,2,CHI,2.0,1.0,NSH,25,11,15,1,52,34,9,10,1,54,25,10,14,0,49,31,8,10,1,50,0,1,38,43,0.470588,0.529412,10,8
2019020944,2020-02-21,2,DAL,1.0,5.0,STL,13,9,11,1,34,15,7,11,5,38,13,8,11,1,33,15,7,10,5,37,0,1,19,23,0.47619,0.52381,16,12
2019020945,2020-02-21,2,CGY,3.0,4.0,BOS,15,10,17,3,45,19,9,9,4,41,15,10,17,3,45,19,9,9,4,41,1,0,21,23,0.538462,0.461538,5,9
2019020946,2020-02-21,2,EDM,3.0,5.0,MIN,20,7,26,3,56,29,7,11,5,52,20,7,26,3,56,29,7,11,5,52,1,0,26,39,0.576923,0.423077,4,4
2019020947,2020-02-21,2,ANA,0.0,1.0,COL,20,13,6,0,39,25,10,21,1,57,20,13,6,0,39,25,10,21,1,57,0,1,26,29,0.545455,0.454545,2,4
2019020948,2020-02-22,2,N.J,3.0,2.0,WSH,20,10,9,1,40,20,10,10,1,41,20,10,9,1,40,19,10,10,1,40,1,0,29,35,0.5,0.5,14,8
2019020949,2020-02-22,2,PHI,4.0,2.0,WPG,22,14,10,4,50,26,16,12,1,55,21,14,10,4,49,26,16,12,1,55,1,0,30,29,0.583333,0.416667,4,6
2019020950,2020-02-22,2,PIT,2.0,5.0,BUF,33,7,11,2,53,20,14,8,3,45,33,7,11,2,53,20,14,8,3,45,0,1,43,26,0.571429,0.428571,8,6
2019020951,2020-02-22,2,TOR,3.0,6.0,CAR,21,9,12,3,45,26,11,7,4,48,20,9,12,3,44,26,11,7,4,48,1,0,26,47,0.52459,0.47541,15,15
2019020952,2020-02-22,2,OTT,0.0,3.0,MTL,24,11,13,0,48,31,14,14,3,62,21,10,12,0,43,29,12,13,3,57,0,1,30,37,0.508475,0.491525,25,25
2019020953,2020-02-22,2,NYR,3.0,2.0,S.J,25,6,8,3,42,33,12,15,1,61,24,6,8,3,41,33,12,15,1,61,1,0,33,46,0.545455,0.454545,8,4
2019020954,2020-02-22,2,NSH,4.0,3.0,CBJ,35,16,20,6,77,41,9,16,4,70,29,14,19,3,65,32,9,14,2,57,1,0,36,43,0.576271,0.423729,4,2
2019020955,2020-02-22,2,ARI,7.0,3.0,T.B,31,6,11,5,53,21,15,8,3,47,29,6,11,5,51,21,15,8,3,47,0,1,41,30,0.540984,0.459016,2,10
2019020956,2020-02-22,2,VAN,9.0,3.0,BOS,22,15,6,8,51,33,13,16,2,64,20,15,6,8,49,32,13,16,2,63,1,0,35,37,0.545455,0.454545,11,13
2019020957,2020-02-22,2,VGK,5.0,3.0,FLA,26,12,16,5,59,27,10,12,2,51,25,12,16,4,57,27,10,12,2,51,0,1,39,35,0.478873,0.521127,8,6
2019020958,2020-02-22,2,L.A,1.0,2.0,COL,18,17,14,1,50,23,11,6,1,41,13,17,11,0,41,22,9,6,1,38,1,0,21,31,0.540984,0.459016,12,6
2019020959,2020-02-23,2,WSH,5.0,3.0,PIT,17,12,10,5,44,27,12,9,3,51,15,9,9,4,37,23,11,9,3,46,1,0,23,35,0.492537,0.507463,14,10
2019020960,2020-02-23,2,BUF,2.0,1.0,WPG,21,3,4,2,30,25,11,8,1,45,21,3,4,2,30,23,11,8,1,43,1,0,25,26,0.320755,0.679245,2,6
2019020961,2020-02-23,2,DAL,2.0,1.0,CHI,31,9,9,2,51,23,7,12,0,42,30,8,9,2,49,22,7,11,0,40,1,0,33,32,0.444444,0.555556,10,2
2019020962,2020-02-23,2,NYI,4.0,1.0,S.J,17,6,10,4,37,29,13,17,1,60,17,6,10,4,37,29,13,17,1,60,1,0,26,30,0.535714,0.464286,2,6
2019020963,2020-02-23,2,DET,2.0,4.0,CGY,22,5,8,2,37,25,15,9,4,53,22,5,8,2,37,25,15,9,4,53,0,1,29,31,0.362069,0.637931,4,4
2019020964,2020-02-23,2,MIN,1.0,4.0,STL,24,9,24,1,58,16,6,7,3,32,24,9,24,1,58,16,6,7,3,32,0,1,33,26,0.358491,0.641509,4,8
2019020965,2020-02-23,2,ANA,5.0,6.0,VGK,22,12,14,5,53,21,16,14,6,57,22,11,13,5,51,21,15,13,5,54,0,1,30,28,0.553571,0.446429,2,4
2019020966,2020-02-23,2,L.A,2.0,4.0,EDM,21,11,11,1,44,25,10,9,3,47,21,11,11,1,44,25,10,9,3,47,0,1,23,31,0.551724,0.448276,4,6
2019020967,2020-02-24,2,CBJ,4.0,3.0,OTT,38,11,11,4,64,30,7,13,2,52,34,10,10,3,57,29,7,13,2,51,1,0,45,33,0.423729,0.576271,2,2
2019020968,2020-02-25,2,BOS,2.0,5.0,CGY,23,14,13,1,51,23,8,7,4,42,23,14,13,1,51,23,8,7,4,42,0,1,28,31,0.56962,0.43038,6,2
2019020969,2020-02-25,2,MTL,3.0,4.0,VAN,37,6,16,3,62,29,9,10,2,50,37,6,16,3,62,25,9,10,1,45,1,0,40,34,0.473684,0.526316,4,2
2019020970,2020-02-25,2,T.B,3.0,4.0,TOR,24,10,8,3,45,17,5,6,2,30,23,10,7,3,43,17,5,6,2,30,1,0,29,23,0.555556,0.444444,8,6
2019020971,2020-02-25,2,NYI,3.0,4.0,NYR,37,16,22,2,77,21,7,13,4,45,35,16,21,2,74,21,7,13,3,44,0,1,45,28,0.625,0.375,19,11
2019020972,2020-02-25,2,PHI,4.0,2.0,S.J,19,12,17,3,51,21,9,17,2,49,18,12,16,3,49,21,8,17,2,48,1,0,27,28,0.644444,0.355556,6,6
2019020973,2020-02-25,2,WSH,4.0,3.0,WPG,32,12,13,6,63,31,13,22,5,71,27,11,13,3,54,25,13,18,3,59,1,0,37,33,0.508475,0.491525,11,7
2019020974,2020-02-25,2,CAR,1.0,4.0,DAL,28,10,8,1,47,9,6,3,3,21,28,10,8,1,47,9,6,3,3,21,0,1,41,16,0.592593,0.407407,6,8
2019020975,2020-02-25,2,DET,1.0,4.0,N.J,25,6,12,0,43,19,5,9,1,34,25,6,12,0,43,19,5,9,1,34,0,1,28,31,0.44898,0.55102,20,31
2019020976,2020-02-25,2,STL,6.0,5.0,CHI,25,8,8,4,45,20,5,4,2,31,25,8,8,4,45,20,5,4,2,31,1,0,37,30,0.483871,0.516129,8,8
2019020977,2020-02-25,2,NSH,3.0,2.0,OTT,21,9,16,1,47,30,13,13,2,58,21,9,16,1,47,30,13,13,2,58,0,1,33,35,0.714286,0.285714,4,6
2019020978,2020-02-25,2,MIN,5.0,4.0,CBJ,33,11,16,5,65,21,9,8,4,42,33,11,16,5,65,21,9,8,4,42,1,0,40,28,0.413793,0.586207,4,2
2019020979,2020-02-25,2,ARI,1.0,2.0,FLA,36,14,12,0,62,22,16,14,1,53,36,14,12,0,62,22,16,14,1,53,1,0,38,26,0.432836,0.567164,4,0
2019020980,2020-02-25,2,ANA,4.0,3.0,EDM,17,14,9,3,43,26,14,11,2,53,16,14,9,3,42,23,14,11,2,50,1,0,21,32,0.385965,0.614035,6,6
2019020981,2020-02-26,2,COL,3.0,2.0,BUF,27,14,23,1,65,26,8,12,2,48,27,14,23,1,65,26,8,12,2,48,1,0,34,33,0.589286,0.410714,4,6
2019020982,2020-02-26,2,VGK,3.0,0.0,EDM,23,7,14,2,46,27,7,15,0,49,23,7,14,2,46,27,7,15,0,49,1,0,33,29,0.522727,0.477273,6,6
2019020983,2020-02-26,2,L.A,2.0,1.0,PIT,15,3,11,1,30,31,11,13,1,56,15,3,11,1,30,31,11,13,1,56,1,0,22,36,0.519231,0.480769,6,4
2019020984,2020-02-27,2,BOS,4.0,3.0,DAL,18,12,6,3,39,30,8,13,2,53,18,12,6,3,39,30,8,13,2,53,0,1,28,34,0.490909,0.509091,9,9
2019020985,2020-02-27,2,MTL,2.0,5.0,NYR,29,12,25,2,68,25,6,10,4,45,29,12,25,2,68,25,6,10,4,45,1,0,34,35,0.563636,0.436364,6,6
2019020986,2020-02-27,2,T.B,2.0,5.0,CHI,22,7,10,2,41,17,2,7,4,30,22,7,10,2,41,17,2,7,4,30,1,0,38,27,0.438596,0.561404,34,12
2019020987,2020-02-27,2,FLA,3.0,5.0,TOR,23,10,16,3,52,19,11,12,5,47,23,10,16,3,52,19,11,12,5,47,1,0,27,29,0.547619,0.452381,7,7
2019020988,2020-02-27,2,OTT,5.0,2.0,VAN,20,10,26,5,61,28,13,16,1,58,20,10,26,5,61,28,13,16,1,58,1,0,25,34,0.444444,0.555556,9,7
2019020989,2020-02-27,2,DET,1.0,7.0,MIN,22,19,14,1,56,15,11,3,6,35,21,19,14,1,55,15,11,3,6,35,0,1,26,26,0.516129,0.483871,8,6
2019020990,2020-02-27,2,STL,3.0,2.0,NYI,28,6,19,3,56,13,7,5,1,26,27,6,18,2,53,12,7,5,1,25,0,1,32,17,0.592593,0.407407,4,2
2019020991,2020-02-27,2,NSH,4.0,3.0,CGY,31,17,10,4,62,36,12,10,3,61,29,16,10,3,58,35,12,10,3,60,1,0,38,39,0.52,0.48,2,6
2019020992,2020-02-27,2,WPG,3.0,0.0,WSH,25,8,13,3,49,27,14,14,0,55,25,8,13,3,49,27,14,14,0,55,1,0,32,34,0.384615,0.615385,6,6
2019020993,2020-02-27,2,S.J,3.0,2.0,N.J,22,12,19,2,55,18,7,7,2,34,18,11,17,1,47,16,7,6,2,31,0,1,30,23,0.44898,0.55102,10,8
2019020994,2020-02-28,2,PHI,5.0,2.0,NYR,31,16,13,4,64,22,5,12,2,41,31,15,13,4,63,21,5,12,1,39,0,1,40,28,0.679245,0.320755,10,10
2019020995,2020-02-28,2,CBJ,0.0,5.0,MIN,22,10,15,0,47,17,11,15,4,47,22,10,15,0,47,17,11,15,4,47,0,1,24,26,0.448276,0.551724,6,4
2019020996,2020-02-28,2,CAR,2.0,3.0,COL,34,13,12,2,61,22,10,8,3,43,34,13,12,2,61,22,10,8,3,43,0,1,47,32,0.619718,0.380282,6,6
2019020997,2020-02-28,2,VGK,4.0,2.0,BUF,24,10,11,4,49,31,9,20,2,62,24,10,11,4,49,31,9,20,2,62,0,1,28,34,0.678571,0.321429,2,0
2019020998,2020-02-28,2,ANA,3.0,2.0,PIT,10,7,13,2,32,24,10,9,1,44,9,7,13,2,31,23,8,9,1,41,1,0,21,30,0.583333,0.416667,14,16
2019020999,2020-02-29,2,NYI,0.0,4.0,BOS,18,8,15,0,41,19,4,11,3,37,17,8,15,0,40,19,4,11,3,37,0,1,25,30,0.490566,0.509434,6,12
2019021000,2020-02-29,2,T.B,4.0,3.0,CGY,22,13,9,1,45,15,10,16,2,43,22,13,9,1,45,15,10,16,2,43,1,0,33,21,0.54386,0.45614,6,10
2019021001,2020-02-29,2,L.A,2.0,1.0,N.J,36,13,17,2,68,27,13,10,1,51,35,12,17,1,65,27,12,10,1,50,0,1,38,33,0.578947,0.421053,2,0
2019021002,2020-02-29,2,FLA,2.0,3.0,CHI,31,9,7,2,49,25,10,11,4,50,25,7,7,2,41,22,9,10,2,43,1,0,40,29,0.52459,0.47541,6,6
2019021003,2020-02-29,2,TOR,4.0,2.0,VAN,18,11,14,4,47,21,13,17,2,53,18,11,14,4,47,21,13,17,2,53,1,0,30,27,0.540984,0.459016,4,8
2019021004,2020-02-29,2,MTL,4.0,3.0,CAR,32,10,18,4,64,22,8,10,3,43,31,10,15,3,59,19,7,10,3,39,1,0,39,30,0.559322,0.440678,6,8
2019021005,2020-02-29,2,OTT,4.0,3.0,DET,29,15,19,3,66,20,14,17,2,53,22,11,19,2,54,19,12,17,2,50,0,1,39,28,0.525424,0.474576,4,10
2019021006,2020-02-29,2,STL,4.0,3.0,DAL,21,12,18,3,54,30,9,10,3,52,17,8,17,2,44,24,9,10,3,46,0,1,29,31,0.571429,0.428571,0,6
2019021007,2020-02-29,2,NSH,2.0,3.0,COL,19,17,6,2,44,17,5,8,3,33,19,17,6,2,44,17,5,8,3,33,0,1,32,31,0.44898,0.55102,8,6
2019021008,2020-02-29,2,ARI,5.0,2.0,BUF,22,14,12,4,52,18,11,8,2,39,22,14,12,4,52,18,11,8,2,39,0,1,31,27,0.46,0.54,4,4
2019021009,2020-02-29,2,EDM,3.0,2.0,WPG,15,12,16,1,44,36,12,17,2,67,15,12,15,1,43,36,12,17,2,67,1,0,22,41,0.5,0.5,4,4
2019021010,2020-02-29,2,S.J,5.0,0.0,PIT,25,12,14,5,56,23,14,17,0,54,24,12,14,5,55,23,13,16,0,52,1,0,32,30,0.435484,0.564516,10,8
2019021011,2020-03-01,2,NYR,3.0,5.0,PHI,18,18,10,0,46,14,4,5,1,24,18,18,10,0,46,14,4,5,1,24,0,1,26,26,0.509804,0.490196,20,12
2019021012,2020-03-01,2,FLA,0.0,3.0,CGY,28,8,7,0,43,24,11,13,2,50,28,8,7,0,43,23,11,13,2,49,0,1,38,28,0.510204,0.489796,2,6
2019021013,2020-03-01,2,CBJ,5.0,3.0,VAN,27,5,10,3,45,31,10,14,2,57,27,5,10,3,45,31,10,14,2,57,0,1,35,39,0.476923,0.523077,11,9
2019021014,2020-03-01,2,MIN,3.0,4.0,WSH,33,6,14,1,54,23,10,9,3,45,33,6,14,1,54,23,10,9,3,45,1,0,40,30,0.616667,0.383333,15,19
2019021015,2020-03-01,2,ANA,0.0,3.0,N.J,29,19,18,0,66,30,8,15,1,54,29,19,18,0,66,30,8,15,1,54,0,1,34,34,0.5,0.5,6,4
2019021016,2020-03-01,2,VGK,1.0,4.0,L.A,36,18,20,0,74,9,4,8,2,23,35,18,20,0,73,7,4,7,2,20,0,1,43,17,0.482143,0.517857,6,10
2019021017,2020-03-02,2,DET,1.0,2.0,COL,12,12,13,1,38,24,13,12,2,51,10,12,13,1,36,24,12,12,2,50,1,0,18,27,0.568966,0.431034,8,8
2019021018,2020-03-02,2,NSH,3.0,8.0,EDM,25,12,17,3,57,26,8,11,7,52,25,12,17,3,57,26,8,11,7,52,0,1,30,35,0.543478,0.456522,2,4
2019021019,2020-03-03,2,T.B,1.0,2.0,BOS,17,8,18,1,44,30,8,11,2,51,17,8,18,1,44,29,7,11,2,49,0,1,21,35,0.425926,0.574074,11,7
2019021020,2020-03-03,2,NYI,2.0,6.0,MTL,18,11,8,1,38,20,14,12,4,50,18,11,8,1,38,20,14,12,4,50,0,1,22,27,0.653846,0.346154,5,13
2019021021,2020-03-03,2,NYR,1.0,3.0,STL,22,17,9,0,48,15,6,10,2,33,22,17,9,0,48,15,6,10,2,33,1,0,26,22,0.361111,0.638889,2,6
2019021022,2020-03-03,2,PIT,7.0,3.0,OTT,25,6,13,6,50,19,5,12,3,39,25,6,12,6,49,19,5,12,3,39,1,0,35,26,0.445946,0.554054,8,10
2019021023,2020-03-03,2,MIN,3.0,1.0,NSH,18,9,12,3,42,22,11,13,0,46,17,8,12,3,40,21,11,13,0,45,1,0,33,38,0.387097,0.612903,10,14
2019021024,2020-03-03,2,WPG,3.0,1.0,BUF,30,12,5,1,48,21,17,12,1,51,30,12,5,1,48,21,17,12,1,51,1,0,35,26,0.55814,0.44186,4,6
2019021025,2020-03-03,2,CHI,6.0,2.0,ANA,28,8,20,6,62,31,9,9,2,51,28,8,20,6,62,31,9,9,2,51,1,0,40,39,0.523077,0.476923,6,4
2019021026,2020-03-03,2,DAL,1.0,2.0,EDM,30,9,12,0,51,20,5,3,0,28,30,9,12,0,51,19,5,3,0,27,0,1,43,27,0.625,0.375,10,12
2019021027,2020-03-03,2,VGK,3.0,0.0,N.J,28,15,16,3,62,23,10,11,0,44,28,15,16,3,62,23,10,11,0,44,1,0,32,27,0.566667,0.433333,6,2
2019021028,2020-03-03,2,S.J,5.0,2.0,TOR,29,10,10,4,53,17,7,14,2,40,29,10,10,4,53,17,6,14,2,39,1,0,38,27,0.45283,0.54717,6,4
2019021029,2020-03-04,2,WSH,2.0,5.0,PHI,20,10,12,2,44,14,9,7,4,34,20,10,12,2,44,14,9,7,4,34,1,0,27,29,0.527273,0.472727,20,20
2019021030,2020-03-04,2,CGY,3.0,2.0,CBJ,31,6,22,3,62,17,11,10,2,40,26,6,22,2,56,14,11,10,2,37,0,1,37,22,0.520833,0.479167,2,2
2019021031,2020-03-04,2,COL,3.0,4.0,ANA,28,18,18,1,65,24,8,12,4,48,19,16,14,1,50,20,8,12,3,43,1,0,35,30,0.596491,0.403509,13,15
2019021032,2020-03-04,2,VAN,2.0,4.0,ARI,33,16,8,1,58,27,9,15,3,54,33,16,8,1,58,27,9,15,3,54,0,1,38,40,0.637931,0.362069,6,6
2019021033,2020-03-05,2,BUF,2.0,4.0,PIT,23,10,10,1,44,28,9,5,3,45,22,10,10,1,43,27,9,5,3,44,0,1,30,32,0.480769,0.519231,6,6
2019021034,2020-03-05,2,T.B,4.0,0.0,MTL,16,10,5,3,34,23,7,9,0,39,15,10,5,3,33,23,7,9,0,39,1,0,23,32,0.457627,0.542373,11,21
2019021035,2020-03-05,2,FLA,1.0,2.0,BOS,28,17,12,1,58,20,5,12,1,38,25,13,11,1,50,13,3,11,0,27,1,0,33,28,0.47619,0.52381,15,13
2019021036,2020-03-05,2,NYR,6.0,5.0,WSH,25,8,11,4,48,19,12,5,5,41,23,8,9,3,43,19,12,4,4,39,0,1,39,34,0.580645,0.419355,6,14
2019021037,2020-03-05,2,PHI,4.0,1.0,CAR,26,9,3,4,42,28,15,16,1,60,26,9,3,4,42,28,15,16,1,60,1,0,32,29,0.576923,0.423077,0,4
2019021038,2020-03-05,2,OTT,4.0,3.0,NYI,18,18,8,3,47,29,9,7,2,47,18,18,8,3,47,29,9,7,2,47,0,1,29,40,0.44,0.56,8,6
2019021039,2020-03-05,2,NSH,2.0,0.0,DAL,26,13,6,0,45,25,11,10,0,46,26,13,6,0,45,25,11,10,0,46,1,0,32,33,0.5,0.5,8,8
2019021040,2020-03-05,2,CHI,4.0,3.0,EDM,24,9,11,4,48,21,6,11,3,41,24,9,11,4,48,21,6,11,3,41,1,0,31,24,0.595745,0.404255,2,4
2019021041,2020-03-05,2,L.A,1.0,0.0,TOR,28,12,7,2,49,29,21,10,1,61,20,11,7,0,38,25,19,9,0,53,0,0,30,36,0.55102,0.44898,6,6
2019021042,2020-03-05,2,S.J,2.0,3.0,MIN,36,16,17,1,70,23,5,9,3,40,36,16,17,1,70,23,5,9,3,40,0,1,42,27,0.469388,0.530612,2,6
2019021043,2020-03-06,2,N.J,4.0,2.0,STL,22,4,9,4,39,23,11,10,1,45,21,4,9,4,38,23,10,10,1,44,1,0,32,33,0.571429,0.428571,8,4
2019021044,2020-03-06,2,DET,2.0,1.0,CHI,19,8,15,1,43,28,13,8,1,50,19,8,15,1,43,28,13,8,1,50,1,0,25,33,0.5,0.5,6,4
2019021045,2020-03-06,2,WPG,4.0,0.0,VGK,20,9,11,2,42,28,16,16,0,60,20,9,11,2,42,28,16,16,0,60,1,0,24,29,0.541667,0.458333,2,4
2019021046,2020-03-06,2,CGY,3.0,2.0,ARI,21,21,7,2,51,29,14,9,2,54,21,21,7,2,51,29,14,8,2,53,0,1,34,34,0.553846,0.446154,6,8
2019021047,2020-03-06,2,VAN,6.0,3.0,COL,14,6,13,4,37,20,15,19,3,57,16,8,17,6,47,23,20,19,3,65,1,0,25,32,0.587302,0.412698,10,10
2019021048,2020-03-06,2,ANA,2.0,1.0,TOR,22,10,11,2,45,21,10,12,1,44,22,10,11,2,45,21,10,12,1,44,1,0,28,31,0.568966,0.431034,11,9
2019021049,2020-03-07,2,NYI,2.0,3.0,CAR,23,8,11,2,44,21,11,8,2,42,23,8,11,2,44,21,11,8,2,42,0,1,26,28,0.467742,0.532258,15,11
2019021050,2020-03-07,2,PIT,2.0,5.0,WSH,23,9,12,1,45,20,9,10,4,43,22,9,12,1,44,18,9,10,4,41,0,1,28,28,0.527273,0.472727,6,14
2019021051,2020-03-07,2,DAL,0.0,1.0,NSH,32,15,26,0,73,20,18,11,0,49,27,14,26,0,67,18,17,10,0,45,0,1,37,23,0.539683,0.460317,8,8
2019021052,2020-03-07,2,L.A,7.0,3.0,MIN,20,7,11,6,44,22,10,12,3,47,20,7,11,6,44,22,10,12,3,47,1,0,35,28,0.478261,0.521739,6,8
2019021053,2020-03-07,2,BOS,3.0,5.0,T.B,28,7,11,2,48,18,2,19,2,41,26,7,9,1,43,16,2,17,2,37,0,1,38,25,0.4375,0.5625,46,48
2019021054,2020-03-07,2,FLA,4.0,1.0,MTL,22,9,12,4,47,27,6,9,1,43,22,9,12,4,47,27,6,9,1,43,1,0,32,34,0.592593,0.407407,6,6
2019021055,2020-03-07,2,NYR,4.0,6.0,N.J,28,10,15,4,57,22,7,21,5,55,28,10,15,4,57,22,7,21,5,55,1,0,35,29,0.576923,0.423077,2,6
2019021056,2020-03-07,2,PHI,3.0,1.0,BUF,15,5,6,3,29,28,6,16,1,51,15,5,6,3,29,28,6,16,1,51,1,0,24,39,0.62,0.38,8,6
2019021057,2020-03-07,2,S.J,1.0,2.0,OTT,28,11,11,0,50,35,10,12,2,59,26,11,11,0,48,35,9,12,1,57,0,1,32,38,0.534483,0.465517,2,6
2019021058,2020-03-07,2,EDM,4.0,1.0,CBJ,20,4,9,4,37,39,13,9,1,62,19,4,9,3,35,38,13,8,0,59,1,0,24,46,0.560606,0.439394,6,4
2019021059,2020-03-08,2,PIT,2.0,6.0,CAR,17,6,13,1,37,19,5,16,5,45,17,6,13,1,37,19,5,15,5,44,1,0,30,36,0.585714,0.414286,8,14
2019021060,2020-03-08,2,DET,5.0,4.0,T.B,23,8,9,5,45,27,11,14,4,56,19,6,8,3,36,22,9,14,3,48,1,0,28,37,0.519231,0.480769,6,6
2019021061,2020-03-08,2,CHI,0.0,2.0,STL,27,8,6,0,41,22,7,13,2,44,27,8,6,0,41,22,7,13,2,44,0,1,29,26,0.45098,0.54902,11,25
2019021062,2020-03-08,2,CGY,3.0,5.0,VGK,18,4,10,2,34,27,13,25,4,69,18,4,10,2,34,27,13,25,4,69,0,1,22,32,0.491803,0.508197,2,2
2019021063,2020-03-08,2,ANA,4.0,5.0,MIN,18,20,15,4,57,20,6,9,3,38,17,18,13,4,52,19,6,9,3,37,1,0,26,30,0.484848,0.515152,11,13
2019021064,2020-03-08,2,VAN,1.0,2.0,CBJ,20,13,13,1,47,17,11,14,2,44,20,13,13,1,47,17,11,14,2,44,0,1,27,22,0.47541,0.52459,4,6
2019021065,2020-03-08,2,S.J,3.0,4.0,COL,14,7,7,1,29,17,9,18,3,47,14,7,7,1,29,17,9,18,3,47,1,0,25,24,0.403846,0.596154,8,8
2019021066,2020-03-09,2,BUF,3.0,2.0,WSH,23,8,9,3,43,36,9,11,3,59,18,6,9,1,34,28,9,11,2,50,1,0,26,35,0.539683,0.460317,2,6
2019021067,2020-03-09,2,WPG,4.0,2.0,ARI,26,13,13,4,56,33,10,8,2,53,26,13,13,4,56,33,10,8,2,53,0,1,34,38,0.571429,0.428571,9,9
2019021068,2020-03-09,2,EDM,2.0,3.0,VGK,22,11,15,2,50,40,9,15,2,66,21,11,15,2,49,39,9,14,1,63,1,0,24,48,0.539683,0.460317,4,0
2019021069,2020-03-09,2,L.A,3.0,1.0,COL,29,7,13,3,52,20,12,14,1,47,29,7,13,3,52,19,12,14,1,46,1,0,35,22,0.592593,0.407407,2,4
2019021070,2020-03-10,2,TOR,2.0,1.0,T.B,28,13,9,0,50,22,12,14,1,49,28,13,9,0,50,22,12,14,1,49,1,0,36,33,0.520833,0.479167,8,10
2019021071,2020-03-10,2,MTL,2.0,4.0,NSH,24,11,25,2,62,26,8,4,3,41,24,11,25,2,62,26,8,4,3,41,0,1,34,36,0.381818,0.618182,8,4
2019021072,2020-03-10,2,N.J,2.0,5.0,PIT,17,9,2,1,29,21,5,17,5,48,17,9,2,1,29,21,5,17,5,48,0,1,22,33,0.392157,0.607843,8,6
2019021073,2020-03-10,2,PHI,0.0,2.0,BOS,29,8,10,0,47,22,10,10,1,43,29,8,10,0,47,22,10,10,1,43,0,1,36,29,0.619048,0.380952,6,6
2019021074,2020-03-10,2,DET,2.0,5.0,CAR,14,6,6,2,28,21,8,8,1,38,14,6,5,2,27,20,8,6,1,35,0,1,25,36,0.470588,0.529412,24,26
2019021075,2020-03-09,2,STL,1.0,2.0,FLA,24,7,22,1,54,30,5,14,1,50,24,7,22,1,54,30,5,14,1,50,1,0,27,34,0.523077,0.476923,2,4
2019021076,2020-03-10,2,DAL,2.0,4.0,NYR,26,8,13,1,48,21,7,9,4,41,25,8,13,1,47,18,6,11,4,39,0,1,33,27,0.5,0.5,13,15
2019021077,2020-03-10,2,VAN,5.0,4.0,NYI,28,23,10,4,65,35,11,15,4,65,26,21,10,3,60,29,10,14,4,57,0,1,34,49,0.515625,0.484375,6,4
2019021078,2020-03-10,2,ANA,5.0,2.0,OTT,10,9,7,3,29,30,13,17,2,62,10,9,7,3,29,30,13,17,2,62,1,0,15,42,0.529412,0.470588,10,4
2019021079,2020-03-11,2,CHI,6.0,2.0,S.J,37,10,12,4,63,27,5,21,1,54,37,10,12,4,63,27,5,21,1,54,0,1,45,36,0.531915,0.468085,6,6
2019021080,2020-03-11,2,EDM,,,WPG,33,6,8,2,49,21,6,14,4,45,32,6,8,2,48,21,6,14,4,45,1,0,38,25,0.590909,0.409091,0,2
2019021081,2020-03-11,2,COL,,,NYR,21,6,14,1,42,21,6,14,2,43,20,6,13,0,39,21,4,14,2,41,0,1,28,32,0.508772,0.491228,10,12
2019021082,2020-03-11,2,L.A,3.0,2.0,OTT,25,8,15,2,50,19,15,11,2,47,25,8,15,2,50,19,15,11,2,47,0,1,39,26,0.466667,0.533333,9,13
2019030001,2020-08-02,3,BOS,1.0,4.0,PHI,30,17,12,1,60,24,5,10,4,43,25,13,12,1,51,22,5,10,4,41,0,1,35,29,0.467532,0.532468,18,20
2019030002,2020-08-03,3,T.B,3.0,2.0,WSH,26,9,13,2,50,27,11,12,1,51,23,9,13,2,47,24,11,10,1,46,1,0,28,33,0.518519,0.481481,19,11
2019030003,2020-08-05,3,BOS,2.0,3.0,T.B,20,11,10,2,43,29,13,10,2,54,20,11,10,2,43,29,13,10,2,54,0,1,27,35,0.606557,0.393443,11,17
2019030004,2020-08-06,3,PHI,3.0,1.0,WSH,14,6,6,3,29,10,9,6,1,26,13,6,6,2,27,10,9,6,1,26,1,0,21,17,0.666667,0.333333,10,14
2019030005,2020-08-09,3,WSH,2.0,1.0,BOS,16,8,13,2,39,28,15,18,1,62,16,6,13,2,37,26,14,16,1,57,1,0,25,31,0.360656,0.639344,10,10
2019030006,2020-08-08,3,T.B,1.0,4.0,PHI,19,12,20,0,51,23,5,10,4,42,19,12,20,0,51,23,5,9,4,41,0,1,24,30,0.490909,0.509091,6,6
2019030011,2020-08-02,3,COL,2.0,1.0,STL,28,3,9,1,41,22,5,8,0,35,28,2,9,1,40,22,5,8,0,35,0,1,38,32,0.469388,0.530612,8,10
2019030012,2020-08-03,3,VGK,5.0,3.0,DAL,25,11,13,5,54,23,7,7,2,39,27,11,13,5,56,23,7,7,2,39,1,0,33,27,0.471698,0.528302,2,4
2019030013,2020-08-05,3,DAL,0.0,4.0,COL,23,10,3,0,36,31,13,9,2,55,23,10,3,0,36,31,12,9,2,54,0,1,27,40,0.515625,0.484375,10,4
2019030014,2020-08-06,3,STL,4.0,6.0,VGK,11,3,4,4,22,22,8,11,4,45,9,3,4,4,20,17,7,10,4,38,1,0,17,38,0.696429,0.303571,12,8
2019030015,2020-08-08,3,COL,3.0,4.0,VGK,25,2,16,2,45,20,8,6,3,37,21,2,15,2,40,17,7,6,1,31,0,1,35,26,0.483333,0.516667,10,14
2019030016,2020-08-09,3,STL,1.0,2.0,DAL,16,5,5,1,27,26,10,15,2,53,11,6,5,1,23,26,9,15,1,51,1,0,22,38,0.54902,0.45098,12,10
2019030021,2020-08-01,3,PIT,2.0,3.0,MTL,30,17,19,1,67,27,9,17,3,56,30,16,19,1,66,27,8,17,3,55,0,1,41,35,0.507463,0.492537,4,14
2019030022,2020-08-03,3,PIT,3.0,1.0,MTL,21,13,13,3,50,25,8,11,1,45,18,13,12,3,46,24,7,11,1,43,1,0,38,27,0.54386,0.45614,8,14
2019030023,2020-08-05,3,MTL,4.0,3.0,PIT,21,7,9,4,41,26,8,14,1,49,21,7,9,4,41,25,7,14,1,47,1,0,31,33,0.521739,0.478261,6,10
2019030024,2020-08-07,3,MTL,2.0,0.0,PIT,18,14,16,2,50,20,8,16,0,44,18,14,16,2,50,20,8,16,0,44,1,0,22,22,0.5,0.5,4,4
2019030031,2020-08-01,3,CAR,3.0,2.0,NYR,21,12,11,2,46,15,6,7,1,29,19,11,10,2,42,15,6,6,1,28,1,0,37,26,0.54386,0.45614,21,21
2019030032,2020-08-03,3,CAR,4.0,1.0,NYR,26,8,9,3,46,21,10,12,0,43,24,8,9,3,44,19,10,12,0,41,1,0,34,24,0.535714,0.464286,12,22
2019030033,2020-08-04,3,NYR,1.0,4.0,CAR,32,5,13,1,51,21,13,16,3,53,32,4,13,1,50,21,13,16,3,53,1,0,38,31,0.492537,0.507463,6,6
2019030041,2020-08-01,3,NYI,2.0,1.0,FLA,24,13,13,1,51,24,11,12,1,48,23,13,12,1,49,24,11,12,1,48,1,0,28,28,0.538462,0.461538,4,8
2019030042,2020-08-04,3,NYI,4.0,2.0,FLA,27,5,9,2,43,23,10,15,1,49,26,5,9,2,42,21,10,15,1,47,0,1,34,28,0.390625,0.609375,8,26
2019030043,2020-08-05,3,FLA,3.0,2.0,NYI,10,11,8,1,30,18,15,12,2,47,10,10,8,1,29,18,15,12,2,47,1,0,22,22,0.541667,0.458333,6,10
2019030044,2020-08-07,3,FLA,1.0,5.0,NYI,18,11,28,0,57,26,9,10,4,49,18,11,28,0,57,26,9,10,4,49,0,1,25,38,0.550725,0.449275,6,10
2019030051,2020-08-02,3,TOR,0.0,2.0,CBJ,25,15,18,0,58,29,17,11,2,59,25,15,18,0,58,29,17,11,2,59,0,1,28,35,0.578947,0.421053,14,2
2019030052,2020-08-04,3,TOR,3.0,0.0,CBJ,25,9,12,3,49,14,10,11,0,35,25,8,12,3,48,11,10,11,0,32,1,0,39,20,0.474576,0.525424,10,12
2019030053,2020-08-06,3,CBJ,4.0,3.0,TOR,37,14,19,4,74,32,22,18,1,73,37,14,19,4,74,32,22,18,1,73,0,1,43,36,0.486486,0.513514,4,6
2019030054,2020-08-07,3,CBJ,3.0,4.0,TOR,28,18,14,3,63,41,10,19,3,73,28,18,14,3,63,41,10,19,3,73,1,0,39,53,0.587302,0.412698,15,13
2019030055,2020-08-09,3,TOR,0.0,3.0,CBJ,30,10,14,0,54,18,6,15,3,42,30,10,14,0,54,18,6,15,3,42,0,1,33,22,0.522727,0.477273,4,2
2019030061,2020-08-01,3,EDM,4.0,6.0,CHI,20,6,12,1,39,25,7,12,3,47,20,6,12,1,39,25,7,12,3,47,1,0,29,42,0.526316,0.473684,12,8
2019030062,2020-08-03,3,EDM,6.0,3.0,CHI,22,11,12,5,50,15,5,13,3,36,22,11,12,5,50,15,5,13,3,36,1,0,35,26,0.596491,0.403509,8,10
2019030063,2020-08-05,3,CHI,4.0,3.0,EDM,14,10,9,3,36,20,8,11,2,41,13,10,8,3,34,18,8,11,2,39,1,0,25,28,0.463768,0.536232,10,14
2019030064,2020-08-07,3,CHI,3.0,2.0,EDM,19,8,9,3,39,33,5,15,2,55,18,7,8,3,36,32,5,15,2,54,0,1,29,45,0.536232,0.463768,11,6
2019030071,2020-08-02,3,NSH,3.0,4.0,ARI,31,10,13,1,55,20,3,11,2,36,31,10,13,1,55,20,3,10,2,35,0,1,43,37,0.5,0.5,14,12
2019030072,2020-08-04,3,NSH,4.0,2.0,ARI,22,10,9,3,44,21,7,15,2,45,21,9,9,3,42,19,7,13,2,41,1,0,28,26,0.666667,0.333333,8,10
2019030073,2020-08-05,3,ARI,4.0,1.0,NSH,21,5,17,3,46,36,7,21,1,65,21,5,17,3,46,36,7,21,1,65,1,0,28,40,0.459016,0.540984,6,6
2019030074,2020-08-07,3,ARI,4.0,3.0,NSH,26,10,20,4,60,45,14,17,2,78,25,10,20,4,59,45,14,17,2,78,1,0,34,52,0.42623,0.57377,8,2
2019030081,2020-08-02,3,VAN,0.0,3.0,MIN,28,11,15,0,54,27,10,12,1,50,25,10,13,0,48,27,10,12,1,50,0,1,28,31,0.590164,0.409836,27,11
2019030082,2020-08-04,3,VAN,4.0,3.0,MIN,13,4,9,3,29,22,8,7,2,39,12,4,8,3,27,21,8,7,2,38,1,0,28,35,0.632353,0.367647,14,16
2019030083,2020-08-06,3,MIN,0.0,3.0,VAN,19,15,7,0,41,17,8,5,1,31,18,13,7,0,38,17,8,5,1,31,0,1,27,29,0.542857,0.457143,22,22
2019030084,2020-08-07,3,MIN,4.0,5.0,VAN,21,8,8,3,40,21,11,19,4,55,21,8,8,3,40,21,11,17,4,53,1,0,29,31,0.47541,0.52459,13,15
2019030091,2020-08-01,3,CGY,4.0,1.0,WPG,18,6,5,1,30,13,16,4,1,34,18,5,5,1,29,13,16,4,1,34,0,1,33,18,0.525424,0.474576,19,13
2019030092,2020-08-03,3,CGY,2.0,3.0,WPG,22,4,10,2,38,17,6,8,2,33,21,4,7,2,34,16,6,8,2,32,0,1,30,26,0.433962,0.566038,14,14
2019030093,2020-08-04,3,WPG,2.0,6.0,CGY,31,5,16,1,53,19,6,12,3,40,31,5,16,1,53,19,6,12,3,40,1,0,35,32,0.585714,0.414286,8,4
2019030094,2020-08-06,3,WPG,0.0,4.0,CGY,25,8,17,0,50,23,9,13,4,49,25,8,17,0,50,23,9,13,4,49,0,1,31,34,0.528571,0.471429,11,9
2019030111,2020-08-12,3,PHI,2.0,1.0,MTL,26,7,14,1,48,25,23,14,0,62,25,7,12,1,45,21,23,14,0,58,1,0,31,28,0.542373,0.457627,6,10
2019030112,2020-08-14,3,PHI,0.0,5.0,MTL,17,18,8,0,43,25,11,20,3,59,17,16,6,0,39,23,11,18,3,55,0,1,30,32,0.58,0.42,26,24
2019030113,2020-08-16,3,MTL,0.0,1.0,PHI,17,13,19,0,49,16,12,5,1,34,17,13,19,0,49,16,12,5,1,34,0,1,23,20,0.492063,0.507937,12,6
2019030114,2020-08-18,3,MTL,0.0,2.0,PHI,26,16,12,0,54,16,13,12,2,43,26,15,12,0,53,16,13,12,2,43,0,1,29,22,0.345455,0.654545,6,4
2019030115,2020-08-19,3,PHI,3.0,5.0,MTL,16,8,14,0,38,22,11,8,3,44,15,8,14,0,37,21,11,8,3,43,0,1,29,33,0.6,0.4,34,33
2019030116,2020-08-21,3,MTL,2.0,3.0,PHI,29,14,19,1,63,9,9,5,3,26,29,14,19,1,63,9,9,5,3,26,0,1,33,17,0.508475,0.491525,8,4
2019030121,2020-08-11,3,T.B,3.0,2.0,CBJ,76,35,60,3,174,57,16,26,1,100,75,35,58,3,171,57,16,26,1,100,0,1,88,63,0.521739,0.478261,10,8
2019030122,2020-08-13,3,T.B,1.0,3.0,CBJ,32,11,17,1,61,18,9,12,2,41,32,11,17,1,61,18,9,12,2,41,1,0,37,22,0.491525,0.508475,6,4
2019030123,2020-08-15,3,CBJ,2.0,3.0,T.B,8,5,8,2,23,29,15,21,3,68,8,5,8,2,23,29,15,21,3,68,0,1,17,34,0.54,0.46,2,8
2019030124,2020-08-17,3,CBJ,1.0,2.0,T.B,26,9,9,1,45,14,10,14,2,40,24,9,9,0,42,14,10,14,2,40,0,1,29,22,0.714286,0.285714,8,6
2019030125,2020-08-19,3,T.B,5.0,4.0,CBJ,20,10,13,5,48,28,11,12,3,54,19,10,13,5,47,27,10,12,3,52,1,0,25,41,0.466667,0.533333,14,2
2019030131,2020-08-12,3,WSH,2.0,4.0,NYI,13,3,12,0,28,17,7,11,3,38,12,3,12,0,27,17,7,11,3,38,1,0,26,27,0.357143,0.642857,17,23
2019030132,2020-08-14,3,WSH,2.0,5.0,NYI,21,9,13,2,45,23,10,9,4,46,21,9,12,2,44,23,10,9,4,46,1,0,25,32,0.454545,0.545455,14,8
2019030133,2020-08-16,3,NYI,2.0,1.0,WSH,26,14,16,2,58,18,10,15,0,43,26,14,16,2,58,18,10,15,0,43,1,0,34,23,0.535714,0.464286,4,10
2019030134,2020-08-18,3,NYI,2.0,3.0,WSH,12,8,9,2,31,20,20,11,2,53,12,8,9,2,31,19,20,10,1,50,1,0,26,29,0.553571,0.446429,12,14
2019030135,2020-08-20,3,WSH,0.0,4.0,NYI,19,13,25,0,57,10,8,4,3,25,18,11,24,0,53,10,8,4,3,25,0,1,21,17,0.488889,0.511111,6,4
2019030141,2020-08-12,3,BOS,4.0,3.0,CAR,32,16,26,4,78,21,15,27,2,65,31,16,26,4,77,21,14,26,2,63,0,1,40,28,0.558442,0.441558,8,10
2019030142,2020-08-13,3,BOS,2.0,3.0,CAR,27,12,14,0,53,20,17,12,2,51,26,12,14,0,52,18,17,12,2,49,1,0,35,26,0.571429,0.428571,8,8
2019030143,2020-08-15,3,CAR,1.0,3.0,BOS,19,9,6,0,34,25,7,12,1,45,19,9,6,0,34,24,7,12,1,44,0,1,30,39,0.431034,0.568966,10,10
2019030144,2020-08-17,3,CAR,3.0,4.0,BOS,16,8,15,3,42,20,12,15,4,51,16,8,15,3,42,20,12,15,4,51,1,0,19,33,0.52459,0.47541,6,2
2019030145,2020-08-19,3,BOS,2.0,1.0,CAR,17,4,7,0,28,17,15,13,1,46,17,4,7,0,28,17,15,13,1,46,0,1,27,24,0.465116,0.534884,6,8
2019030151,2020-08-11,3,VGK,4.0,1.0,CHI,19,9,8,4,40,13,5,14,0,32,24,9,11,4,48,15,6,15,0,36,1,0,34,20,0.45,0.55,4,4
2019030152,2020-08-13,3,VGK,4.0,3.0,CHI,32,14,18,4,68,20,5,25,2,52,32,14,18,4,68,20,5,25,2,52,1,0,39,25,0.483333,0.516667,4,2
2019030153,2020-08-15,3,CHI,1.0,2.0,VGK,19,9,10,1,39,19,18,14,1,52,19,9,10,1,39,19,18,14,1,52,0,1,27,26,0.415094,0.584906,6,8
2019030154,2020-08-16,3,CHI,3.0,1.0,VGK,14,6,7,3,30,38,13,27,1,79,14,6,7,3,30,38,13,27,1,79,1,0,25,49,0.482759,0.517241,6,6
2019030155,2020-08-18,3,VGK,4.0,3.0,CHI,35,10,18,3,66,23,8,16,3,50,35,10,18,3,66,23,8,16,3,50,0,1,39,26,0.44898,0.55102,2,2
2019030161,2020-08-12,3,COL,3.0,0.0,ARI,35,7,20,2,64,13,11,19,0,43,35,7,20,2,64,13,11,19,0,43,1,0,40,14,0.517241,0.482759,6,6
2019030162,2020-08-14,3,COL,3.0,2.0,ARI,23,6,15,3,47,24,7,11,2,44,23,6,15,3,47,22,7,11,2,42,1,0,28,32,0.517857,0.482143,8,8
2019030163,2020-08-15,3,ARI,4.0,2.0,COL,15,7,7,4,33,39,12,22,2,75,15,7,7,4,33,39,12,22,2,75,1,0,23,51,0.441176,0.558824,6,6
2019030164,2020-08-17,3,ARI,1.0,7.0,COL,13,3,10,0,26,15,14,12,4,45,13,3,10,0,26,15,14,12,4,45,0,1,15,30,0.491803,0.508197,16,10
2019030165,2020-08-19,3,COL,7.0,1.0,ARI,23,4,11,4,42,23,6,16,1,46,23,4,11,4,42,23,6,16,1,46,1,0,36,24,0.481481,0.518519,4,8
2019030171,2020-08-11,3,DAL,2.0,3.0,CGY,22,11,14,2,49,21,14,11,2,48,22,11,14,2,49,21,14,11,2,48,0,1,26,26,0.534483,0.465517,7,9
2019030172,2020-08-13,3,DAL,5.0,4.0,CGY,24,7,6,4,41,17,6,8,2,33,24,7,6,4,41,17,6,10,2,35,0,1,36,26,0.529412,0.470588,8,8
2019030173,2020-08-14,3,CGY,2.0,0.0,DAL,15,4,7,1,27,25,18,20,0,63,15,4,7,1,27,25,18,20,0,63,1,0,23,35,0.518519,0.481481,8,4
2019030174,2020-08-16,3,CGY,4.0,5.0,DAL,28,4,13,1,46,45,17,16,3,81,28,4,13,1,46,45,17,16,3,81,0,1,40,62,0.488372,0.511628,14,8
2019030175,2020-08-18,3,DAL,2.0,1.0,CGY,29,15,13,1,58,28,14,18,1,61,28,15,13,1,57,28,14,18,1,61,1,0,32,29,0.428571,0.571429,8,4
2019030176,2020-08-20,3,CGY,3.0,7.0,DAL,29,12,20,2,63,12,8,8,5,33,29,12,20,2,63,12,8,8,5,33,1,0,41,24,0.537037,0.462963,4,6
2019030181,2020-08-12,3,STL,2.0,5.0,VAN,25,12,16,1,54,14,11,9,2,36,25,12,16,1,54,14,11,9,2,36,0,1,31,22,0.507246,0.492754,22,16
2019030182,2020-08-14,3,STL,3.0,4.0,VAN,26,7,18,2,53,19,7,10,1,37,26,7,17,2,52,19,7,10,1,37,0,1,37,25,0.438356,0.561644,13,19
2019030183,2020-08-16,3,VAN,2.0,3.0,STL,36,9,11,1,57,46,15,28,3,92,33,9,10,1,53,45,15,28,3,91,1,0,41,49,0.493506,0.506494,6,6
2019030184,2020-08-17,3,VAN,1.0,3.0,STL,13,7,10,1,31,21,7,12,1,41,12,7,10,1,30,20,6,11,1,38,0,1,23,37,0.555556,0.444444,14,18
2019030185,2020-08-19,3,STL,3.0,4.0,VAN,31,7,14,2,54,22,14,21,3,60,31,7,14,2,54,22,14,21,3,60,0,1,39,30,0.603774,0.396226,6,4
2019030186,2020-08-21,3,VAN,6.0,2.0,STL,19,7,8,5,39,29,12,26,2,69,19,7,8,5,39,29,12,26,2,69,1,0,25,36,0.569231,0.430769,4,4
2019030211,2020-08-24,3,PHI,0.0,4.0,NYI,27,16,20,0,63,25,10,9,4,48,27,16,20,0,63,25,10,9,4,48,0,1,29,29,0.517241,0.482759,4,4
2019030212,2020-08-26,3,PHI,4.0,3.0,NYI,24,8,12,4,48,27,19,15,2,63,24,8,12,4,48,27,19,15,2,63,1,0,31,34,0.465517,0.534483,6,4
2019030213,2020-08-29,3,NYI,3.0,1.0,PHI,26,13,13,2,54,22,17,18,1,58,26,13,13,2,54,22,17,18,1,58,0,1,29,27,0.490196,0.509804,2,4
2019030214,2020-08-30,3,NYI,3.0,2.0,PHI,21,12,6,3,42,35,11,19,2,67,18,12,6,3,39,35,11,19,2,67,1,0,33,38,0.553571,0.446429,4,4
2019030215,2020-09-01,3,PHI,4.0,3.0,NYI,26,17,25,4,72,26,14,9,2,51,26,17,24,4,71,26,14,9,2,51,0,1,32,32,0.548387,0.451613,8,4
2019030216,2020-09-03,3,NYI,4.0,5.0,PHI,36,21,27,3,87,25,10,26,5,66,36,21,26,3,86,25,10,25,5,65,0,1,53,31,0.435897,0.564103,8,12
2019030217,2020-09-05,3,PHI,0.0,4.0,NYI,14,9,19,0,42,18,11,14,4,47,14,9,19,0,42,18,11,14,4,47,0,1,16,26,0.588235,0.411765,13,9
2019030221,2020-08-23,3,T.B,2.0,3.0,BOS,30,11,15,2,58,24,10,14,2,50,30,11,14,2,57,23,10,14,2,49,0,1,37,31,0.415385,0.584615,8,8
2019030222,2020-08-25,3,T.B,4.0,3.0,BOS,31,14,24,4,73,20,10,17,2,49,31,14,24,4,73,19,9,17,2,47,0,1,40,25,0.484375,0.515625,8,6
2019030223,2020-08-26,3,BOS,1.0,7.0,T.B,19,11,15,0,45,21,9,8,4,42,18,11,15,0,44,21,8,8,4,41,0,1,24,31,0.45283,0.54717,39,13
2019030224,2020-08-29,3,BOS,1.0,3.0,T.B,20,9,10,0,39,13,8,10,2,33,20,9,10,0,39,13,8,10,2,33,0,1,30,26,0.653846,0.346154,16,13
2019030225,2020-08-31,3,T.B,3.0,2.0,BOS,28,21,32,3,84,40,15,33,1,89,28,21,32,3,84,39,15,33,1,88,1,0,35,47,0.595745,0.404255,8,8
2019030231,2020-08-23,3,VGK,5.0,0.0,VAN,31,10,18,4,63,21,11,25,0,57,31,10,18,4,63,21,11,25,0,57,1,0,39,26,0.365079,0.634921,2,16
2019030232,2020-08-25,3,VGK,2.0,5.0,VAN,29,11,31,1,72,14,12,10,4,40,29,11,31,1,72,14,12,10,4,40,0,1,40,27,0.338462,0.661538,12,10
2019030233,2020-08-29,3,VAN,0.0,3.0,VGK,20,8,18,0,46,24,11,15,2,52,19,8,18,0,45,24,11,15,2,52,0,1,31,34,0.575758,0.424242,18,10
2019030234,2020-08-30,3,VAN,3.0,5.0,VGK,25,3,13,1,42,27,10,17,4,58,25,3,13,1,42,27,10,17,4,58,0,1,31,33,0.612903,0.387097,4,10
2019030235,2020-09-01,3,VGK,1.0,2.0,VAN,38,11,21,1,71,13,7,12,2,34,36,11,19,1,67,11,7,12,2,32,1,0,43,17,0.47619,0.52381,10,8
2019030236,2020-09-03,3,VAN,4.0,0.0,VGK,15,4,10,4,33,33,13,15,0,61,15,4,10,3,32,30,13,14,0,57,1,0,23,48,0.596491,0.403509,12,20
2019030237,2020-09-04,3,VGK,3.0,0.0,VAN,27,11,25,2,65,12,5,8,0,25,27,11,25,2,65,12,5,8,0,25,1,0,36,14,0.40678,0.59322,16,6
2019030241,2020-08-22,3,COL,3.0,5.0,DAL,25,5,21,3,54,24,8,10,5,47,24,5,21,2,52,23,8,10,5,46,0,1,31,30,0.457143,0.542857,6,4
2019030242,2020-08-24,3,COL,2.0,5.0,DAL,30,7,20,0,57,15,2,4,3,24,28,7,19,0,54,14,2,4,3,23,1,0,40,27,0.565217,0.434783,8,18
2019030243,2020-08-26,3,DAL,4.0,6.0,COL,24,4,20,4,52,23,9,14,6,52,23,4,20,4,51,17,9,14,5,45,1,0,37,32,0.422535,0.577465,10,10
2019030244,2020-08-30,3,DAL,5.0,4.0,COL,11,4,6,2,23,28,13,22,3,66,10,3,6,2,21,27,13,22,3,65,1,0,29,37,0.509434,0.490566,12,14
2019030245,2020-08-31,3,COL,6.0,3.0,DAL,21,3,3,6,33,21,9,18,1,49,17,3,3,6,29,20,8,18,1,47,1,0,41,34,0.455882,0.544118,18,38
2019030246,2020-09-02,3,DAL,1.0,4.0,COL,23,10,16,1,50,11,9,21,4,45,23,10,16,1,50,11,9,21,4,45,1,0,28,24,0.5,0.5,20,12
2019030247,2020-09-04,3,COL,4.0,5.0,DAL,30,12,21,3,66,28,8,22,3,61,30,12,21,3,66,28,8,22,3,61,0,1,44,35,0.442857,0.557143,4,8
2019030311,2020-09-07,3,T.B,8.0,2.0,NYI,17,1,7,5,30,13,1,10,1,25,17,1,6,4,28,13,1,10,1,25,1,0,34,24,0.472727,0.527273,12,24
2019030312,2020-09-09,3,T.B,2.0,1.0,NYI,14,12,12,2,40,14,4,16,1,35,14,12,10,2,38,13,4,16,1,34,0,1,21,28,0.444444,0.555556,28,13
2019030313,2020-09-11,3,NYI,5.0,3.0,T.B,28,7,13,5,53,33,15,24,2,74,27,7,13,4,51,32,15,24,2,73,1,0,35,37,0.421875,0.578125,29,41
2019030314,2020-09-13,3,NYI,1.0,4.0,T.B,22,13,16,1,52,22,7,11,4,44,22,13,16,1,52,22,7,11,4,44,1,0,27,36,0.381818,0.618182,8,8
2019030315,2020-09-15,3,T.B,1.0,2.0,NYI,29,14,27,1,71,21,9,28,1,59,29,14,27,1,71,21,9,28,1,59,0,1,37,24,0.447368,0.552632,6,6
2019030316,2020-09-17,3,NYI,1.0,2.0,T.B,21,11,23,1,56,41,15,27,2,85,21,11,23,1,56,41,15,27,2,85,1,0,27,48,0.544118,0.455882,10,4
2019030321,2020-09-06,3,VGK,0.0,1.0,DAL,22,7,13,0,42,23,8,17,1,49,22,7,12,0,41,19,8,17,1,45,0,1,25,25,0.4,0.6,4,8
2019030322,2020-09-08,3,VGK,3.0,0.0,DAL,19,8,4,2,33,21,6,10,0,37,19,8,4,2,33,21,6,10,0,37,1,0,32,24,0.612245,0.387755,4,14
2019030323,2020-09-10,3,DAL,3.0,2.0,VGK,20,3,15,3,41,28,8,17,1,54,20,3,15,3,41,28,8,17,1,54,1,0,23,40,0.5,0.5,8,2
2019030324,2020-09-12,3,DAL,2.0,1.0,VGK,12,3,9,1,25,19,11,13,0,43,12,3,9,1,25,19,11,13,0,43,0,1,20,33,0.5,0.5,10,8
2019030325,2020-09-14,3,VGK,2.0,3.0,DAL,26,3,15,2,46,20,4,19,1,44,21,3,15,2,41,19,4,19,1,43,1,0,36,26,0.473684,0.526316,12,10
2019030411,2020-09-19,3,T.B,1.0,4.0,DAL,30,11,20,1,62,9,9,15,4,37,30,10,20,1,61,8,9,15,4,36,0,1,36,20,0.489362,0.510638,16,8
2019030412,2020-09-21,3,T.B,3.0,2.0,DAL,24,7,16,1,48,16,3,18,1,38,24,7,16,1,48,16,3,18,1,38,1,0,31,29,0.507246,0.492754,14,12
2019030413,2020-09-23,3,DAL,2.0,5.0,T.B,15,6,9,1,31,22,4,8,4,38,13,6,9,1,29,21,4,7,4,36,0,1,24,32,0.553191,0.446809,26,36
2019030414,2020-09-25,3,DAL,4.0,5.0,T.B,22,6,13,4,45,23,13,18,2,56,21,6,13,4,44,23,13,17,2,55,1,0,30,35,0.581081,0.418919,10,8
2019030415,2020-09-26,3,T.B,2.0,3.0,DAL,36,16,33,2,87,27,16,17,3,63,36,16,33,2,87,27,16,17,3,63,0,1,41,33,0.5125,0.4875,4,2
2019030416,2020-09-28,3,DAL,0.0,2.0,T.B,19,9,18,0,46,23,7,14,1,45,19,9,17,0,45,23,7,14,1,45,0,1,22,29,0.465517,0.534483,6,6
